county,sub-county,Age,Male,Female,Total
BARINGO,ALL,Total,336322,330428,666750
BARINGO,ALL,0,8303,7982,16285
BARINGO,ALL,1,8669,8417,17086
BARINGO,ALL,2,10226,9762,19988
BARINGO,ALL,3,10265,10086,20351
BARINGO,ALL,4,11045,10276,21321
BARINGO,ALL,0 - 4,48508,46523,95031
BARINGO,ALL,5,10701,10047,20748
BARINGO,ALL,6,10949,10422,21371
BARINGO,ALL,7,9595,9082,18677
BARINGO,ALL,8,10276,10027,20303
BARINGO,ALL,9,9355,9101,18456
BARINGO,ALL,5-9,50876,48679,99555
BARINGO,ALL,10,12772,11975,24747
BARINGO,ALL,11,8102,8365,16467
BARINGO,ALL,12,11844,10549,22393
BARINGO,ALL,13,9747,9167,18914
BARINGO,ALL,14,9920,9151,19071
BARINGO,ALL,10-14,52385,49207,101592
BARINGO,ALL,15,10511,9330,19841
BARINGO,ALL,16,8720,8131,16851
BARINGO,ALL,17,8494,7641,16135
BARINGO,ALL,18,7287,6686,13973
BARINGO,ALL,19,7312,6836,14148
BARINGO,ALL,15-19,42324,38624,80948
BARINGO,ALL,20,7833,7737,15570
BARINGO,ALL,21,5933,6111,12044
BARINGO,ALL,22,5679,5987,11666
BARINGO,ALL,23,5840,6017,11857
BARINGO,ALL,24,5303,5405,10708
BARINGO,ALL,20-24,30588,31257,61845
BARINGO,ALL,25,6470,6583,13053
BARINGO,ALL,26,4296,4652,8948
BARINGO,ALL,27,4417,4584,9001
BARINGO,ALL,28,3754,4292,8046
BARINGO,ALL,29,3956,4254,8210
BARINGO,ALL,25-29,22893,24365,47258
BARINGO,ALL,30,6117,6540,12657
BARINGO,ALL,31,3290,3428,6718
BARINGO,ALL,32,3900,4109,8009
BARINGO,ALL,33,3299,3485,6784
BARINGO,ALL,34,2773,2899,5672
BARINGO,ALL,30-34,19379,20461,39840
BARINGO,ALL,35,5022,5023,10045
BARINGO,ALL,36,2612,2449,5061
BARINGO,ALL,37,2697,2318,5015
BARINGO,ALL,38,1984,2084,4068
BARINGO,ALL,39,2335,2201,4536
BARINGO,ALL,35-39,14650,14075,28725
BARINGO,ALL,40,3863,3488,7351
BARINGO,ALL,41,2944,2634,5578
BARINGO,ALL,42,2351,2237,4588
BARINGO,ALL,43,1895,2086,3981
BARINGO,ALL,44,1440,1583,3023
BARINGO,ALL,40-44,12493,12028,24521
BARINGO,ALL,45,3764,3602,7366
BARINGO,ALL,46,1954,2078,4032
BARINGO,ALL,47,2040,2073,4113
BARINGO,ALL,48,1278,1289,2567
BARINGO,ALL,49,1627,1785,3412
BARINGO,ALL,45-49,10663,10827,21490
BARINGO,ALL,50,2502,2745,5247
BARINGO,ALL,51,1471,1457,2928
BARINGO,ALL,52,1259,1371,2630
BARINGO,ALL,53,1004,1067,2071
BARINGO,ALL,54,1432,1517,2949
BARINGO,ALL,50-54,7668,8157,15825
BARINGO,ALL,55,1305,1107,2412
BARINGO,ALL,56,1163,1176,2339
BARINGO,ALL,57,1170,1492,2662
BARINGO,ALL,58,1395,1537,2932
BARINGO,ALL,59,1406,1390,2796
BARINGO,ALL,55-59,6439,6702,13141
BARINGO,ALL,60,1946,2061,4007
BARINGO,ALL,61,1213,1064,2277
BARINGO,ALL,62,868,875,1743
BARINGO,ALL,63,944,948,1892
BARINGO,ALL,64,642,670,1312
BARINGO,ALL,60-64,5613,5618,11231
BARINGO,ALL,65,1223,1405,2628
BARINGO,ALL,66,560,557,1117
BARINGO,ALL,67,1069,976,2045
BARINGO,ALL,68,574,565,1139
BARINGO,ALL,69,943,1026,1969
BARINGO,ALL,65-69,4369,4529,8898
BARINGO,ALL,70,1267,1525,2792
BARINGO,ALL,71,874,776,1650
BARINGO,ALL,72,593,566,1159
BARINGO,ALL,73,409,486,895
BARINGO,ALL,74,477,529,1006
BARINGO,ALL,70-74,3620,3882,7502
BARINGO,ALL,75,493,543,1036
BARINGO,ALL,76,306,310,616
BARINGO,ALL,77,318,354,672
BARINGO,ALL,78,212,224,436
BARINGO,ALL,79,350,591,941
BARINGO,ALL,75-79,1679,2022,3701
BARINGO,ALL,80,458,681,1139
BARINGO,ALL,81,167,345,512
BARINGO,ALL,82,137,167,304
BARINGO,ALL,83,169,258,427
BARINGO,ALL,84,185,277,462
BARINGO,ALL,80-84,1116,1728,2844
BARINGO,ALL,85,137,239,376
BARINGO,ALL,86,102,134,236
BARINGO,ALL,87,123,137,260
BARINGO,ALL,88,51,71,122
BARINGO,ALL,89,185,318,503
BARINGO,ALL,85-89,598,899,1497
BARINGO,ALL,90,85,186,271
BARINGO,ALL,91,58,80,138
BARINGO,ALL,92,39,57,96
BARINGO,ALL,93,38,55,93
BARINGO,ALL,94,33,62,95
BARINGO,ALL,90-94,253,440,693
BARINGO,ALL,95,55,116,171
BARINGO,ALL,96,22,31,53
BARINGO,ALL,97,27,34,61
BARINGO,ALL,98,8,29,37
BARINGO,ALL,99,29,68,97
BARINGO,ALL,95-99,141,278,419
BARINGO,ALL,100+,66,126,192
BARINGO,ALL,Not Stated,1,1,2
BARINGO,BARINGO CENTRAL,Total,48120,48829,96949
BARINGO,BARINGO CENTRAL,0,1110,1071,2181
BARINGO,BARINGO CENTRAL,1,1189,1160,2349
BARINGO,BARINGO CENTRAL,2,1293,1222,2515
BARINGO,BARINGO CENTRAL,3,1367,1353,2720
BARINGO,BARINGO CENTRAL,4,1344,1247,2591
BARINGO,BARINGO CENTRAL,0 - 4,6303,6053,12356
BARINGO,BARINGO CENTRAL,5,1297,1235,2532
BARINGO,BARINGO CENTRAL,6,1250,1282,2532
BARINGO,BARINGO CENTRAL,7,1232,1251,2483
BARINGO,BARINGO CENTRAL,8,1098,1193,2291
BARINGO,BARINGO CENTRAL,9,1266,1297,2563
BARINGO,BARINGO CENTRAL,5-9,6143,6258,12401
BARINGO,BARINGO CENTRAL,10,1450,1378,2828
BARINGO,BARINGO CENTRAL,11,1149,1259,2408
BARINGO,BARINGO CENTRAL,12,1387,1357,2744
BARINGO,BARINGO CENTRAL,13,1429,1368,2797
BARINGO,BARINGO CENTRAL,14,1300,1382,2682
BARINGO,BARINGO CENTRAL,Oct-14,6715,6744,13459
BARINGO,BARINGO CENTRAL,15,1424,1377,2801
BARINGO,BARINGO CENTRAL,16,1181,1195,2376
BARINGO,BARINGO CENTRAL,17,1255,1275,2530
BARINGO,BARINGO CENTRAL,18,949,905,1854
BARINGO,BARINGO CENTRAL,19,1133,1097,2230
BARINGO,BARINGO CENTRAL,15-19,5942,5849,11791
BARINGO,BARINGO CENTRAL,20,974,994,1968
BARINGO,BARINGO CENTRAL,21,927,970,1897
BARINGO,BARINGO CENTRAL,22,827,871,1698
BARINGO,BARINGO CENTRAL,23,947,986,1933
BARINGO,BARINGO CENTRAL,24,858,879,1737
BARINGO,BARINGO CENTRAL,20-24,4533,4700,9233
BARINGO,BARINGO CENTRAL,25,956,928,1884
BARINGO,BARINGO CENTRAL,26,708,736,1444
BARINGO,BARINGO CENTRAL,27,755,733,1488
BARINGO,BARINGO CENTRAL,28,596,689,1285
BARINGO,BARINGO CENTRAL,29,651,664,1315
BARINGO,BARINGO CENTRAL,25-29,3666,3750,7416
BARINGO,BARINGO CENTRAL,30,829,852,1681
BARINGO,BARINGO CENTRAL,31,572,513,1085
BARINGO,BARINGO CENTRAL,32,655,712,1367
BARINGO,BARINGO CENTRAL,33,566,581,1147
BARINGO,BARINGO CENTRAL,34,468,537,1005
BARINGO,BARINGO CENTRAL,30-34,3090,3195,6285
BARINGO,BARINGO CENTRAL,35,767,701,1468
BARINGO,BARINGO CENTRAL,36,445,401,846
BARINGO,BARINGO CENTRAL,37,465,435,900
BARINGO,BARINGO CENTRAL,38,345,330,675
BARINGO,BARINGO CENTRAL,39,377,393,770
BARINGO,BARINGO CENTRAL,35-39,2399,2260,4659
BARINGO,BARINGO CENTRAL,40,533,470,1003
BARINGO,BARINGO CENTRAL,41,508,475,983
BARINGO,BARINGO CENTRAL,42,352,372,724
BARINGO,BARINGO CENTRAL,43,329,393,722
BARINGO,BARINGO CENTRAL,44,278,323,601
BARINGO,BARINGO CENTRAL,40-44,2000,2033,4033
BARINGO,BARINGO CENTRAL,45,583,596,1179
BARINGO,BARINGO CENTRAL,46,325,334,659
BARINGO,BARINGO CENTRAL,47,344,383,727
BARINGO,BARINGO CENTRAL,48,197,208,405
BARINGO,BARINGO CENTRAL,49,292,307,599
BARINGO,BARINGO CENTRAL,45-49,1741,1828,3569
BARINGO,BARINGO CENTRAL,50,295,381,676
BARINGO,BARINGO CENTRAL,51,250,255,505
BARINGO,BARINGO CENTRAL,52,219,218,437
BARINGO,BARINGO CENTRAL,53,177,215,392
BARINGO,BARINGO CENTRAL,54,259,308,567
BARINGO,BARINGO CENTRAL,50-54,1200,1377,2577
BARINGO,BARINGO CENTRAL,55,201,190,391
BARINGO,BARINGO CENTRAL,56,174,192,366
BARINGO,BARINGO CENTRAL,57,239,335,574
BARINGO,BARINGO CENTRAL,58,267,322,589
BARINGO,BARINGO CENTRAL,59,269,241,510
BARINGO,BARINGO CENTRAL,55-59,1150,1280,2430
BARINGO,BARINGO CENTRAL,60,306,299,605
BARINGO,BARINGO CENTRAL,61,270,217,487
BARINGO,BARINGO CENTRAL,62,187,175,362
BARINGO,BARINGO CENTRAL,63,211,187,398
BARINGO,BARINGO CENTRAL,64,156,114,270
BARINGO,BARINGO CENTRAL,60-64,1130,992,2122
BARINGO,BARINGO CENTRAL,65,217,250,467
BARINGO,BARINGO CENTRAL,66,103,129,232
BARINGO,BARINGO CENTRAL,67,175,187,362
BARINGO,BARINGO CENTRAL,68,97,93,190
BARINGO,BARINGO CENTRAL,69,169,175,344
BARINGO,BARINGO CENTRAL,65-69,761,834,1595
BARINGO,BARINGO CENTRAL,70,209,220,429
BARINGO,BARINGO CENTRAL,71,184,149,333
BARINGO,BARINGO CENTRAL,72,125,87,212
BARINGO,BARINGO CENTRAL,73,94,91,185
BARINGO,BARINGO CENTRAL,74,75,85,160
BARINGO,BARINGO CENTRAL,70-74,687,632,1319
BARINGO,BARINGO CENTRAL,75,90,104,194
BARINGO,BARINGO CENTRAL,76,51,63,114
BARINGO,BARINGO CENTRAL,77,54,61,115
BARINGO,BARINGO CENTRAL,78,30,30,60
BARINGO,BARINGO CENTRAL,79,50,90,140
BARINGO,BARINGO CENTRAL,75-79,275,348,623
BARINGO,BARINGO CENTRAL,80,66,106,172
BARINGO,BARINGO CENTRAL,81,34,81,115
BARINGO,BARINGO CENTRAL,82,20,32,52
BARINGO,BARINGO CENTRAL,83,31,68,99
BARINGO,BARINGO CENTRAL,84,24,56,80
BARINGO,BARINGO CENTRAL,80-84,175,343,518
BARINGO,BARINGO CENTRAL,85,26,57,83
BARINGO,BARINGO CENTRAL,86,17,22,39
BARINGO,BARINGO CENTRAL,87,20,26,46
BARINGO,BARINGO CENTRAL,88,11,12,23
BARINGO,BARINGO CENTRAL,89,37,52,89
BARINGO,BARINGO CENTRAL,85-89,111,169,280
BARINGO,BARINGO CENTRAL,90,20,32,52
BARINGO,BARINGO CENTRAL,91,13,21,34
BARINGO,BARINGO CENTRAL,92,9,15,24
BARINGO,BARINGO CENTRAL,93,9,12,21
BARINGO,BARINGO CENTRAL,94,5,13,18
BARINGO,BARINGO CENTRAL,90-94,56,93,149
BARINGO,BARINGO CENTRAL,95,14,34,48
BARINGO,BARINGO CENTRAL,96,4,8,12
BARINGO,BARINGO CENTRAL,97,6,6,12
BARINGO,BARINGO CENTRAL,98,-,5,5
BARINGO,BARINGO CENTRAL,99,10,14,24
BARINGO,BARINGO CENTRAL,95-99,34,67,101
BARINGO,BARINGO CENTRAL,100+,9,23,32
BARINGO,BARINGO CENTRAL,Not Stated,-,1,1
BARINGO,BARINGO NORTH,Total,52369,52500,104869
BARINGO,BARINGO NORTH,0,1207,1243,2450
BARINGO,BARINGO NORTH,1,1354,1296,2650
BARINGO,BARINGO NORTH,2,1486,1408,2894
BARINGO,BARINGO NORTH,3,1609,1568,3177
BARINGO,BARINGO NORTH,4,1700,1555,3255
BARINGO,BARINGO NORTH,0 - 4,7356,7070,14426
BARINGO,BARINGO NORTH,5,1651,1543,3194
BARINGO,BARINGO NORTH,6,1701,1554,3255
BARINGO,BARINGO NORTH,7,1572,1435,3007
BARINGO,BARINGO NORTH,8,1498,1372,2870
BARINGO,BARINGO NORTH,9,1532,1488,3020
BARINGO,BARINGO NORTH,05-Sep,7954,7392,15346
BARINGO,BARINGO NORTH,10,1902,1732,3634
BARINGO,BARINGO NORTH,11,1343,1426,2769
BARINGO,BARINGO NORTH,12,1837,1676,3513
BARINGO,BARINGO NORTH,13,1678,1631,3309
BARINGO,BARINGO NORTH,14,1676,1544,3220
BARINGO,BARINGO NORTH,Oct-14,8436,8009,16445
BARINGO,BARINGO NORTH,15,1577,1522,3099
BARINGO,BARINGO NORTH,16,1333,1300,2633
BARINGO,BARINGO NORTH,17,1300,1198,2498
BARINGO,BARINGO NORTH,18,1081,1031,2112
BARINGO,BARINGO NORTH,19,1084,970,2054
BARINGO,BARINGO NORTH,15-19,6375,6021,12396
BARINGO,BARINGO NORTH,20,1037,975,2012
BARINGO,BARINGO NORTH,21,814,832,1646
BARINGO,BARINGO NORTH,22,734,840,1574
BARINGO,BARINGO NORTH,23,804,914,1718
BARINGO,BARINGO NORTH,24,737,736,1473
BARINGO,BARINGO NORTH,20-24,4126,4297,8423
BARINGO,BARINGO NORTH,25,858,893,1751
BARINGO,BARINGO NORTH,26,570,639,1209
BARINGO,BARINGO NORTH,27,609,629,1238
BARINGO,BARINGO NORTH,28,477,616,1093
BARINGO,BARINGO NORTH,29,537,600,1137
BARINGO,BARINGO NORTH,25-29,3051,3377,6428
BARINGO,BARINGO NORTH,30,799,904,1703
BARINGO,BARINGO NORTH,31,486,521,1007
BARINGO,BARINGO NORTH,32,549,595,1144
BARINGO,BARINGO NORTH,33,516,564,1080
BARINGO,BARINGO NORTH,34,397,407,804
BARINGO,BARINGO NORTH,30-34,2747,2991,5738
BARINGO,BARINGO NORTH,35,753,763,1516
BARINGO,BARINGO NORTH,36,401,338,739
BARINGO,BARINGO NORTH,37,377,290,667
BARINGO,BARINGO NORTH,38,296,308,604
BARINGO,BARINGO NORTH,39,339,280,619
BARINGO,BARINGO NORTH,35-39,2166,1979,4145
BARINGO,BARINGO NORTH,40,505,472,977
BARINGO,BARINGO NORTH,41,398,397,795
BARINGO,BARINGO NORTH,42,318,333,651
BARINGO,BARINGO NORTH,43,282,355,637
BARINGO,BARINGO NORTH,44,197,234,431
BARINGO,BARINGO NORTH,40-44,1700,1791,3491
BARINGO,BARINGO NORTH,45,613,662,1275
BARINGO,BARINGO NORTH,46,334,339,673
BARINGO,BARINGO NORTH,47,397,359,756
BARINGO,BARINGO NORTH,48,181,216,397
BARINGO,BARINGO NORTH,49,260,357,617
BARINGO,BARINGO NORTH,45-49,1785,1933,3718
BARINGO,BARINGO NORTH,50,422,505,927
BARINGO,BARINGO NORTH,51,239,253,492
BARINGO,BARINGO NORTH,52,200,254,454
BARINGO,BARINGO NORTH,53,146,164,310
BARINGO,BARINGO NORTH,54,266,302,568
BARINGO,BARINGO NORTH,50-54,1273,1478,2751
BARINGO,BARINGO NORTH,55,211,230,441
BARINGO,BARINGO NORTH,56,191,203,394
BARINGO,BARINGO NORTH,57,197,316,513
BARINGO,BARINGO NORTH,58,260,310,570
BARINGO,BARINGO NORTH,59,302,281,583
BARINGO,BARINGO NORTH,55-59,1161,1340,2501
BARINGO,BARINGO NORTH,60,402,475,877
BARINGO,BARINGO NORTH,61,236,222,458
BARINGO,BARINGO NORTH,62,177,211,388
BARINGO,BARINGO NORTH,63,209,235,444
BARINGO,BARINGO NORTH,64,158,173,331
BARINGO,BARINGO NORTH,60-64,1182,1316,2498
BARINGO,BARINGO NORTH,65,267,348,615
BARINGO,BARINGO NORTH,66,121,128,249
BARINGO,BARINGO NORTH,67,269,237,506
BARINGO,BARINGO NORTH,68,161,156,317
BARINGO,BARINGO NORTH,69,253,241,494
BARINGO,BARINGO NORTH,65-69,1071,1110,2181
BARINGO,BARINGO NORTH,70,362,400,762
BARINGO,BARINGO NORTH,71,268,208,476
BARINGO,BARINGO NORTH,72,178,141,319
BARINGO,BARINGO NORTH,73,95,127,222
BARINGO,BARINGO NORTH,74,126,147,273
BARINGO,BARINGO NORTH,70-74,1029,1023,2052
BARINGO,BARINGO NORTH,75,107,124,231
BARINGO,BARINGO NORTH,76,69,50,119
BARINGO,BARINGO NORTH,77,82,94,176
BARINGO,BARINGO NORTH,78,57,51,108
BARINGO,BARINGO NORTH,79,76,153,229
BARINGO,BARINGO NORTH,75-79,391,472,863
BARINGO,BARINGO NORTH,80,121,169,290
BARINGO,BARINGO NORTH,81,40,106,146
BARINGO,BARINGO NORTH,82,44,41,85
BARINGO,BARINGO NORTH,83,48,70,118
BARINGO,BARINGO NORTH,84,51,80,131
BARINGO,BARINGO NORTH,80-84,304,466,770
BARINGO,BARINGO NORTH,85,34,57,91
BARINGO,BARINGO NORTH,86,23,38,61
BARINGO,BARINGO NORTH,87,29,31,60
BARINGO,BARINGO NORTH,88,12,12,24
BARINGO,BARINGO NORTH,89,47,79,126
BARINGO,BARINGO NORTH,85-89,145,217,362
BARINGO,BARINGO NORTH,90,23,58,81
BARINGO,BARINGO NORTH,91,17,23,40
BARINGO,BARINGO NORTH,92,12,12,24
BARINGO,BARINGO NORTH,93,11,15,26
BARINGO,BARINGO NORTH,94,6,11,17
BARINGO,BARINGO NORTH,90-94,69,119,188
BARINGO,BARINGO NORTH,95,14,22,36
BARINGO,BARINGO NORTH,96,8,6,14
BARINGO,BARINGO NORTH,97,9,8,17
BARINGO,BARINGO NORTH,98,5,7,12
BARINGO,BARINGO NORTH,99,3,20,23
BARINGO,BARINGO NORTH,95-99,39,63,102
BARINGO,BARINGO NORTH,100+,9,36,45
BARINGO,BARINGO NORTH,Not Stated,-,-,-
BARINGO,EAST POKOT,Total,40462,39459,79921
BARINGO,EAST POKOT,0,872,789,1661
BARINGO,EAST POKOT,1,987,949,1936
BARINGO,EAST POKOT,2,1552,1489,3041
BARINGO,EAST POKOT,3,1332,1276,2608
BARINGO,EAST POKOT,4,1723,1614,3337
BARINGO,EAST POKOT,0 - 4,6466,6117,12583
BARINGO,EAST POKOT,5,1548,1423,2971
BARINGO,EAST POKOT,6,1815,1708,3523
BARINGO,EAST POKOT,7,1189,1065,2254
BARINGO,EAST POKOT,8,1932,1915,3847
BARINGO,EAST POKOT,9,1144,1115,2259
BARINGO,EAST POKOT,5-9,7628,7226,14854
BARINGO,EAST POKOT,10,2371,2321,4692
BARINGO,EAST POKOT,11,749,860,1609
BARINGO,EAST POKOT,12,1889,1536,3425
BARINGO,EAST POKOT,13,966,852,1818
BARINGO,EAST POKOT,14,1296,1012,2308
BARINGO,EAST POKOT,10-14,7271,6581,13852
BARINGO,EAST POKOT,15,1502,1074,2576
BARINGO,EAST POKOT,16,1230,950,2180
BARINGO,EAST POKOT,17,841,687,1528
BARINGO,EAST POKOT,18,1205,1003,2208
BARINGO,EAST POKOT,19,743,615,1358
BARINGO,EAST POKOT,15-19,5521,4329,9850
BARINGO,EAST POKOT,20,1382,1434,2816
BARINGO,EAST POKOT,21,554,633,1187
BARINGO,EAST POKOT,22,639,738,1377
BARINGO,EAST POKOT,23,578,612,1190
BARINGO,EAST POKOT,24,552,612,1164
BARINGO,EAST POKOT,20-24,3705,4029,7734
BARINGO,EAST POKOT,25,891,1033,1924
BARINGO,EAST POKOT,26,491,603,1094
BARINGO,EAST POKOT,27,401,483,884
BARINGO,EAST POKOT,28,498,632,1130
BARINGO,EAST POKOT,29,433,519,952
BARINGO,EAST POKOT,25-29,2714,3270,5984
BARINGO,EAST POKOT,30,1123,1144,2267
BARINGO,EAST POKOT,31,278,326,604
BARINGO,EAST POKOT,32,342,330,672
BARINGO,EAST POKOT,33,197,190,387
BARINGO,EAST POKOT,34,167,209,376
BARINGO,EAST POKOT,30-34,2107,2199,4306
BARINGO,EAST POKOT,35,514,563,1077
BARINGO,EAST POKOT,36,139,169,308
BARINGO,EAST POKOT,37,136,135,271
BARINGO,EAST POKOT,38,161,232,393
BARINGO,EAST POKOT,39,122,169,291
BARINGO,EAST POKOT,35-39,1072,1268,2340
BARINGO,EAST POKOT,40,569,666,1235
BARINGO,EAST POKOT,41,211,192,403
BARINGO,EAST POKOT,42,180,172,352
BARINGO,EAST POKOT,43,87,127,214
BARINGO,EAST POKOT,44,93,125,218
BARINGO,EAST POKOT,40-44,1140,1282,2422
BARINGO,EAST POKOT,45,349,363,712
BARINGO,EAST POKOT,46,142,140,282
BARINGO,EAST POKOT,47,95,133,228
BARINGO,EAST POKOT,48,98,113,211
BARINGO,EAST POKOT,49,127,153,280
BARINGO,EAST POKOT,45-49,811,902,1713
BARINGO,EAST POKOT,50,445,446,891
BARINGO,EAST POKOT,51,62,77,139
BARINGO,EAST POKOT,52,87,80,167
BARINGO,EAST POKOT,53,63,56,119
BARINGO,EAST POKOT,54,69,99,168
BARINGO,EAST POKOT,50-54,726,758,1484
BARINGO,EAST POKOT,55,123,78,201
BARINGO,EAST POKOT,56,73,72,145
BARINGO,EAST POKOT,57,45,54,99
BARINGO,EAST POKOT,58,61,68,129
BARINGO,EAST POKOT,59,73,92,165
BARINGO,EAST POKOT,55-59,375,364,739
BARINGO,EAST POKOT,60,226,226,452
BARINGO,EAST POKOT,61,45,58,103
BARINGO,EAST POKOT,62,32,45,77
BARINGO,EAST POKOT,63,43,43,86
BARINGO,EAST POKOT,64,19,34,53
BARINGO,EAST POKOT,60-64,365,406,771
BARINGO,EAST POKOT,65,82,108,190
BARINGO,EAST POKOT,66,21,22,43
BARINGO,EAST POKOT,67,25,29,54
BARINGO,EAST POKOT,68,29,30,59
BARINGO,EAST POKOT,69,68,98,166
BARINGO,EAST POKOT,65-69,225,287,512
BARINGO,EAST POKOT,70,90,115,205
BARINGO,EAST POKOT,71,28,29,57
BARINGO,EAST POKOT,72,24,33,57
BARINGO,EAST POKOT,73,14,15,29
BARINGO,EAST POKOT,74,17,20,37
BARINGO,EAST POKOT,70-74,173,212,385
BARINGO,EAST POKOT,75,30,30,60
BARINGO,EAST POKOT,76,10,9,19
BARINGO,EAST POKOT,77,6,9,15
BARINGO,EAST POKOT,78,8,8,16
BARINGO,EAST POKOT,79,25,41,66
BARINGO,EAST POKOT,75-79,79,97,176
BARINGO,EAST POKOT,80,31,45,76
BARINGO,EAST POKOT,81,2,5,7
BARINGO,EAST POKOT,82,6,2,8
BARINGO,EAST POKOT,83,5,4,9
BARINGO,EAST POKOT,84,4,10,14
BARINGO,EAST POKOT,80-84,48,66,114
BARINGO,EAST POKOT,85,4,8,12
BARINGO,EAST POKOT,86,-,5,5
BARINGO,EAST POKOT,87,4,5,9
BARINGO,EAST POKOT,88,-,1,1
BARINGO,EAST POKOT,89,14,16,30
BARINGO,EAST POKOT,85-89,22,35,57
BARINGO,EAST POKOT,90,3,9,12
BARINGO,EAST POKOT,91,1,3,4
BARINGO,EAST POKOT,92,-,4,4
BARINGO,EAST POKOT,93,1,2,3
BARINGO,EAST POKOT,94,1,1,2
BARINGO,EAST POKOT,90-94,6,19,25
BARINGO,EAST POKOT,95,-,5,5
BARINGO,EAST POKOT,96,-,-,-
BARINGO,EAST POKOT,97,1,-,1
BARINGO,EAST POKOT,98,-,-,-
BARINGO,EAST POKOT,99,2,1,3
BARINGO,EAST POKOT,95-99,3,6,9
BARINGO,EAST POKOT,100+,5,6,11
BARINGO,EAST POKOT,Not Stated,-,-,-
BARINGO,KOIBATEK,Total,65295,64238,129533
BARINGO,KOIBATEK,0,1604,1510,3114
BARINGO,KOIBATEK,1,1634,1534,3168
BARINGO,KOIBATEK,2,1620,1514,3134
BARINGO,KOIBATEK,3,1708,1652,3360
BARINGO,KOIBATEK,4,1766,1679,3445
BARINGO,KOIBATEK,0 - 4,8332,7889,16221
BARINGO,KOIBATEK,5,1718,1635,3353
BARINGO,KOIBATEK,6,1685,1660,3345
BARINGO,KOIBATEK,7,1706,1662,3368
BARINGO,KOIBATEK,8,1450,1510,2960
BARINGO,KOIBATEK,9,1713,1728,3441
BARINGO,KOIBATEK,05-Sep,8272,8195,16467
BARINGO,KOIBATEK,10,1678,1704,3382
BARINGO,KOIBATEK,11,1704,1649,3353
BARINGO,KOIBATEK,12,1891,1722,3613
BARINGO,KOIBATEK,13,1808,1820,3628
BARINGO,KOIBATEK,14,1859,1752,3611
BARINGO,KOIBATEK,Oct-14,8940,8647,17587
BARINGO,KOIBATEK,15,1776,1714,3490
BARINGO,KOIBATEK,16,1615,1641,3256
BARINGO,KOIBATEK,17,1700,1676,3376
BARINGO,KOIBATEK,18,1311,1277,2588
BARINGO,KOIBATEK,19,1580,1510,3090
BARINGO,KOIBATEK,15-19,7982,7818,15800
BARINGO,KOIBATEK,20,1290,1288,2578
BARINGO,KOIBATEK,21,1287,1356,2643
BARINGO,KOIBATEK,22,1250,1219,2469
BARINGO,KOIBATEK,23,1302,1233,2535
BARINGO,KOIBATEK,24,1173,1207,2380
BARINGO,KOIBATEK,20-24,6302,6303,12605
BARINGO,KOIBATEK,25,1225,1207,2432
BARINGO,KOIBATEK,26,907,998,1905
BARINGO,KOIBATEK,27,997,984,1981
BARINGO,KOIBATEK,28,777,758,1535
BARINGO,KOIBATEK,29,854,914,1768
BARINGO,KOIBATEK,25-29,4760,4861,9621
BARINGO,KOIBATEK,30,1099,1104,2203
BARINGO,KOIBATEK,31,769,737,1506
BARINGO,KOIBATEK,32,925,978,1903
BARINGO,KOIBATEK,33,869,891,1760
BARINGO,KOIBATEK,34,758,781,1539
BARINGO,KOIBATEK,30-34,4420,4491,8911
BARINGO,KOIBATEK,35,1066,1025,2091
BARINGO,KOIBATEK,36,704,661,1365
BARINGO,KOIBATEK,37,802,646,1448
BARINGO,KOIBATEK,38,517,504,1021
BARINGO,KOIBATEK,39,640,615,1255
BARINGO,KOIBATEK,35-39,3729,3451,7180
BARINGO,KOIBATEK,40,719,688,1407
BARINGO,KOIBATEK,41,742,659,1401
BARINGO,KOIBATEK,42,604,619,1223
BARINGO,KOIBATEK,43,563,565,1128
BARINGO,KOIBATEK,44,392,408,800
BARINGO,KOIBATEK,40-44,3020,2939,5959
BARINGO,KOIBATEK,45,861,777,1638
BARINGO,KOIBATEK,46,497,482,979
BARINGO,KOIBATEK,47,530,522,1052
BARINGO,KOIBATEK,48,353,335,688
BARINGO,KOIBATEK,49,414,434,848
BARINGO,KOIBATEK,45-49,2655,2550,5205
BARINGO,KOIBATEK,50,496,511,1007
BARINGO,KOIBATEK,51,406,373,779
BARINGO,KOIBATEK,52,329,352,681
BARINGO,KOIBATEK,53,296,274,570
BARINGO,KOIBATEK,54,344,299,643
BARINGO,KOIBATEK,50-54,1871,1809,3680
BARINGO,KOIBATEK,55,320,244,564
BARINGO,KOIBATEK,56,322,298,620
BARINGO,KOIBATEK,57,308,358,666
BARINGO,KOIBATEK,58,313,359,672
BARINGO,KOIBATEK,59,328,279,607
BARINGO,KOIBATEK,55-59,1591,1538,3129
BARINGO,KOIBATEK,60,348,353,701
BARINGO,KOIBATEK,61,297,243,540
BARINGO,KOIBATEK,62,180,168,348
BARINGO,KOIBATEK,63,198,176,374
BARINGO,KOIBATEK,64,124,147,271
BARINGO,KOIBATEK,60-64,1147,1087,2234
BARINGO,KOIBATEK,65,217,217,434
BARINGO,KOIBATEK,66,114,129,243
BARINGO,KOIBATEK,67,228,228,456
BARINGO,KOIBATEK,68,95,107,202
BARINGO,KOIBATEK,69,163,181,344
BARINGO,KOIBATEK,65-69,817,862,1679
BARINGO,KOIBATEK,70,205,223,428
BARINGO,KOIBATEK,71,160,152,312
BARINGO,KOIBATEK,72,102,115,217
BARINGO,KOIBATEK,73,73,106,179
BARINGO,KOIBATEK,74,95,103,198
BARINGO,KOIBATEK,70-74,635,699,1334
BARINGO,KOIBATEK,75,85,101,186
BARINGO,KOIBATEK,76,79,82,161
BARINGO,KOIBATEK,77,69,88,157
BARINGO,KOIBATEK,78,50,53,103
BARINGO,KOIBATEK,79,71,116,187
BARINGO,KOIBATEK,75-79,354,440,794
BARINGO,KOIBATEK,80,78,123,201
BARINGO,KOIBATEK,81,44,51,95
BARINGO,KOIBATEK,82,32,41,73
BARINGO,KOIBATEK,83,44,60,104
BARINGO,KOIBATEK,84,46,51,97
BARINGO,KOIBATEK,80-84,244,326,570
BARINGO,KOIBATEK,85,29,44,73
BARINGO,KOIBATEK,86,31,26,57
BARINGO,KOIBATEK,87,28,29,57
BARINGO,KOIBATEK,88,8,18,26
BARINGO,KOIBATEK,89,27,56,83
BARINGO,KOIBATEK,85-89,123,173,296
BARINGO,KOIBATEK,90,17,37,54
BARINGO,KOIBATEK,91,13,11,24
BARINGO,KOIBATEK,92,11,14,25
BARINGO,KOIBATEK,93,7,10,17
BARINGO,KOIBATEK,94,8,13,21
BARINGO,KOIBATEK,90-94,56,85,141
BARINGO,KOIBATEK,95,13,27,40
BARINGO,KOIBATEK,96,4,3,7
BARINGO,KOIBATEK,97,5,8,13
BARINGO,KOIBATEK,98,2,8,10
BARINGO,KOIBATEK,99,4,14,18
BARINGO,KOIBATEK,95-99,28,60,88
BARINGO,KOIBATEK,100+,17,15,32
BARINGO,KOIBATEK,Not Stated,-,-,-
BARINGO,MARIGAT,Total,45706,45246,90952
BARINGO,MARIGAT,0,1315,1243,2558
BARINGO,MARIGAT,1,1360,1373,2733
BARINGO,MARIGAT,2,1557,1459,3016
BARINGO,MARIGAT,3,1597,1626,3223
BARINGO,MARIGAT,4,1672,1565,3237
BARINGO,MARIGAT,0 - 4,7501,7266,14767
BARINGO,MARIGAT,5,1641,1553,3194
BARINGO,MARIGAT,6,1548,1482,3030
BARINGO,MARIGAT,7,1421,1442,2863
BARINGO,MARIGAT,8,1392,1360,2752
BARINGO,MARIGAT,9,1328,1267,2595
BARINGO,MARIGAT,05-Sep,7330,7104,14434
BARINGO,MARIGAT,10,1725,1531,3256
BARINGO,MARIGAT,11,1145,1136,2281
BARINGO,MARIGAT,12,1652,1547,3199
BARINGO,MARIGAT,13,1394,1329,2723
BARINGO,MARIGAT,14,1355,1298,2653
BARINGO,MARIGAT,Oct-14,7271,6841,14112
BARINGO,MARIGAT,15,1342,1213,2555
BARINGO,MARIGAT,16,1163,1049,2212
BARINGO,MARIGAT,17,1155,983,2138
BARINGO,MARIGAT,18,840,802,1642
BARINGO,MARIGAT,19,855,901,1756
BARINGO,MARIGAT,15-19,5355,4948,10303
BARINGO,MARIGAT,20,884,984,1868
BARINGO,MARIGAT,21,806,891,1697
BARINGO,MARIGAT,22,748,866,1614
BARINGO,MARIGAT,23,812,814,1626
BARINGO,MARIGAT,24,704,712,1416
BARINGO,MARIGAT,20-24,3954,4267,8221
BARINGO,MARIGAT,25,890,897,1787
BARINGO,MARIGAT,26,561,643,1204
BARINGO,MARIGAT,27,606,663,1269
BARINGO,MARIGAT,28,528,613,1141
BARINGO,MARIGAT,29,504,543,1047
BARINGO,MARIGAT,25-29,3089,3359,6448
BARINGO,MARIGAT,30,747,878,1625
BARINGO,MARIGAT,31,475,544,1019
BARINGO,MARIGAT,32,559,577,1136
BARINGO,MARIGAT,33,440,454,894
BARINGO,MARIGAT,34,378,363,741
BARINGO,MARIGAT,30-34,2599,2816,5415
BARINGO,MARIGAT,35,645,655,1300
BARINGO,MARIGAT,36,356,297,653
BARINGO,MARIGAT,37,333,293,626
BARINGO,MARIGAT,38,241,218,459
BARINGO,MARIGAT,39,291,249,540
BARINGO,MARIGAT,35-39,1866,1712,3578
BARINGO,MARIGAT,40,437,363,800
BARINGO,MARIGAT,41,441,367,808
BARINGO,MARIGAT,42,353,263,616
BARINGO,MARIGAT,43,213,229,442
BARINGO,MARIGAT,44,157,171,328
BARINGO,MARIGAT,40-44,1601,1393,2994
BARINGO,MARIGAT,45,472,489,961
BARINGO,MARIGAT,46,204,271,475
BARINGO,MARIGAT,47,266,256,522
BARINGO,MARIGAT,48,131,133,264
BARINGO,MARIGAT,49,193,161,354
BARINGO,MARIGAT,45-49,1266,1310,2576
BARINGO,MARIGAT,50,278,329,607
BARINGO,MARIGAT,51,187,176,363
BARINGO,MARIGAT,52,141,179,320
BARINGO,MARIGAT,53,132,150,282
BARINGO,MARIGAT,54,198,209,407
BARINGO,MARIGAT,50-54,936,1043,1979
BARINGO,MARIGAT,55,169,148,317
BARINGO,MARIGAT,56,134,155,289
BARINGO,MARIGAT,57,165,175,340
BARINGO,MARIGAT,58,189,178,367
BARINGO,MARIGAT,59,167,224,391
BARINGO,MARIGAT,55-59,824,880,1704
BARINGO,MARIGAT,60,260,290,550
BARINGO,MARIGAT,61,160,137,297
BARINGO,MARIGAT,62,117,100,217
BARINGO,MARIGAT,63,115,145,260
BARINGO,MARIGAT,64,74,74,148
BARINGO,MARIGAT,60-64,726,746,1472
BARINGO,MARIGAT,65,173,167,340
BARINGO,MARIGAT,66,74,57,131
BARINGO,MARIGAT,67,126,96,222
BARINGO,MARIGAT,68,74,62,136
BARINGO,MARIGAT,69,103,115,218
BARINGO,MARIGAT,65-69,550,497,1047
BARINGO,MARIGAT,70,141,195,336
BARINGO,MARIGAT,71,86,97,183
BARINGO,MARIGAT,72,69,60,129
BARINGO,MARIGAT,73,53,48,101
BARINGO,MARIGAT,74,62,49,111
BARINGO,MARIGAT,70-74,411,449,860
BARINGO,MARIGAT,75,65,67,132
BARINGO,MARIGAT,76,43,31,74
BARINGO,MARIGAT,77,44,35,79
BARINGO,MARIGAT,78,24,25,49
BARINGO,MARIGAT,79,49,80,129
BARINGO,MARIGAT,75-79,225,238,463
BARINGO,MARIGAT,80,51,65,116
BARINGO,MARIGAT,81,18,46,64
BARINGO,MARIGAT,82,11,16,27
BARINGO,MARIGAT,83,11,21,32
BARINGO,MARIGAT,84,21,29,50
BARINGO,MARIGAT,80-84,112,177,289
BARINGO,MARIGAT,85,8,29,37
BARINGO,MARIGAT,86,9,14,23
BARINGO,MARIGAT,87,15,17,32
BARINGO,MARIGAT,88,4,10,14
BARINGO,MARIGAT,89,16,47,63
BARINGO,MARIGAT,85-89,52,117,169
BARINGO,MARIGAT,90,5,17,22
BARINGO,MARIGAT,91,5,8,13
BARINGO,MARIGAT,92,2,5,7
BARINGO,MARIGAT,93,2,6,8
BARINGO,MARIGAT,94,5,6,11
BARINGO,MARIGAT,90-94,19,42,61
BARINGO,MARIGAT,95,2,11,13
BARINGO,MARIGAT,96,1,4,5
BARINGO,MARIGAT,97,2,4,6
BARINGO,MARIGAT,98,-,7,7
BARINGO,MARIGAT,99,4,3,7
BARINGO,MARIGAT,95-99,9,29,38
BARINGO,MARIGAT,100+,9,12,21
BARINGO,MARIGAT,Not Stated,1,-,1
BARINGO,MOGOTIO,Total,46014,45088,91102
BARINGO,MOGOTIO,0,1192,1082,2274
BARINGO,MOGOTIO,1,1192,1150,2342
BARINGO,MOGOTIO,2,1285,1297,2582
BARINGO,MOGOTIO,3,1415,1416,2831
BARINGO,MOGOTIO,4,1418,1320,2738
BARINGO,MOGOTIO,0 - 4,6502,6265,12767
BARINGO,MOGOTIO,5,1425,1306,2731
BARINGO,MOGOTIO,6,1357,1328,2685
BARINGO,MOGOTIO,7,1345,1271,2616
BARINGO,MOGOTIO,8,1223,1137,2360
BARINGO,MOGOTIO,9,1259,1243,2502
BARINGO,MOGOTIO,05-Sep,6609,6285,12894
BARINGO,MOGOTIO,10,1372,1357,2729
BARINGO,MOGOTIO,11,1206,1224,2430
BARINGO,MOGOTIO,12,1399,1342,2741
BARINGO,MOGOTIO,13,1362,1327,2689
BARINGO,MOGOTIO,14,1302,1210,2512
BARINGO,MOGOTIO,Oct-14,6641,6460,13101
BARINGO,MOGOTIO,15,1372,1306,2678
BARINGO,MOGOTIO,16,1128,1159,2287
BARINGO,MOGOTIO,17,1272,1118,2390
BARINGO,MOGOTIO,18,847,894,1741
BARINGO,MOGOTIO,19,1125,1053,2178
BARINGO,MOGOTIO,15-19,5744,5530,11274
BARINGO,MOGOTIO,20,984,932,1916
BARINGO,MOGOTIO,21,991,940,1931
BARINGO,MOGOTIO,22,901,875,1776
BARINGO,MOGOTIO,23,862,958,1820
BARINGO,MOGOTIO,24,797,790,1587
BARINGO,MOGOTIO,20-24,4535,4495,9030
BARINGO,MOGOTIO,25,864,837,1701
BARINGO,MOGOTIO,26,657,634,1291
BARINGO,MOGOTIO,27,621,659,1280
BARINGO,MOGOTIO,28,443,496,939
BARINGO,MOGOTIO,29,608,629,1237
BARINGO,MOGOTIO,25-29,3193,3255,6448
BARINGO,MOGOTIO,30,662,707,1369
BARINGO,MOGOTIO,31,486,490,976
BARINGO,MOGOTIO,32,553,575,1128
BARINGO,MOGOTIO,33,524,583,1107
BARINGO,MOGOTIO,34,433,453,886
BARINGO,MOGOTIO,30-34,2658,2808,5466
BARINGO,MOGOTIO,35,670,621,1291
BARINGO,MOGOTIO,36,402,386,788
BARINGO,MOGOTIO,37,444,366,810
BARINGO,MOGOTIO,38,271,273,544
BARINGO,MOGOTIO,39,419,332,751
BARINGO,MOGOTIO,35-39,2206,1978,4184
BARINGO,MOGOTIO,40,483,356,839
BARINGO,MOGOTIO,41,456,362,818
BARINGO,MOGOTIO,42,336,314,650
BARINGO,MOGOTIO,43,311,294,605
BARINGO,MOGOTIO,44,230,226,456
BARINGO,MOGOTIO,40-44,1816,1552,3368
BARINGO,MOGOTIO,45,484,470,954
BARINGO,MOGOTIO,46,321,342,663
BARINGO,MOGOTIO,47,318,323,641
BARINGO,MOGOTIO,48,206,175,381
BARINGO,MOGOTIO,49,241,250,491
BARINGO,MOGOTIO,45-49,1570,1560,3130
BARINGO,MOGOTIO,50,274,284,558
BARINGO,MOGOTIO,51,253,245,498
BARINGO,MOGOTIO,52,211,206,417
BARINGO,MOGOTIO,53,143,161,304
BARINGO,MOGOTIO,54,197,231,428
BARINGO,MOGOTIO,50-54,1078,1127,2205
BARINGO,MOGOTIO,55,166,124,290
BARINGO,MOGOTIO,56,176,175,351
BARINGO,MOGOTIO,57,170,212,382
BARINGO,MOGOTIO,58,242,257,499
BARINGO,MOGOTIO,59,202,187,389
BARINGO,MOGOTIO,55-59,956,955,1911
BARINGO,MOGOTIO,60,214,209,423
BARINGO,MOGOTIO,61,169,157,326
BARINGO,MOGOTIO,62,142,131,273
BARINGO,MOGOTIO,63,131,122,253
BARINGO,MOGOTIO,64,90,101,191
BARINGO,MOGOTIO,60-64,746,720,1466
BARINGO,MOGOTIO,65,171,197,368
BARINGO,MOGOTIO,66,101,71,172
BARINGO,MOGOTIO,67,199,153,352
BARINGO,MOGOTIO,68,85,81,166
BARINGO,MOGOTIO,69,124,131,255
BARINGO,MOGOTIO,65-69,680,633,1313
BARINGO,MOGOTIO,70,148,235,383
BARINGO,MOGOTIO,71,118,117,235
BARINGO,MOGOTIO,72,64,94,158
BARINGO,MOGOTIO,73,60,78,138
BARINGO,MOGOTIO,74,74,93,167
BARINGO,MOGOTIO,70-74,464,617,1081
BARINGO,MOGOTIO,75,77,75,152
BARINGO,MOGOTIO,76,48,59,107
BARINGO,MOGOTIO,77,52,55,107
BARINGO,MOGOTIO,78,27,38,65
BARINGO,MOGOTIO,79,48,81,129
BARINGO,MOGOTIO,75-79,252,308,560
BARINGO,MOGOTIO,80,68,108,176
BARINGO,MOGOTIO,81,23,48,71
BARINGO,MOGOTIO,82,20,24,44
BARINGO,MOGOTIO,83,28,29,57
BARINGO,MOGOTIO,84,35,46,81
BARINGO,MOGOTIO,80-84,174,255,429
BARINGO,MOGOTIO,85,31,28,59
BARINGO,MOGOTIO,86,19,26,45
BARINGO,MOGOTIO,87,20,26,46
BARINGO,MOGOTIO,88,15,15,30
BARINGO,MOGOTIO,89,36,55,91
BARINGO,MOGOTIO,85-89,121,150,271
BARINGO,MOGOTIO,90,13,26,39
BARINGO,MOGOTIO,91,5,12,17
BARINGO,MOGOTIO,92,5,7,12
BARINGO,MOGOTIO,93,6,5,11
BARINGO,MOGOTIO,94,5,15,20
BARINGO,MOGOTIO,90-94,34,65,99
BARINGO,MOGOTIO,95,10,13,23
BARINGO,MOGOTIO,96,4,8,12
BARINGO,MOGOTIO,97,2,6,8
BARINGO,MOGOTIO,98,1,1,2
BARINGO,MOGOTIO,99,4,15,19
BARINGO,MOGOTIO,95-99,21,43,64
BARINGO,MOGOTIO,100+,14,27,41
BARINGO,MOGOTIO,Not Stated,-,-,-
BARINGO,TIATY EAST,Total,38356,35068,73424
BARINGO,TIATY EAST,0,1003,1044,2047
BARINGO,TIATY EAST,1,953,955,1908
BARINGO,TIATY EAST,2,1433,1373,2806
BARINGO,TIATY EAST,3,1237,1195,2432
BARINGO,TIATY EAST,4,1422,1296,2718
BARINGO,TIATY EAST,0 - 4,6048,5863,11911
BARINGO,TIATY EAST,5,1421,1352,2773
BARINGO,TIATY EAST,6,1593,1408,3001
BARINGO,TIATY EAST,7,1130,956,2086
BARINGO,TIATY EAST,8,1683,1540,3223
BARINGO,TIATY EAST,9,1113,963,2076
BARINGO,TIATY EAST,05-Sep,6940,6219,13159
BARINGO,TIATY EAST,10,2274,1952,4226
BARINGO,TIATY EAST,11,806,811,1617
BARINGO,TIATY EAST,12,1789,1369,3158
BARINGO,TIATY EAST,13,1110,840,1950
BARINGO,TIATY EAST,14,1132,953,2085
BARINGO,TIATY EAST,Oct-14,7111,5925,13036
BARINGO,TIATY EAST,15,1518,1124,2642
BARINGO,TIATY EAST,16,1070,837,1907
BARINGO,TIATY EAST,17,971,704,1675
BARINGO,TIATY EAST,18,1054,774,1828
BARINGO,TIATY EAST,19,792,690,1482
BARINGO,TIATY EAST,15-19,5405,4129,9534
BARINGO,TIATY EAST,20,1282,1130,2412
BARINGO,TIATY EAST,21,554,489,1043
BARINGO,TIATY EAST,22,580,578,1158
BARINGO,TIATY EAST,23,535,500,1035
BARINGO,TIATY EAST,24,482,469,951
BARINGO,TIATY EAST,20-24,3433,3166,6599
BARINGO,TIATY EAST,25,786,788,1574
BARINGO,TIATY EAST,26,402,399,801
BARINGO,TIATY EAST,27,428,433,861
BARINGO,TIATY EAST,28,435,488,923
BARINGO,TIATY EAST,29,369,385,754
BARINGO,TIATY EAST,25-29,2420,2493,4913
BARINGO,TIATY EAST,30,858,951,1809
BARINGO,TIATY EAST,31,224,297,521
BARINGO,TIATY EAST,32,317,342,659
BARINGO,TIATY EAST,33,187,222,409
BARINGO,TIATY EAST,34,172,149,321
BARINGO,TIATY EAST,30-34,1758,1961,3719
BARINGO,TIATY EAST,35,607,695,1302
BARINGO,TIATY EAST,36,165,197,362
BARINGO,TIATY EAST,37,140,153,293
BARINGO,TIATY EAST,38,153,219,372
BARINGO,TIATY EAST,39,147,163,310
BARINGO,TIATY EAST,35-39,1212,1427,2639
BARINGO,TIATY EAST,40,617,473,1090
BARINGO,TIATY EAST,41,188,182,370
BARINGO,TIATY EAST,42,208,164,372
BARINGO,TIATY EAST,43,110,123,233
BARINGO,TIATY EAST,44,93,96,189
BARINGO,TIATY EAST,40-44,1216,1038,2254
BARINGO,TIATY EAST,45,402,245,647
BARINGO,TIATY EAST,46,131,170,301
BARINGO,TIATY EAST,47,90,97,187
BARINGO,TIATY EAST,48,112,109,221
BARINGO,TIATY EAST,49,100,123,223
BARINGO,TIATY EAST,45-49,835,744,1579
BARINGO,TIATY EAST,50,292,289,581
BARINGO,TIATY EAST,51,74,78,152
BARINGO,TIATY EAST,52,72,82,154
BARINGO,TIATY EAST,53,47,47,94
BARINGO,TIATY EAST,54,99,69,168
BARINGO,TIATY EAST,50-54,584,565,1149
BARINGO,TIATY EAST,55,115,93,208
BARINGO,TIATY EAST,56,93,81,174
BARINGO,TIATY EAST,57,46,42,88
BARINGO,TIATY EAST,58,63,43,106
BARINGO,TIATY EAST,59,65,86,151
BARINGO,TIATY EAST,55-59,382,345,727
BARINGO,TIATY EAST,60,190,209,399
BARINGO,TIATY EAST,61,36,30,66
BARINGO,TIATY EAST,62,33,45,78
BARINGO,TIATY EAST,63,37,40,77
BARINGO,TIATY EAST,64,21,27,48
BARINGO,TIATY EAST,60-64,317,351,668
BARINGO,TIATY EAST,65,96,118,214
BARINGO,TIATY EAST,66,26,21,47
BARINGO,TIATY EAST,67,47,46,93
BARINGO,TIATY EAST,68,33,36,69
BARINGO,TIATY EAST,69,63,85,148
BARINGO,TIATY EAST,65-69,265,306,571
BARINGO,TIATY EAST,70,112,137,249
BARINGO,TIATY EAST,71,30,24,54
BARINGO,TIATY EAST,72,31,36,67
BARINGO,TIATY EAST,73,20,21,41
BARINGO,TIATY EAST,74,28,32,60
BARINGO,TIATY EAST,70-74,221,250,471
BARINGO,TIATY EAST,75,39,42,81
BARINGO,TIATY EAST,76,6,16,22
BARINGO,TIATY EAST,77,11,12,23
BARINGO,TIATY EAST,78,16,19,35
BARINGO,TIATY EAST,79,31,30,61
BARINGO,TIATY EAST,75-79,103,119,222
BARINGO,TIATY EAST,80,43,65,108
BARINGO,TIATY EAST,81,6,8,14
BARINGO,TIATY EAST,82,4,11,15
BARINGO,TIATY EAST,83,2,6,8
BARINGO,TIATY EAST,84,4,5,9
BARINGO,TIATY EAST,80-84,59,95,154
BARINGO,TIATY EAST,85,5,16,21
BARINGO,TIATY EAST,86,3,3,6
BARINGO,TIATY EAST,87,7,3,10
BARINGO,TIATY EAST,88,1,3,4
BARINGO,TIATY EAST,89,8,13,21
BARINGO,TIATY EAST,85-89,24,38,62
BARINGO,TIATY EAST,90,4,7,11
BARINGO,TIATY EAST,91,4,2,6
BARINGO,TIATY EAST,92,-,-,-
BARINGO,TIATY EAST,93,2,5,7
BARINGO,TIATY EAST,94,3,3,6
BARINGO,TIATY EAST,90-94,13,17,30
BARINGO,TIATY EAST,95,2,4,6
BARINGO,TIATY EAST,96,1,2,3
BARINGO,TIATY EAST,97,2,2,4
BARINGO,TIATY EAST,98,-,1,1
BARINGO,TIATY EAST,99,2,1,3
BARINGO,TIATY EAST,95-99,7,10,17
BARINGO,TIATY EAST,100+,3,7,10
BARINGO,TIATY EAST,Not Stated,-,-,-
BOMET,ALL,Total,434287,441379,875666
BOMET,ALL,0,10015,9753,19768
BOMET,ALL,1,10566,10389,20955
BOMET,ALL,2,11425,10948,22373
BOMET,ALL,3,11684,11715,23399
BOMET,ALL,4,12577,11904,24481
BOMET,ALL,0 - 4,56267,54709,110976
BOMET,ALL,5,12433,11415,23848
BOMET,ALL,6,12065,11755,23820
BOMET,ALL,7,12707,12397,25104
BOMET,ALL,8,11516,11202,22718
BOMET,ALL,9,13689,13281,26970
BOMET,ALL,05-Sep,62410,60050,122460
BOMET,ALL,10,13311,12742,26053
BOMET,ALL,11,12635,12880,25515
BOMET,ALL,12,13747,13278,27025
BOMET,ALL,13,13317,13689,27006
BOMET,ALL,14,12936,12813,25749
BOMET,ALL,Oct-14,65946,65402,131348
BOMET,ALL,15,13204,12799,26003
BOMET,ALL,16,11709,11619,23328
BOMET,ALL,17,11456,10622,22078
BOMET,ALL,18,8701,8300,17001
BOMET,ALL,19,11030,10569,21599
BOMET,ALL,15-19,56100,53909,110009
BOMET,ALL,20,8280,8864,17144
BOMET,ALL,21,8221,9254,17475
BOMET,ALL,22,7331,8195,15526
BOMET,ALL,23,7645,8978,16623
BOMET,ALL,24,6758,7666,14424
BOMET,ALL,20-24,38235,42957,81192
BOMET,ALL,25,7516,8033,15549
BOMET,ALL,26,6224,7034,13258
BOMET,ALL,27,6532,7467,13999
BOMET,ALL,28,4824,5714,10538
BOMET,ALL,29,5738,6904,12642
BOMET,ALL,25-29,30834,35152,65986
BOMET,ALL,30,6590,8239,14829
BOMET,ALL,31,5220,6516,11736
BOMET,ALL,32,6442,7470,13912
BOMET,ALL,33,5659,6738,12397
BOMET,ALL,34,4978,5235,10213
BOMET,ALL,30-34,28889,34198,63087
BOMET,ALL,35,6455,5719,12174
BOMET,ALL,36,4151,3159,7310
BOMET,ALL,37,4586,3374,7960
BOMET,ALL,38,2716,2095,4811
BOMET,ALL,39,3869,2912,6781
BOMET,ALL,35-39,21777,17259,39036
BOMET,ALL,40,4381,3618,7999
BOMET,ALL,41,5024,4674,9698
BOMET,ALL,42,3617,3413,7030
BOMET,ALL,43,3222,3308,6530
BOMET,ALL,44,2381,2573,4954
BOMET,ALL,40-44,18625,17586,36211
BOMET,ALL,45,5403,4588,9991
BOMET,ALL,46,3198,3248,6446
BOMET,ALL,47,3478,3611,7089
BOMET,ALL,48,1694,1739,3433
BOMET,ALL,49,2559,2823,5382
BOMET,ALL,45-49,16332,16009,32341
BOMET,ALL,50,2657,2723,5380
BOMET,ALL,51,2512,2412,4924
BOMET,ALL,52,1593,1564,3157
BOMET,ALL,53,1182,1215,2397
BOMET,ALL,54,1514,1446,2960
BOMET,ALL,50-54,9458,9360,18818
BOMET,ALL,55,1300,1385,2685
BOMET,ALL,56,1311,1360,2671
BOMET,ALL,57,1591,1871,3462
BOMET,ALL,58,2391,3272,5663
BOMET,ALL,59,1962,1808,3770
BOMET,ALL,55-59,8555,9696,18251
BOMET,ALL,60,1918,2029,3947
BOMET,ALL,61,1621,1627,3248
BOMET,ALL,62,1196,1224,2420
BOMET,ALL,63,1264,1332,2596
BOMET,ALL,64,936,979,1915
BOMET,ALL,60-64,6935,7191,14126
BOMET,ALL,65,1447,1655,3102
BOMET,ALL,66,845,803,1648
BOMET,ALL,67,1320,1385,2705
BOMET,ALL,68,539,628,1167
BOMET,ALL,69,938,1107,2045
BOMET,ALL,65-69,5089,5578,10667
BOMET,ALL,70,1099,1428,2527
BOMET,ALL,71,1099,961,2060
BOMET,ALL,72,708,645,1353
BOMET,ALL,73,606,641,1247
BOMET,ALL,74,523,795,1318
BOMET,ALL,70-74,4035,4470,8505
BOMET,ALL,75,489,711,1200
BOMET,ALL,76,358,478,836
BOMET,ALL,77,490,569,1059
BOMET,ALL,78,235,281,516
BOMET,ALL,79,384,821,1205
BOMET,ALL,75-79,1956,2860,4816
BOMET,ALL,80,392,769,1161
BOMET,ALL,81,225,474,699
BOMET,ALL,82,218,245,463
BOMET,ALL,83,236,274,510
BOMET,ALL,84,248,446,694
BOMET,ALL,80-84,1319,2208,3527
BOMET,ALL,85,176,300,476
BOMET,ALL,86,160,173,333
BOMET,ALL,87,209,274,483
BOMET,ALL,88,104,150,254
BOMET,ALL,89,209,543,752
BOMET,ALL,85-89,858,1440,2298
BOMET,ALL,90,109,278,387
BOMET,ALL,91,74,166,240
BOMET,ALL,92,55,88,143
BOMET,ALL,93,51,94,145
BOMET,ALL,94,59,146,205
BOMET,ALL,90-94,348,772,1120
BOMET,ALL,95,102,117,219
BOMET,ALL,96,34,37,71
BOMET,ALL,97,45,40,85
BOMET,ALL,98,20,41,61
BOMET,ALL,99,42,129,171
BOMET,ALL,95-99,243,364,607
BOMET,ALL,100+,73,207,280
BOMET,ALL,Not Stated,3,2,5
BOMET,BOMET EAST,Total,71095,73172,144267
BOMET,BOMET EAST,0,1837,1679,3516
BOMET,BOMET EAST,1,1788,1853,3641
BOMET,BOMET EAST,2,2087,1898,3985
BOMET,BOMET EAST,3,2063,2025,4088
BOMET,BOMET EAST,4,2240,2009,4249
BOMET,BOMET EAST,0 - 4,10015,9464,19479
BOMET,BOMET EAST,5,2197,1913,4110
BOMET,BOMET EAST,6,2156,1935,4091
BOMET,BOMET EAST,7,2274,2081,4355
BOMET,BOMET EAST,8,1964,1850,3814
BOMET,BOMET EAST,9,2289,2240,4529
BOMET,BOMET EAST,05-Sep,10880,10019,20899
BOMET,BOMET EAST,10,2304,2180,4484
BOMET,BOMET EAST,11,2125,2088,4213
BOMET,BOMET EAST,12,2254,2293,4547
BOMET,BOMET EAST,13,2237,2199,4436
BOMET,BOMET EAST,14,2156,2067,4223
BOMET,BOMET EAST,Oct-14,11076,10827,21903
BOMET,BOMET EAST,15,2125,2132,4257
BOMET,BOMET EAST,16,1955,1842,3797
BOMET,BOMET EAST,17,1857,1749,3606
BOMET,BOMET EAST,18,1469,1339,2808
BOMET,BOMET EAST,19,1931,1761,3692
BOMET,BOMET EAST,15-19,9337,8823,18160
BOMET,BOMET EAST,20,1380,1500,2880
BOMET,BOMET EAST,21,1372,1556,2928
BOMET,BOMET EAST,22,1108,1367,2475
BOMET,BOMET EAST,23,1194,1430,2624
BOMET,BOMET EAST,24,1052,1316,2368
BOMET,BOMET EAST,20-24,6106,7169,13275
BOMET,BOMET EAST,25,1092,1235,2327
BOMET,BOMET EAST,26,922,1062,1984
BOMET,BOMET EAST,27,1051,1156,2207
BOMET,BOMET EAST,28,733,870,1603
BOMET,BOMET EAST,29,919,1112,2031
BOMET,BOMET EAST,25-29,4717,5435,10152
BOMET,BOMET EAST,30,1042,1333,2375
BOMET,BOMET EAST,31,764,1085,1849
BOMET,BOMET EAST,32,937,1093,2030
BOMET,BOMET EAST,33,886,1075,1961
BOMET,BOMET EAST,34,796,926,1722
BOMET,BOMET EAST,30-34,4425,5512,9937
BOMET,BOMET EAST,35,936,907,1843
BOMET,BOMET EAST,36,575,461,1036
BOMET,BOMET EAST,37,668,562,1230
BOMET,BOMET EAST,38,366,300,666
BOMET,BOMET EAST,39,522,429,951
BOMET,BOMET EAST,35-39,3067,2659,5726
BOMET,BOMET EAST,40,603,577,1180
BOMET,BOMET EAST,41,739,818,1557
BOMET,BOMET EAST,42,548,610,1158
BOMET,BOMET EAST,43,516,574,1090
BOMET,BOMET EAST,44,370,462,832
BOMET,BOMET EAST,40-44,2776,3041,5817
BOMET,BOMET EAST,45,758,725,1483
BOMET,BOMET EAST,46,487,528,1015
BOMET,BOMET EAST,47,520,561,1081
BOMET,BOMET EAST,48,231,257,488
BOMET,BOMET EAST,49,381,556,937
BOMET,BOMET EAST,45-49,2377,2627,5004
BOMET,BOMET EAST,50,407,426,833
BOMET,BOMET EAST,51,455,424,879
BOMET,BOMET EAST,52,244,232,476
BOMET,BOMET EAST,53,169,174,343
BOMET,BOMET EAST,54,228,238,466
BOMET,BOMET EAST,50-54,1503,1494,2997
BOMET,BOMET EAST,55,190,243,433
BOMET,BOMET EAST,56,182,210,392
BOMET,BOMET EAST,57,264,291,555
BOMET,BOMET EAST,58,379,572,951
BOMET,BOMET EAST,59,285,289,574
BOMET,BOMET EAST,55-59,1300,1605,2905
BOMET,BOMET EAST,60,296,370,666
BOMET,BOMET EAST,61,280,273,553
BOMET,BOMET EAST,62,195,210,405
BOMET,BOMET EAST,63,202,237,439
BOMET,BOMET EAST,64,188,191,379
BOMET,BOMET EAST,60-64,1161,1281,2442
BOMET,BOMET EAST,65,249,282,531
BOMET,BOMET EAST,66,139,127,266
BOMET,BOMET EAST,67,217,258,475
BOMET,BOMET EAST,68,85,122,207
BOMET,BOMET EAST,69,172,202,374
BOMET,BOMET EAST,65-69,862,991,1853
BOMET,BOMET EAST,70,184,245,429
BOMET,BOMET EAST,71,174,168,342
BOMET,BOMET EAST,72,115,119,234
BOMET,BOMET EAST,73,86,108,194
BOMET,BOMET EAST,74,80,158,238
BOMET,BOMET EAST,70-74,639,798,1437
BOMET,BOMET EAST,75,87,136,223
BOMET,BOMET EAST,76,82,104,186
BOMET,BOMET EAST,77,89,102,191
BOMET,BOMET EAST,78,41,58,99
BOMET,BOMET EAST,79,71,158,229
BOMET,BOMET EAST,75-79,370,558,928
BOMET,BOMET EAST,80,80,139,219
BOMET,BOMET EAST,81,40,77,117
BOMET,BOMET EAST,82,39,35,74
BOMET,BOMET EAST,83,34,52,86
BOMET,BOMET EAST,84,40,80,120
BOMET,BOMET EAST,80-84,233,383,616
BOMET,BOMET EAST,85,33,60,93
BOMET,BOMET EAST,86,25,32,57
BOMET,BOMET EAST,87,27,58,85
BOMET,BOMET EAST,88,17,29,46
BOMET,BOMET EAST,89,33,102,135
BOMET,BOMET EAST,85-89,135,281,416
BOMET,BOMET EAST,90,26,45,71
BOMET,BOMET EAST,91,11,25,36
BOMET,BOMET EAST,92,10,11,21
BOMET,BOMET EAST,93,8,16,24
BOMET,BOMET EAST,94,13,24,37
BOMET,BOMET EAST,90-94,68,121,189
BOMET,BOMET EAST,95,20,18,38
BOMET,BOMET EAST,96,4,10,14
BOMET,BOMET EAST,97,8,7,15
BOMET,BOMET EAST,98,2,11,13
BOMET,BOMET EAST,99,4,10,14
BOMET,BOMET EAST,95-99,38,56,94
BOMET,BOMET EAST,100+,10,28,38
BOMET,BOMET EAST,Not Stated,-,-,-
BOMET,CHEPALUNGU,Total,79921,84912,164833
BOMET,CHEPALUNGU,0,1896,1931,3827
BOMET,CHEPALUNGU,1,1955,1994,3949
BOMET,CHEPALUNGU,2,2338,2191,4529
BOMET,CHEPALUNGU,3,2351,2262,4613
BOMET,CHEPALUNGU,4,2442,2380,4822
BOMET,CHEPALUNGU,0 - 4,10982,10758,21740
BOMET,CHEPALUNGU,5,2512,2330,4842
BOMET,CHEPALUNGU,6,2331,2258,4589
BOMET,CHEPALUNGU,7,2618,2532,5150
BOMET,CHEPALUNGU,8,2327,2283,4610
BOMET,CHEPALUNGU,9,2806,2739,5545
BOMET,CHEPALUNGU,05-Sep,12594,12142,24736
BOMET,CHEPALUNGU,10,2671,2604,5275
BOMET,CHEPALUNGU,11,2498,2612,5110
BOMET,CHEPALUNGU,12,2748,2666,5414
BOMET,CHEPALUNGU,13,2739,2780,5519
BOMET,CHEPALUNGU,14,2595,2528,5123
BOMET,CHEPALUNGU,Oct-14,13251,13190,26441
BOMET,CHEPALUNGU,15,2662,2567,5229
BOMET,CHEPALUNGU,16,2279,2373,4652
BOMET,CHEPALUNGU,17,2272,2147,4419
BOMET,CHEPALUNGU,18,1557,1520,3077
BOMET,CHEPALUNGU,19,2109,2077,4186
BOMET,CHEPALUNGU,15-19,10879,10684,21563
BOMET,CHEPALUNGU,20,1491,1687,3178
BOMET,CHEPALUNGU,21,1387,1693,3080
BOMET,CHEPALUNGU,22,1247,1489,2736
BOMET,CHEPALUNGU,23,1331,1586,2917
BOMET,CHEPALUNGU,24,1095,1298,2393
BOMET,CHEPALUNGU,20-24,6551,7753,14304
BOMET,CHEPALUNGU,25,1208,1374,2582
BOMET,CHEPALUNGU,26,964,1207,2171
BOMET,CHEPALUNGU,27,922,1326,2248
BOMET,CHEPALUNGU,28,713,977,1690
BOMET,CHEPALUNGU,29,884,1161,2045
BOMET,CHEPALUNGU,25-29,4691,6045,10736
BOMET,CHEPALUNGU,30,1027,1373,2400
BOMET,CHEPALUNGU,31,789,1221,2010
BOMET,CHEPALUNGU,32,1035,1336,2371
BOMET,CHEPALUNGU,33,866,1180,2046
BOMET,CHEPALUNGU,34,739,826,1565
BOMET,CHEPALUNGU,30-34,4456,5936,10392
BOMET,CHEPALUNGU,35,989,921,1910
BOMET,CHEPALUNGU,36,565,496,1061
BOMET,CHEPALUNGU,37,663,574,1237
BOMET,CHEPALUNGU,38,419,367,786
BOMET,CHEPALUNGU,39,611,446,1057
BOMET,CHEPALUNGU,35-39,3247,2804,6051
BOMET,CHEPALUNGU,40,713,609,1322
BOMET,CHEPALUNGU,41,903,983,1886
BOMET,CHEPALUNGU,42,616,627,1243
BOMET,CHEPALUNGU,43,539,627,1166
BOMET,CHEPALUNGU,44,443,508,951
BOMET,CHEPALUNGU,40-44,3214,3354,6568
BOMET,CHEPALUNGU,45,868,810,1678
BOMET,CHEPALUNGU,46,529,610,1139
BOMET,CHEPALUNGU,47,653,749,1402
BOMET,CHEPALUNGU,48,285,366,651
BOMET,CHEPALUNGU,49,441,538,979
BOMET,CHEPALUNGU,45-49,2776,3073,5849
BOMET,CHEPALUNGU,50,433,496,929
BOMET,CHEPALUNGU,51,414,466,880
BOMET,CHEPALUNGU,52,253,300,553
BOMET,CHEPALUNGU,53,219,222,441
BOMET,CHEPALUNGU,54,265,277,542
BOMET,CHEPALUNGU,50-54,1584,1761,3345
BOMET,CHEPALUNGU,55,204,276,480
BOMET,CHEPALUNGU,56,257,259,516
BOMET,CHEPALUNGU,57,297,335,632
BOMET,CHEPALUNGU,58,440,681,1121
BOMET,CHEPALUNGU,59,349,394,743
BOMET,CHEPALUNGU,55-59,1547,1945,3492
BOMET,CHEPALUNGU,60,338,445,783
BOMET,CHEPALUNGU,61,290,334,624
BOMET,CHEPALUNGU,62,216,246,462
BOMET,CHEPALUNGU,63,243,271,514
BOMET,CHEPALUNGU,64,172,205,377
BOMET,CHEPALUNGU,60-64,1259,1501,2760
BOMET,CHEPALUNGU,65,269,319,588
BOMET,CHEPALUNGU,66,182,150,332
BOMET,CHEPALUNGU,67,236,297,533
BOMET,CHEPALUNGU,68,105,117,222
BOMET,CHEPALUNGU,69,206,266,472
BOMET,CHEPALUNGU,65-69,998,1149,2147
BOMET,CHEPALUNGU,70,231,313,544
BOMET,CHEPALUNGU,71,238,219,457
BOMET,CHEPALUNGU,72,127,162,289
BOMET,CHEPALUNGU,73,132,156,288
BOMET,CHEPALUNGU,74,115,176,291
BOMET,CHEPALUNGU,70-74,843,1026,1869
BOMET,CHEPALUNGU,75,102,152,254
BOMET,CHEPALUNGU,76,75,98,173
BOMET,CHEPALUNGU,77,105,98,203
BOMET,CHEPALUNGU,78,46,64,110
BOMET,CHEPALUNGU,79,80,204,284
BOMET,CHEPALUNGU,75-79,408,616,1024
BOMET,CHEPALUNGU,80,79,168,247
BOMET,CHEPALUNGU,81,58,124,182
BOMET,CHEPALUNGU,82,34,65,99
BOMET,CHEPALUNGU,83,47,51,98
BOMET,CHEPALUNGU,84,56,124,180
BOMET,CHEPALUNGU,80-84,274,532,806
BOMET,CHEPALUNGU,85,47,67,114
BOMET,CHEPALUNGU,86,31,31,62
BOMET,CHEPALUNGU,87,45,55,100
BOMET,CHEPALUNGU,88,29,28,57
BOMET,CHEPALUNGU,89,50,142,192
BOMET,CHEPALUNGU,85-89,202,323,525
BOMET,CHEPALUNGU,90,26,65,91
BOMET,CHEPALUNGU,91,22,37,59
BOMET,CHEPALUNGU,92,10,19,29
BOMET,CHEPALUNGU,93,11,34,45
BOMET,CHEPALUNGU,94,19,38,57
BOMET,CHEPALUNGU,90-94,88,193,281
BOMET,CHEPALUNGU,95,21,28,49
BOMET,CHEPALUNGU,96,12,7,19
BOMET,CHEPALUNGU,97,10,9,19
BOMET,CHEPALUNGU,98,4,11,15
BOMET,CHEPALUNGU,99,10,28,38
BOMET,CHEPALUNGU,95-99,57,83,140
BOMET,CHEPALUNGU,100+,20,44,64
BOMET,CHEPALUNGU,Not Stated,-,-,-
BOMET,KONOIN,Total,83120,80384,163504
BOMET,KONOIN,0,1659,1620,3279
BOMET,KONOIN,1,1947,1985,3932
BOMET,KONOIN,2,2034,1987,4021
BOMET,KONOIN,3,2057,2080,4137
BOMET,KONOIN,4,2273,2136,4409
BOMET,KONOIN,0 - 4,9970,9808,19778
BOMET,KONOIN,5,2191,2034,4225
BOMET,KONOIN,6,2272,2143,4415
BOMET,KONOIN,7,2223,2271,4494
BOMET,KONOIN,8,2067,2089,4156
BOMET,KONOIN,9,2464,2390,4854
BOMET,KONOIN,05-Sep,11217,10927,22144
BOMET,KONOIN,10,2397,2239,4636
BOMET,KONOIN,11,2257,2286,4543
BOMET,KONOIN,12,2493,2373,4866
BOMET,KONOIN,13,2347,2433,4780
BOMET,KONOIN,14,2299,2342,4641
BOMET,KONOIN,Oct-14,11793,11673,23466
BOMET,KONOIN,15,2428,2263,4691
BOMET,KONOIN,16,2143,2117,4260
BOMET,KONOIN,17,2001,1890,3891
BOMET,KONOIN,18,1680,1542,3222
BOMET,KONOIN,19,1921,1915,3836
BOMET,KONOIN,15-19,10173,9727,19900
BOMET,KONOIN,20,1532,1618,3150
BOMET,KONOIN,21,1580,1666,3246
BOMET,KONOIN,22,1469,1521,2990
BOMET,KONOIN,23,1476,1719,3195
BOMET,KONOIN,24,1390,1430,2820
BOMET,KONOIN,20-24,7447,7954,15401
BOMET,KONOIN,25,1580,1701,3281
BOMET,KONOIN,26,1343,1395,2738
BOMET,KONOIN,27,1434,1498,2932
BOMET,KONOIN,28,1086,1239,2325
BOMET,KONOIN,29,1197,1412,2609
BOMET,KONOIN,25-29,6640,7245,13885
BOMET,KONOIN,30,1386,1557,2943
BOMET,KONOIN,31,1154,1208,2362
BOMET,KONOIN,32,1426,1527,2953
BOMET,KONOIN,33,1188,1285,2473
BOMET,KONOIN,34,1034,954,1988
BOMET,KONOIN,30-34,6188,6531,12719
BOMET,KONOIN,35,1390,1042,2432
BOMET,KONOIN,36,952,667,1619
BOMET,KONOIN,37,1019,679,1698
BOMET,KONOIN,38,649,410,1059
BOMET,KONOIN,39,899,615,1514
BOMET,KONOIN,35-39,4909,3413,8322
BOMET,KONOIN,40,1015,758,1773
BOMET,KONOIN,41,1142,856,1998
BOMET,KONOIN,42,837,632,1469
BOMET,KONOIN,43,666,658,1324
BOMET,KONOIN,44,523,443,966
BOMET,KONOIN,40-44,4183,3347,7530
BOMET,KONOIN,45,1187,893,2080
BOMET,KONOIN,46,722,589,1311
BOMET,KONOIN,47,718,637,1355
BOMET,KONOIN,48,399,311,710
BOMET,KONOIN,49,529,490,1019
BOMET,KONOIN,45-49,3555,2920,6475
BOMET,KONOIN,50,558,529,1087
BOMET,KONOIN,51,521,418,939
BOMET,KONOIN,52,337,283,620
BOMET,KONOIN,53,229,176,405
BOMET,KONOIN,54,290,203,493
BOMET,KONOIN,50-54,1935,1609,3544
BOMET,KONOIN,55,232,184,416
BOMET,KONOIN,56,216,194,410
BOMET,KONOIN,57,286,343,629
BOMET,KONOIN,58,500,543,1043
BOMET,KONOIN,59,354,271,625
BOMET,KONOIN,55-59,1588,1535,3123
BOMET,KONOIN,60,338,291,629
BOMET,KONOIN,61,275,276,551
BOMET,KONOIN,62,229,197,426
BOMET,KONOIN,63,207,200,407
BOMET,KONOIN,64,150,139,289
BOMET,KONOIN,60-64,1199,1103,2302
BOMET,KONOIN,65,255,255,510
BOMET,KONOIN,66,158,129,287
BOMET,KONOIN,67,220,204,424
BOMET,KONOIN,68,104,111,215
BOMET,KONOIN,69,143,155,298
BOMET,KONOIN,65-69,880,854,1734
BOMET,KONOIN,70,192,199,391
BOMET,KONOIN,71,188,139,327
BOMET,KONOIN,72,123,78,201
BOMET,KONOIN,73,110,101,211
BOMET,KONOIN,74,96,109,205
BOMET,KONOIN,70-74,709,626,1335
BOMET,KONOIN,75,70,94,164
BOMET,KONOIN,76,54,70,124
BOMET,KONOIN,77,83,92,175
BOMET,KONOIN,78,29,39,68
BOMET,KONOIN,79,59,111,170
BOMET,KONOIN,75-79,295,406,701
BOMET,KONOIN,80,66,132,198
BOMET,KONOIN,81,39,56,95
BOMET,KONOIN,82,30,19,49
BOMET,KONOIN,83,40,33,73
BOMET,KONOIN,84,42,70,112
BOMET,KONOIN,80-84,217,310,527
BOMET,KONOIN,85,25,34,59
BOMET,KONOIN,86,27,33,60
BOMET,KONOIN,87,33,49,82
BOMET,KONOIN,88,15,25,40
BOMET,KONOIN,89,33,79,112
BOMET,KONOIN,85-89,133,220,353
BOMET,KONOIN,90,16,36,52
BOMET,KONOIN,91,11,20,31
BOMET,KONOIN,92,12,10,22
BOMET,KONOIN,93,7,8,15
BOMET,KONOIN,94,5,18,23
BOMET,KONOIN,90-94,51,92,143
BOMET,KONOIN,95,13,18,31
BOMET,KONOIN,96,5,4,9
BOMET,KONOIN,97,10,3,13
BOMET,KONOIN,98,2,7,9
BOMET,KONOIN,99,5,25,30
BOMET,KONOIN,95-99,35,57,92
BOMET,KONOIN,100+,3,27,30
BOMET,KONOIN,Not Stated,-,-,-
BOMET,SOTIK,Total,112369,115482,227851
BOMET,SOTIK,0,2556,2560,5116
BOMET,SOTIK,1,2786,2634,5420
BOMET,SOTIK,2,2789,2757,5546
BOMET,SOTIK,3,2978,3018,5996
BOMET,SOTIK,4,3207,3081,6288
BOMET,SOTIK,0 - 4,14316,14050,28366
BOMET,SOTIK,5,3197,2959,6156
BOMET,SOTIK,6,3037,3092,6129
BOMET,SOTIK,7,3245,3202,6447
BOMET,SOTIK,8,2983,2881,5864
BOMET,SOTIK,9,3586,3559,7145
BOMET,SOTIK,05-Sep,16048,15693,31741
BOMET,SOTIK,10,3520,3410,6930
BOMET,SOTIK,11,3353,3545,6898
BOMET,SOTIK,12,3682,3509,7191
BOMET,SOTIK,13,3535,3653,7188
BOMET,SOTIK,14,3463,3430,6893
BOMET,SOTIK,Oct-14,17553,17547,35100
BOMET,SOTIK,15,3528,3461,6989
BOMET,SOTIK,16,3102,3076,6178
BOMET,SOTIK,17,3121,2731,5852
BOMET,SOTIK,18,2267,2257,4524
BOMET,SOTIK,19,2917,2700,5617
BOMET,SOTIK,15-19,14935,14225,29160
BOMET,SOTIK,20,2142,2197,4339
BOMET,SOTIK,21,2019,2309,4328
BOMET,SOTIK,22,1848,2029,3877
BOMET,SOTIK,23,1875,2277,4152
BOMET,SOTIK,24,1680,1925,3605
BOMET,SOTIK,20-24,9564,10737,20301
BOMET,SOTIK,25,1890,1975,3865
BOMET,SOTIK,26,1560,1805,3365
BOMET,SOTIK,27,1603,1883,3486
BOMET,SOTIK,28,1164,1406,2570
BOMET,SOTIK,29,1411,1768,3179
BOMET,SOTIK,25-29,7628,8837,16465
BOMET,SOTIK,30,1653,2164,3817
BOMET,SOTIK,31,1265,1656,2921
BOMET,SOTIK,32,1624,2019,3643
BOMET,SOTIK,33,1409,1654,3063
BOMET,SOTIK,34,1270,1390,2660
BOMET,SOTIK,30-34,7221,8883,16104
BOMET,SOTIK,35,1633,1567,3200
BOMET,SOTIK,36,1095,822,1917
BOMET,SOTIK,37,1228,873,2101
BOMET,SOTIK,38,720,563,1283
BOMET,SOTIK,39,988,772,1760
BOMET,SOTIK,35-39,5664,4597,10261
BOMET,SOTIK,40,1176,991,2167
BOMET,SOTIK,41,1239,1201,2440
BOMET,SOTIK,42,941,880,1821
BOMET,SOTIK,43,787,800,1587
BOMET,SOTIK,44,593,643,1236
BOMET,SOTIK,40-44,4736,4515,9251
BOMET,SOTIK,45,1423,1200,2623
BOMET,SOTIK,46,800,887,1687
BOMET,SOTIK,47,881,964,1845
BOMET,SOTIK,48,428,458,886
BOMET,SOTIK,49,722,728,1450
BOMET,SOTIK,45-49,4254,4237,8491
BOMET,SOTIK,50,701,720,1421
BOMET,SOTIK,51,652,610,1262
BOMET,SOTIK,52,459,446,905
BOMET,SOTIK,53,360,433,793
BOMET,SOTIK,54,420,442,862
BOMET,SOTIK,50-54,2592,2651,5243
BOMET,SOTIK,55,401,403,804
BOMET,SOTIK,56,378,413,791
BOMET,SOTIK,57,408,518,926
BOMET,SOTIK,58,621,900,1521
BOMET,SOTIK,59,554,531,1085
BOMET,SOTIK,55-59,2362,2765,5127
BOMET,SOTIK,60,537,544,1081
BOMET,SOTIK,61,433,432,865
BOMET,SOTIK,62,324,345,669
BOMET,SOTIK,63,339,368,707
BOMET,SOTIK,64,255,249,504
BOMET,SOTIK,60-64,1888,1938,3826
BOMET,SOTIK,65,369,471,840
BOMET,SOTIK,66,202,246,448
BOMET,SOTIK,67,358,348,706
BOMET,SOTIK,68,143,184,327
BOMET,SOTIK,69,235,308,543
BOMET,SOTIK,65-69,1307,1557,2864
BOMET,SOTIK,70,299,421,720
BOMET,SOTIK,71,260,251,511
BOMET,SOTIK,72,177,162,339
BOMET,SOTIK,73,161,161,322
BOMET,SOTIK,74,128,203,331
BOMET,SOTIK,70-74,1025,1198,2223
BOMET,SOTIK,75,141,197,338
BOMET,SOTIK,76,72,119,191
BOMET,SOTIK,77,128,164,292
BOMET,SOTIK,78,65,69,134
BOMET,SOTIK,79,101,207,308
BOMET,SOTIK,75-79,507,756,1263
BOMET,SOTIK,80,103,223,326
BOMET,SOTIK,81,62,123,185
BOMET,SOTIK,82,63,72,135
BOMET,SOTIK,83,68,81,149
BOMET,SOTIK,84,67,93,160
BOMET,SOTIK,80-84,363,592,955
BOMET,SOTIK,85,45,68,113
BOMET,SOTIK,86,43,40,83
BOMET,SOTIK,87,63,61,124
BOMET,SOTIK,88,28,43,71
BOMET,SOTIK,89,49,121,170
BOMET,SOTIK,85-89,228,333,561
BOMET,SOTIK,90,27,75,102
BOMET,SOTIK,91,18,42,60
BOMET,SOTIK,92,15,32,47
BOMET,SOTIK,93,15,18,33
BOMET,SOTIK,94,12,33,45
BOMET,SOTIK,90-94,87,200,287
BOMET,SOTIK,95,30,24,54
BOMET,SOTIK,96,10,6,16
BOMET,SOTIK,97,10,14,24
BOMET,SOTIK,98,8,5,13
BOMET,SOTIK,99,7,46,53
BOMET,SOTIK,95-99,65,95,160
BOMET,SOTIK,100+,26,75,101
BOMET,SOTIK,Not Stated,-,1,1
BOMET,BOMET CENTRAL,Total,87782,87429,175211
BOMET,BOMET CENTRAL,0,2067,1963,4030
BOMET,BOMET CENTRAL,1,2090,1923,4013
BOMET,BOMET CENTRAL,2,2177,2115,4292
BOMET,BOMET CENTRAL,3,2235,2330,4565
BOMET,BOMET CENTRAL,4,2415,2298,4713
BOMET,BOMET CENTRAL,0 - 4,10984,10629,21613
BOMET,BOMET CENTRAL,5,2336,2179,4515
BOMET,BOMET CENTRAL,6,2269,2327,4596
BOMET,BOMET CENTRAL,7,2347,2311,4658
BOMET,BOMET CENTRAL,8,2175,2099,4274
BOMET,BOMET CENTRAL,9,2544,2353,4897
BOMET,BOMET CENTRAL,05-Sep,11671,11269,22940
BOMET,BOMET CENTRAL,10,2419,2309,4728
BOMET,BOMET CENTRAL,11,2402,2349,4751
BOMET,BOMET CENTRAL,12,2570,2437,5007
BOMET,BOMET CENTRAL,13,2459,2624,5083
BOMET,BOMET CENTRAL,14,2423,2446,4869
BOMET,BOMET CENTRAL,Oct-14,12273,12165,24438
BOMET,BOMET CENTRAL,15,2461,2376,4837
BOMET,BOMET CENTRAL,16,2230,2211,4441
BOMET,BOMET CENTRAL,17,2205,2105,4310
BOMET,BOMET CENTRAL,18,1728,1642,3370
BOMET,BOMET CENTRAL,19,2152,2116,4268
BOMET,BOMET CENTRAL,15-19,10776,10450,21226
BOMET,BOMET CENTRAL,20,1735,1862,3597
BOMET,BOMET CENTRAL,21,1863,2030,3893
BOMET,BOMET CENTRAL,22,1659,1789,3448
BOMET,BOMET CENTRAL,23,1769,1966,3735
BOMET,BOMET CENTRAL,24,1541,1697,3238
BOMET,BOMET CENTRAL,20-24,8567,9344,17911
BOMET,BOMET CENTRAL,25,1746,1748,3494
BOMET,BOMET CENTRAL,26,1435,1565,3000
BOMET,BOMET CENTRAL,27,1522,1604,3126
BOMET,BOMET CENTRAL,28,1128,1222,2350
BOMET,BOMET CENTRAL,29,1327,1451,2778
BOMET,BOMET CENTRAL,25-29,7158,7590,14748
BOMET,BOMET CENTRAL,30,1482,1812,3294
BOMET,BOMET CENTRAL,31,1248,1346,2594
BOMET,BOMET CENTRAL,32,1420,1495,2915
BOMET,BOMET CENTRAL,33,1310,1544,2854
BOMET,BOMET CENTRAL,34,1139,1139,2278
BOMET,BOMET CENTRAL,30-34,6599,7336,13935
BOMET,BOMET CENTRAL,35,1507,1282,2789
BOMET,BOMET CENTRAL,36,964,713,1677
BOMET,BOMET CENTRAL,37,1008,686,1694
BOMET,BOMET CENTRAL,38,562,455,1017
BOMET,BOMET CENTRAL,39,849,650,1499
BOMET,BOMET CENTRAL,35-39,4890,3786,8676
BOMET,BOMET CENTRAL,40,874,683,1557
BOMET,BOMET CENTRAL,41,1001,816,1817
BOMET,BOMET CENTRAL,42,675,664,1339
BOMET,BOMET CENTRAL,43,714,649,1363
BOMET,BOMET CENTRAL,44,452,517,969
BOMET,BOMET CENTRAL,40-44,3716,3329,7045
BOMET,BOMET CENTRAL,45,1167,960,2127
BOMET,BOMET CENTRAL,46,660,634,1294
BOMET,BOMET CENTRAL,47,706,700,1406
BOMET,BOMET CENTRAL,48,351,347,698
BOMET,BOMET CENTRAL,49,486,511,997
BOMET,BOMET CENTRAL,45-49,3370,3152,6522
BOMET,BOMET CENTRAL,50,558,552,1110
BOMET,BOMET CENTRAL,51,470,494,964
BOMET,BOMET CENTRAL,52,300,303,603
BOMET,BOMET CENTRAL,53,205,210,415
BOMET,BOMET CENTRAL,54,311,286,597
BOMET,BOMET CENTRAL,50-54,1844,1845,3689
BOMET,BOMET CENTRAL,55,273,279,552
BOMET,BOMET CENTRAL,56,278,284,562
BOMET,BOMET CENTRAL,57,336,384,720
BOMET,BOMET CENTRAL,58,451,576,1027
BOMET,BOMET CENTRAL,59,420,323,743
BOMET,BOMET CENTRAL,55-59,1758,1846,3604
BOMET,BOMET CENTRAL,60,409,379,788
BOMET,BOMET CENTRAL,61,343,312,655
BOMET,BOMET CENTRAL,62,232,226,458
BOMET,BOMET CENTRAL,63,273,256,529
BOMET,BOMET CENTRAL,64,171,195,366
BOMET,BOMET CENTRAL,60-64,1428,1368,2796
BOMET,BOMET CENTRAL,65,305,328,633
BOMET,BOMET CENTRAL,66,164,151,315
BOMET,BOMET CENTRAL,67,289,278,567
BOMET,BOMET CENTRAL,68,102,94,196
BOMET,BOMET CENTRAL,69,182,176,358
BOMET,BOMET CENTRAL,65-69,1042,1027,2069
BOMET,BOMET CENTRAL,70,193,250,443
BOMET,BOMET CENTRAL,71,239,184,423
BOMET,BOMET CENTRAL,72,166,124,290
BOMET,BOMET CENTRAL,73,117,115,232
BOMET,BOMET CENTRAL,74,104,149,253
BOMET,BOMET CENTRAL,70-74,819,822,1641
BOMET,BOMET CENTRAL,75,89,132,221
BOMET,BOMET CENTRAL,76,75,87,162
BOMET,BOMET CENTRAL,77,85,113,198
BOMET,BOMET CENTRAL,78,54,51,105
BOMET,BOMET CENTRAL,79,73,141,214
BOMET,BOMET CENTRAL,75-79,376,524,900
BOMET,BOMET CENTRAL,80,64,107,171
BOMET,BOMET CENTRAL,81,26,94,120
BOMET,BOMET CENTRAL,82,52,54,106
BOMET,BOMET CENTRAL,83,47,57,104
BOMET,BOMET CENTRAL,84,43,79,122
BOMET,BOMET CENTRAL,80-84,232,391,623
BOMET,BOMET CENTRAL,85,26,71,97
BOMET,BOMET CENTRAL,86,34,37,71
BOMET,BOMET CENTRAL,87,41,51,92
BOMET,BOMET CENTRAL,88,15,25,40
BOMET,BOMET CENTRAL,89,44,99,143
BOMET,BOMET CENTRAL,85-89,160,283,443
BOMET,BOMET CENTRAL,90,14,57,71
BOMET,BOMET CENTRAL,91,12,42,54
BOMET,BOMET CENTRAL,92,8,16,24
BOMET,BOMET CENTRAL,93,10,18,28
BOMET,BOMET CENTRAL,94,10,33,43
BOMET,BOMET CENTRAL,90-94,54,166,220
BOMET,BOMET CENTRAL,95,18,29,47
BOMET,BOMET CENTRAL,96,3,10,13
BOMET,BOMET CENTRAL,97,7,7,14
BOMET,BOMET CENTRAL,98,4,7,11
BOMET,BOMET CENTRAL,99,16,20,36
BOMET,BOMET CENTRAL,95-99,48,73,121
BOMET,BOMET CENTRAL,100+,14,33,47
BOMET,BOMET CENTRAL,Not Stated,3,1,4
BUNGOMA,ALL,Total,812146,858389,1670535
BUNGOMA,ALL,0,19903,20290,40193
BUNGOMA,ALL,1,20926,21076,42002
BUNGOMA,ALL,2,21576,21681,43257
BUNGOMA,ALL,3,23106,23590,46696
BUNGOMA,ALL,4,23594,23432,47026
BUNGOMA,ALL,0 - 4,109105,110069,219174
BUNGOMA,ALL,5,25439,24790,50229
BUNGOMA,ALL,6,25041,25479,50520
BUNGOMA,ALL,7,25199,25081,50280
BUNGOMA,ALL,8,23313,23875,47188
BUNGOMA,ALL,9,27830,27261,55091
BUNGOMA,ALL,05-Sep,126822,126486,253308
BUNGOMA,ALL,10,27036,27013,54049
BUNGOMA,ALL,11,25654,26436,52090
BUNGOMA,ALL,12,27412,26868,54280
BUNGOMA,ALL,13,27634,28358,55992
BUNGOMA,ALL,14,25297,25246,50543
BUNGOMA,ALL,Oct-14,133033,133921,266954
BUNGOMA,ALL,15,25840,25347,51187
BUNGOMA,ALL,16,22352,22670,45022
BUNGOMA,ALL,17,23783,23071,46854
BUNGOMA,ALL,18,17525,16457,33982
BUNGOMA,ALL,19,19837,18940,38777
BUNGOMA,ALL,15-19,109337,106485,215822
BUNGOMA,ALL,20,15497,16646,32143
BUNGOMA,ALL,21,13828,14901,28729
BUNGOMA,ALL,22,12263,14158,26421
BUNGOMA,ALL,23,13097,15338,28435
BUNGOMA,ALL,24,10930,13119,24049
BUNGOMA,ALL,20-24,65615,74162,139777
BUNGOMA,ALL,25,12374,14866,27240
BUNGOMA,ALL,26,9712,11968,21680
BUNGOMA,ALL,27,10713,12502,23215
BUNGOMA,ALL,28,7514,9228,16742
BUNGOMA,ALL,29,9144,10568,19712
BUNGOMA,ALL,25-29,49457,59132,108589
BUNGOMA,ALL,30,10799,13518,24317
BUNGOMA,ALL,31,9101,11776,20877
BUNGOMA,ALL,32,10807,13350,24157
BUNGOMA,ALL,33,8598,10288,18886
BUNGOMA,ALL,34,7310,8068,15378
BUNGOMA,ALL,30-34,46615,57000,103615
BUNGOMA,ALL,35,9550,9492,19042
BUNGOMA,ALL,36,7206,7007,14213
BUNGOMA,ALL,37,7463,7112,14575
BUNGOMA,ALL,38,5287,5551,10838
BUNGOMA,ALL,39,6256,6324,12580
BUNGOMA,ALL,35-39,35762,35486,71248
BUNGOMA,ALL,40,6845,7255,14100
BUNGOMA,ALL,41,7080,7959,15039
BUNGOMA,ALL,42,6950,7614,14564
BUNGOMA,ALL,43,6552,7071,13623
BUNGOMA,ALL,44,4608,4967,9575
BUNGOMA,ALL,40-44,32035,34866,66901
BUNGOMA,ALL,45,7471,7277,14748
BUNGOMA,ALL,46,5428,5512,10940
BUNGOMA,ALL,47,5819,5843,11662
BUNGOMA,ALL,48,3580,3895,7475
BUNGOMA,ALL,49,4286,4314,8600
BUNGOMA,ALL,45-49,26584,26841,53425
BUNGOMA,ALL,50,4737,5538,10275
BUNGOMA,ALL,51,4259,4809,9068
BUNGOMA,ALL,52,3660,4022,7682
BUNGOMA,ALL,53,3107,3895,7002
BUNGOMA,ALL,54,3262,3837,7099
BUNGOMA,ALL,50-54,19025,22101,41126
BUNGOMA,ALL,55,3791,4223,8014
BUNGOMA,ALL,56,3590,4181,7771
BUNGOMA,ALL,57,3867,5052,8919
BUNGOMA,ALL,58,2903,3384,6287
BUNGOMA,ALL,59,4277,4426,8703
BUNGOMA,ALL,55-59,18428,21266,39694
BUNGOMA,ALL,60,3765,3967,7732
BUNGOMA,ALL,61,3196,3624,6820
BUNGOMA,ALL,62,2490,2780,5270
BUNGOMA,ALL,63,2968,3480,6448
BUNGOMA,ALL,64,2059,2438,4497
BUNGOMA,ALL,60-64,14478,16289,30767
BUNGOMA,ALL,65,2782,3366,6148
BUNGOMA,ALL,66,1668,2099,3767
BUNGOMA,ALL,67,2225,2935,5160
BUNGOMA,ALL,68,1128,1364,2492
BUNGOMA,ALL,69,1943,2213,4156
BUNGOMA,ALL,65-69,9746,11977,21723
BUNGOMA,ALL,70,1699,2176,3875
BUNGOMA,ALL,71,1550,2034,3584
BUNGOMA,ALL,72,1214,1509,2723
BUNGOMA,ALL,73,1252,1646,2898
BUNGOMA,ALL,74,1035,1290,2325
BUNGOMA,ALL,70-74,6750,8655,15405
BUNGOMA,ALL,75,1001,1424,2425
BUNGOMA,ALL,76,808,1144,1952
BUNGOMA,ALL,77,977,1673,2650
BUNGOMA,ALL,78,634,713,1347
BUNGOMA,ALL,79,608,886,1494
BUNGOMA,ALL,75-79,4028,5840,9868
BUNGOMA,ALL,80,795,1111,1906
BUNGOMA,ALL,81,500,664,1164
BUNGOMA,ALL,82,509,660,1169
BUNGOMA,ALL,83,659,982,1641
BUNGOMA,ALL,84,378,479,857
BUNGOMA,ALL,80-84,2841,3896,6737
BUNGOMA,ALL,85,448,644,1092
BUNGOMA,ALL,86,255,412,667
BUNGOMA,ALL,87,451,708,1159
BUNGOMA,ALL,88,178,214,392
BUNGOMA,ALL,89,297,525,822
BUNGOMA,ALL,85-89,1629,2503,4132
BUNGOMA,ALL,90,177,217,394
BUNGOMA,ALL,91,166,239,405
BUNGOMA,ALL,92,96,156,252
BUNGOMA,ALL,93,68,155,223
BUNGOMA,ALL,94,48,81,129
BUNGOMA,ALL,90-94,555,848,1403
BUNGOMA,ALL,95,117,173,290
BUNGOMA,ALL,96,36,51,87
BUNGOMA,ALL,97,61,137,198
BUNGOMA,ALL,98,14,46,60
BUNGOMA,ALL,99,25,58,83
BUNGOMA,ALL,95-99,253,465,718
BUNGOMA,ALL,100+,41,100,141
BUNGOMA,ALL,Not Stated,7,1,8
BUNGOMA,BUMULA,Total,103368,112523,215891
BUNGOMA,BUMULA,0,2567,2674,5241
BUNGOMA,BUMULA,1,2619,2701,5320
BUNGOMA,BUMULA,2,2707,2797,5504
BUNGOMA,BUMULA,3,2990,3057,6047
BUNGOMA,BUMULA,4,3090,3093,6183
BUNGOMA,BUMULA,0 - 4,13973,14322,28295
BUNGOMA,BUMULA,5,3392,3443,6835
BUNGOMA,BUMULA,6,3354,3460,6814
BUNGOMA,BUMULA,7,3440,3357,6797
BUNGOMA,BUMULA,8,3185,3178,6363
BUNGOMA,BUMULA,9,3666,3690,7356
BUNGOMA,BUMULA,05-Sep,17037,17128,34165
BUNGOMA,BUMULA,10,3636,3637,7273
BUNGOMA,BUMULA,11,3537,3580,7117
BUNGOMA,BUMULA,12,3637,3609,7246
BUNGOMA,BUMULA,13,3644,3855,7499
BUNGOMA,BUMULA,14,3401,3437,6838
BUNGOMA,BUMULA,Oct-14,17855,18118,35973
BUNGOMA,BUMULA,15,3591,3444,7035
BUNGOMA,BUMULA,16,2942,3071,6013
BUNGOMA,BUMULA,17,3133,3136,6269
BUNGOMA,BUMULA,18,2168,2120,4288
BUNGOMA,BUMULA,19,2542,2445,4987
BUNGOMA,BUMULA,15-19,14376,14216,28592
BUNGOMA,BUMULA,20,1922,2147,4069
BUNGOMA,BUMULA,21,1787,1919,3706
BUNGOMA,BUMULA,22,1397,1715,3112
BUNGOMA,BUMULA,23,1478,1806,3284
BUNGOMA,BUMULA,24,1265,1680,2945
BUNGOMA,BUMULA,20-24,7849,9267,17116
BUNGOMA,BUMULA,25,1414,1887,3301
BUNGOMA,BUMULA,26,1114,1580,2694
BUNGOMA,BUMULA,27,1276,1604,2880
BUNGOMA,BUMULA,28,875,1200,2075
BUNGOMA,BUMULA,29,1040,1348,2388
BUNGOMA,BUMULA,25-29,5719,7619,13338
BUNGOMA,BUMULA,30,1183,1695,2878
BUNGOMA,BUMULA,31,1122,1592,2714
BUNGOMA,BUMULA,32,1237,1727,2964
BUNGOMA,BUMULA,33,950,1300,2250
BUNGOMA,BUMULA,34,822,940,1762
BUNGOMA,BUMULA,30-34,5314,7254,12568
BUNGOMA,BUMULA,35,1077,1106,2183
BUNGOMA,BUMULA,36,804,800,1604
BUNGOMA,BUMULA,37,937,851,1788
BUNGOMA,BUMULA,38,583,682,1265
BUNGOMA,BUMULA,39,802,725,1527
BUNGOMA,BUMULA,35-39,4203,4164,8367
BUNGOMA,BUMULA,40,742,841,1583
BUNGOMA,BUMULA,41,873,1003,1876
BUNGOMA,BUMULA,42,828,886,1714
BUNGOMA,BUMULA,43,848,951,1799
BUNGOMA,BUMULA,44,611,604,1215
BUNGOMA,BUMULA,40-44,3902,4285,8187
BUNGOMA,BUMULA,45,898,919,1817
BUNGOMA,BUMULA,46,595,643,1238
BUNGOMA,BUMULA,47,743,720,1463
BUNGOMA,BUMULA,48,403,442,845
BUNGOMA,BUMULA,49,474,502,976
BUNGOMA,BUMULA,45-49,3113,3226,6339
BUNGOMA,BUMULA,50,539,730,1269
BUNGOMA,BUMULA,51,558,692,1250
BUNGOMA,BUMULA,52,431,560,991
BUNGOMA,BUMULA,53,398,556,954
BUNGOMA,BUMULA,54,361,483,844
BUNGOMA,BUMULA,50-54,2287,3021,5308
BUNGOMA,BUMULA,55,523,535,1058
BUNGOMA,BUMULA,56,447,510,957
BUNGOMA,BUMULA,57,464,687,1151
BUNGOMA,BUMULA,58,340,386,726
BUNGOMA,BUMULA,59,554,586,1140
BUNGOMA,BUMULA,55-59,2328,2704,5032
BUNGOMA,BUMULA,60,442,544,986
BUNGOMA,BUMULA,61,400,494,894
BUNGOMA,BUMULA,62,319,332,651
BUNGOMA,BUMULA,63,366,538,904
BUNGOMA,BUMULA,64,255,332,587
BUNGOMA,BUMULA,60-64,1782,2240,4022
BUNGOMA,BUMULA,65,383,567,950
BUNGOMA,BUMULA,66,178,289,467
BUNGOMA,BUMULA,67,329,487,816
BUNGOMA,BUMULA,68,137,170,307
BUNGOMA,BUMULA,69,297,292,589
BUNGOMA,BUMULA,65-69,1324,1805,3129
BUNGOMA,BUMULA,70,227,294,521
BUNGOMA,BUMULA,71,208,339,547
BUNGOMA,BUMULA,72,159,196,355
BUNGOMA,BUMULA,73,174,254,428
BUNGOMA,BUMULA,74,149,198,347
BUNGOMA,BUMULA,70-74,917,1281,2198
BUNGOMA,BUMULA,75,159,229,388
BUNGOMA,BUMULA,76,133,137,270
BUNGOMA,BUMULA,77,159,244,403
BUNGOMA,BUMULA,78,110,114,224
BUNGOMA,BUMULA,79,89,118,207
BUNGOMA,BUMULA,75-79,650,842,1492
BUNGOMA,BUMULA,80,116,150,266
BUNGOMA,BUMULA,81,65,84,149
BUNGOMA,BUMULA,82,70,104,174
BUNGOMA,BUMULA,83,95,129,224
BUNGOMA,BUMULA,84,63,58,121
BUNGOMA,BUMULA,80-84,409,525,934
BUNGOMA,BUMULA,85,66,75,141
BUNGOMA,BUMULA,86,30,47,77
BUNGOMA,BUMULA,87,64,111,175
BUNGOMA,BUMULA,88,33,29,62
BUNGOMA,BUMULA,89,38,76,114
BUNGOMA,BUMULA,85-89,231,338,569
BUNGOMA,BUMULA,90,21,25,46
BUNGOMA,BUMULA,91,22,31,53
BUNGOMA,BUMULA,92,9,23,32
BUNGOMA,BUMULA,93,5,13,18
BUNGOMA,BUMULA,94,6,16,22
BUNGOMA,BUMULA,90-94,63,108,171
BUNGOMA,BUMULA,95,12,14,26
BUNGOMA,BUMULA,96,6,2,8
BUNGOMA,BUMULA,97,9,16,25
BUNGOMA,BUMULA,98,3,9,12
BUNGOMA,BUMULA,99,3,7,10
BUNGOMA,BUMULA,95-99,33,48,81
BUNGOMA,BUMULA,100+,3,12,15
BUNGOMA,BUMULA,Not Stated,-,-,-
BUNGOMA,BUNGOMA CENTRAL,Total,86302,91438,177740
BUNGOMA,BUNGOMA CENTRAL,0,2201,2160,4361
BUNGOMA,BUNGOMA CENTRAL,1,2220,2271,4491
BUNGOMA,BUNGOMA CENTRAL,2,2236,2299,4535
BUNGOMA,BUNGOMA CENTRAL,3,2413,2398,4811
BUNGOMA,BUNGOMA CENTRAL,4,2523,2438,4961
BUNGOMA,BUNGOMA CENTRAL,0 - 4,11593,11566,23159
BUNGOMA,BUNGOMA CENTRAL,5,2686,2578,5264
BUNGOMA,BUNGOMA CENTRAL,6,2577,2727,5304
BUNGOMA,BUNGOMA CENTRAL,7,2548,2632,5180
BUNGOMA,BUNGOMA CENTRAL,8,2435,2610,5045
BUNGOMA,BUNGOMA CENTRAL,9,2972,2893,5865
BUNGOMA,BUNGOMA CENTRAL,05-Sep,13218,13440,26658
BUNGOMA,BUNGOMA CENTRAL,10,2866,2933,5799
BUNGOMA,BUNGOMA CENTRAL,11,2610,2774,5384
BUNGOMA,BUNGOMA CENTRAL,12,2868,2903,5771
BUNGOMA,BUNGOMA CENTRAL,13,2848,3000,5848
BUNGOMA,BUNGOMA CENTRAL,14,2665,2814,5479
BUNGOMA,BUNGOMA CENTRAL,Oct-14,13857,14424,28281
BUNGOMA,BUNGOMA CENTRAL,15,2802,2738,5540
BUNGOMA,BUNGOMA CENTRAL,16,2411,2469,4880
BUNGOMA,BUNGOMA CENTRAL,17,2556,2435,4991
BUNGOMA,BUNGOMA CENTRAL,18,1902,1762,3664
BUNGOMA,BUNGOMA CENTRAL,19,2164,2007,4171
BUNGOMA,BUNGOMA CENTRAL,15-19,11835,11411,23246
BUNGOMA,BUNGOMA CENTRAL,20,1670,1742,3412
BUNGOMA,BUNGOMA CENTRAL,21,1431,1551,2982
BUNGOMA,BUNGOMA CENTRAL,22,1241,1451,2692
BUNGOMA,BUNGOMA CENTRAL,23,1421,1573,2994
BUNGOMA,BUNGOMA CENTRAL,24,1145,1337,2482
BUNGOMA,BUNGOMA CENTRAL,20-24,6908,7654,14562
BUNGOMA,BUNGOMA CENTRAL,25,1333,1592,2925
BUNGOMA,BUNGOMA CENTRAL,26,1064,1246,2310
BUNGOMA,BUNGOMA CENTRAL,27,1157,1329,2486
BUNGOMA,BUNGOMA CENTRAL,28,807,953,1760
BUNGOMA,BUNGOMA CENTRAL,29,980,1170,2150
BUNGOMA,BUNGOMA CENTRAL,25-29,5341,6290,11631
BUNGOMA,BUNGOMA CENTRAL,30,1095,1423,2518
BUNGOMA,BUNGOMA CENTRAL,31,937,1271,2208
BUNGOMA,BUNGOMA CENTRAL,32,1177,1383,2560
BUNGOMA,BUNGOMA CENTRAL,33,952,1098,2050
BUNGOMA,BUNGOMA CENTRAL,34,743,854,1597
BUNGOMA,BUNGOMA CENTRAL,30-34,4904,6029,10933
BUNGOMA,BUNGOMA CENTRAL,35,1036,1064,2100
BUNGOMA,BUNGOMA CENTRAL,36,733,708,1441
BUNGOMA,BUNGOMA CENTRAL,37,815,771,1586
BUNGOMA,BUNGOMA CENTRAL,38,609,631,1240
BUNGOMA,BUNGOMA CENTRAL,39,676,711,1387
BUNGOMA,BUNGOMA CENTRAL,35-39,3869,3885,7754
BUNGOMA,BUNGOMA CENTRAL,40,732,825,1557
BUNGOMA,BUNGOMA CENTRAL,41,783,878,1661
BUNGOMA,BUNGOMA CENTRAL,42,796,781,1577
BUNGOMA,BUNGOMA CENTRAL,43,678,777,1455
BUNGOMA,BUNGOMA CENTRAL,44,510,551,1061
BUNGOMA,BUNGOMA CENTRAL,40-44,3499,3812,7311
BUNGOMA,BUNGOMA CENTRAL,45,807,755,1562
BUNGOMA,BUNGOMA CENTRAL,46,545,592,1137
BUNGOMA,BUNGOMA CENTRAL,47,633,638,1271
BUNGOMA,BUNGOMA CENTRAL,48,374,392,766
BUNGOMA,BUNGOMA CENTRAL,49,466,448,914
BUNGOMA,BUNGOMA CENTRAL,45-49,2825,2825,5650
BUNGOMA,BUNGOMA CENTRAL,50,527,599,1126
BUNGOMA,BUNGOMA CENTRAL,51,474,480,954
BUNGOMA,BUNGOMA CENTRAL,52,404,423,827
BUNGOMA,BUNGOMA CENTRAL,53,305,419,724
BUNGOMA,BUNGOMA CENTRAL,54,358,390,748
BUNGOMA,BUNGOMA CENTRAL,50-54,2068,2311,4379
BUNGOMA,BUNGOMA CENTRAL,55,407,405,812
BUNGOMA,BUNGOMA CENTRAL,56,369,421,790
BUNGOMA,BUNGOMA CENTRAL,57,421,583,1004
BUNGOMA,BUNGOMA CENTRAL,58,314,372,686
BUNGOMA,BUNGOMA CENTRAL,59,461,457,918
BUNGOMA,BUNGOMA CENTRAL,55-59,1972,2238,4210
BUNGOMA,BUNGOMA CENTRAL,60,435,414,849
BUNGOMA,BUNGOMA CENTRAL,61,328,385,713
BUNGOMA,BUNGOMA CENTRAL,62,241,293,534
BUNGOMA,BUNGOMA CENTRAL,63,295,357,652
BUNGOMA,BUNGOMA CENTRAL,64,215,247,462
BUNGOMA,BUNGOMA CENTRAL,60-64,1514,1696,3210
BUNGOMA,BUNGOMA CENTRAL,65,312,380,692
BUNGOMA,BUNGOMA CENTRAL,66,186,224,410
BUNGOMA,BUNGOMA CENTRAL,67,218,306,524
BUNGOMA,BUNGOMA CENTRAL,68,124,155,279
BUNGOMA,BUNGOMA CENTRAL,69,202,274,476
BUNGOMA,BUNGOMA CENTRAL,65-69,1042,1339,2381
BUNGOMA,BUNGOMA CENTRAL,70,198,257,455
BUNGOMA,BUNGOMA CENTRAL,71,160,214,374
BUNGOMA,BUNGOMA CENTRAL,72,132,155,287
BUNGOMA,BUNGOMA CENTRAL,73,166,167,333
BUNGOMA,BUNGOMA CENTRAL,74,119,142,261
BUNGOMA,BUNGOMA CENTRAL,70-74,775,935,1710
BUNGOMA,BUNGOMA CENTRAL,75,130,150,280
BUNGOMA,BUNGOMA CENTRAL,76,103,124,227
BUNGOMA,BUNGOMA CENTRAL,77,100,206,306
BUNGOMA,BUNGOMA CENTRAL,78,76,94,170
BUNGOMA,BUNGOMA CENTRAL,79,63,98,161
BUNGOMA,BUNGOMA CENTRAL,75-79,472,672,1144
BUNGOMA,BUNGOMA CENTRAL,80,80,144,224
BUNGOMA,BUNGOMA CENTRAL,81,55,69,124
BUNGOMA,BUNGOMA CENTRAL,82,62,70,132
BUNGOMA,BUNGOMA CENTRAL,83,68,121,189
BUNGOMA,BUNGOMA CENTRAL,84,38,64,102
BUNGOMA,BUNGOMA CENTRAL,80-84,303,468,771
BUNGOMA,BUNGOMA CENTRAL,85,60,84,144
BUNGOMA,BUNGOMA CENTRAL,86,39,57,96
BUNGOMA,BUNGOMA CENTRAL,87,54,70,124
BUNGOMA,BUNGOMA CENTRAL,88,19,29,48
BUNGOMA,BUNGOMA CENTRAL,89,39,69,108
BUNGOMA,BUNGOMA CENTRAL,85-89,211,309,520
BUNGOMA,BUNGOMA CENTRAL,90,21,17,38
BUNGOMA,BUNGOMA CENTRAL,91,16,24,40
BUNGOMA,BUNGOMA CENTRAL,92,11,20,31
BUNGOMA,BUNGOMA CENTRAL,93,13,16,29
BUNGOMA,BUNGOMA CENTRAL,94,6,7,13
BUNGOMA,BUNGOMA CENTRAL,90-94,67,84,151
BUNGOMA,BUNGOMA CENTRAL,95,9,13,22
BUNGOMA,BUNGOMA CENTRAL,96,3,4,7
BUNGOMA,BUNGOMA CENTRAL,97,6,11,17
BUNGOMA,BUNGOMA CENTRAL,98,2,5,7
BUNGOMA,BUNGOMA CENTRAL,99,3,4,7
BUNGOMA,BUNGOMA CENTRAL,95-99,23,37,60
BUNGOMA,BUNGOMA CENTRAL,100+,6,13,19
BUNGOMA,BUNGOMA CENTRAL,Not Stated,-,-,-
BUNGOMA,BUNGOMA EAST,Total,55775,58771,114546
BUNGOMA,BUNGOMA EAST,0,1347,1321,2668
BUNGOMA,BUNGOMA EAST,1,1348,1307,2655
BUNGOMA,BUNGOMA EAST,2,1390,1412,2802
BUNGOMA,BUNGOMA EAST,3,1566,1573,3139
BUNGOMA,BUNGOMA EAST,4,1440,1523,2963
BUNGOMA,BUNGOMA EAST,0 - 4,7091,7136,14227
BUNGOMA,BUNGOMA EAST,5,1601,1581,3182
BUNGOMA,BUNGOMA EAST,6,1607,1640,3247
BUNGOMA,BUNGOMA EAST,7,1784,1730,3514
BUNGOMA,BUNGOMA EAST,8,1568,1561,3129
BUNGOMA,BUNGOMA EAST,9,1920,1883,3803
BUNGOMA,BUNGOMA EAST,05-Sep,8480,8395,16875
BUNGOMA,BUNGOMA EAST,10,1795,1868,3663
BUNGOMA,BUNGOMA EAST,11,1809,1841,3650
BUNGOMA,BUNGOMA EAST,12,1951,1827,3778
BUNGOMA,BUNGOMA EAST,13,1927,2010,3937
BUNGOMA,BUNGOMA EAST,14,1736,1730,3466
BUNGOMA,BUNGOMA EAST,Oct-14,9218,9276,18494
BUNGOMA,BUNGOMA EAST,15,1804,1796,3600
BUNGOMA,BUNGOMA EAST,16,1565,1618,3183
BUNGOMA,BUNGOMA EAST,17,1721,1607,3328
BUNGOMA,BUNGOMA EAST,18,1283,1153,2436
BUNGOMA,BUNGOMA EAST,19,1486,1249,2735
BUNGOMA,BUNGOMA EAST,15-19,7859,7423,15282
BUNGOMA,BUNGOMA EAST,20,1044,1113,2157
BUNGOMA,BUNGOMA EAST,21,993,942,1935
BUNGOMA,BUNGOMA EAST,22,826,938,1764
BUNGOMA,BUNGOMA EAST,23,801,1034,1835
BUNGOMA,BUNGOMA EAST,24,685,877,1562
BUNGOMA,BUNGOMA EAST,20-24,4349,4904,9253
BUNGOMA,BUNGOMA EAST,25,778,984,1762
BUNGOMA,BUNGOMA EAST,26,580,782,1362
BUNGOMA,BUNGOMA EAST,27,590,809,1399
BUNGOMA,BUNGOMA EAST,28,487,589,1076
BUNGOMA,BUNGOMA EAST,29,599,696,1295
BUNGOMA,BUNGOMA EAST,25-29,3034,3860,6894
BUNGOMA,BUNGOMA EAST,30,676,906,1582
BUNGOMA,BUNGOMA EAST,31,594,775,1369
BUNGOMA,BUNGOMA EAST,32,753,915,1668
BUNGOMA,BUNGOMA EAST,33,593,737,1330
BUNGOMA,BUNGOMA EAST,34,481,558,1039
BUNGOMA,BUNGOMA EAST,30-34,3097,3891,6988
BUNGOMA,BUNGOMA EAST,35,617,670,1287
BUNGOMA,BUNGOMA EAST,36,478,481,959
BUNGOMA,BUNGOMA EAST,37,545,511,1056
BUNGOMA,BUNGOMA EAST,38,377,411,788
BUNGOMA,BUNGOMA EAST,39,478,465,943
BUNGOMA,BUNGOMA EAST,35-39,2495,2538,5033
BUNGOMA,BUNGOMA EAST,40,490,556,1046
BUNGOMA,BUNGOMA EAST,41,488,576,1064
BUNGOMA,BUNGOMA EAST,42,514,553,1067
BUNGOMA,BUNGOMA EAST,43,470,474,944
BUNGOMA,BUNGOMA EAST,44,323,388,711
BUNGOMA,BUNGOMA EAST,40-44,2285,2547,4832
BUNGOMA,BUNGOMA EAST,45,523,519,1042
BUNGOMA,BUNGOMA EAST,46,388,429,817
BUNGOMA,BUNGOMA EAST,47,357,415,772
BUNGOMA,BUNGOMA EAST,48,251,288,539
BUNGOMA,BUNGOMA EAST,49,344,318,662
BUNGOMA,BUNGOMA EAST,45-49,1863,1969,3832
BUNGOMA,BUNGOMA EAST,50,358,384,742
BUNGOMA,BUNGOMA EAST,51,304,344,648
BUNGOMA,BUNGOMA EAST,52,289,279,568
BUNGOMA,BUNGOMA EAST,53,225,255,480
BUNGOMA,BUNGOMA EAST,54,243,276,519
BUNGOMA,BUNGOMA EAST,50-54,1419,1538,2957
BUNGOMA,BUNGOMA EAST,55,273,289,562
BUNGOMA,BUNGOMA EAST,56,292,299,591
BUNGOMA,BUNGOMA EAST,57,328,350,678
BUNGOMA,BUNGOMA EAST,58,207,253,460
BUNGOMA,BUNGOMA EAST,59,310,312,622
BUNGOMA,BUNGOMA EAST,55-59,1410,1503,2913
BUNGOMA,BUNGOMA EAST,60,299,290,589
BUNGOMA,BUNGOMA EAST,61,255,281,536
BUNGOMA,BUNGOMA EAST,62,198,231,429
BUNGOMA,BUNGOMA EAST,63,230,262,492
BUNGOMA,BUNGOMA EAST,64,172,178,350
BUNGOMA,BUNGOMA EAST,60-64,1154,1242,2396
BUNGOMA,BUNGOMA EAST,65,201,258,459
BUNGOMA,BUNGOMA EAST,66,126,175,301
BUNGOMA,BUNGOMA EAST,67,163,209,372
BUNGOMA,BUNGOMA EAST,68,87,101,188
BUNGOMA,BUNGOMA EAST,69,164,165,329
BUNGOMA,BUNGOMA EAST,65-69,741,908,1649
BUNGOMA,BUNGOMA EAST,70,131,184,315
BUNGOMA,BUNGOMA EAST,71,129,156,285
BUNGOMA,BUNGOMA EAST,72,106,112,218
BUNGOMA,BUNGOMA EAST,73,108,139,247
BUNGOMA,BUNGOMA EAST,74,96,94,190
BUNGOMA,BUNGOMA EAST,70-74,570,685,1255
BUNGOMA,BUNGOMA EAST,75,80,101,181
BUNGOMA,BUNGOMA EAST,76,62,85,147
BUNGOMA,BUNGOMA EAST,77,58,111,169
BUNGOMA,BUNGOMA EAST,78,36,56,92
BUNGOMA,BUNGOMA EAST,79,48,63,111
BUNGOMA,BUNGOMA EAST,75-79,284,416,700
BUNGOMA,BUNGOMA EAST,80,79,83,162
BUNGOMA,BUNGOMA EAST,81,34,50,84
BUNGOMA,BUNGOMA EAST,82,36,42,78
BUNGOMA,BUNGOMA EAST,83,60,69,129
BUNGOMA,BUNGOMA EAST,84,34,39,73
BUNGOMA,BUNGOMA EAST,80-84,243,283,526
BUNGOMA,BUNGOMA EAST,85,32,45,77
BUNGOMA,BUNGOMA EAST,86,22,22,44
BUNGOMA,BUNGOMA EAST,87,36,44,80
BUNGOMA,BUNGOMA EAST,88,13,15,28
BUNGOMA,BUNGOMA EAST,89,22,29,51
BUNGOMA,BUNGOMA EAST,85-89,125,155,280
BUNGOMA,BUNGOMA EAST,90,18,19,37
BUNGOMA,BUNGOMA EAST,91,5,14,19
BUNGOMA,BUNGOMA EAST,92,4,17,21
BUNGOMA,BUNGOMA EAST,93,4,13,17
BUNGOMA,BUNGOMA EAST,94,6,4,10
BUNGOMA,BUNGOMA EAST,90-94,37,67,104
BUNGOMA,BUNGOMA EAST,95,7,10,17
BUNGOMA,BUNGOMA EAST,96,3,6,9
BUNGOMA,BUNGOMA EAST,97,3,5,8
BUNGOMA,BUNGOMA EAST,98,-,5,5
BUNGOMA,BUNGOMA EAST,99,3,3,6
BUNGOMA,BUNGOMA EAST,95-99,16,29,45
BUNGOMA,BUNGOMA EAST,100+,4,5,9
BUNGOMA,BUNGOMA EAST,Not Stated,1,1,2
BUNGOMA,BUNGOMA NORTH,Total,58790,62526,121316
BUNGOMA,BUNGOMA NORTH,0,1469,1498,2967
BUNGOMA,BUNGOMA NORTH,1,1484,1480,2964
BUNGOMA,BUNGOMA NORTH,2,1528,1527,3055
BUNGOMA,BUNGOMA NORTH,3,1630,1691,3321
BUNGOMA,BUNGOMA NORTH,4,1722,1686,3408
BUNGOMA,BUNGOMA NORTH,0 - 4,7833,7882,15715
BUNGOMA,BUNGOMA NORTH,5,1789,1683,3472
BUNGOMA,BUNGOMA NORTH,6,1750,1775,3525
BUNGOMA,BUNGOMA NORTH,7,1801,1773,3574
BUNGOMA,BUNGOMA NORTH,8,1715,1713,3428
BUNGOMA,BUNGOMA NORTH,9,1982,1888,3870
BUNGOMA,BUNGOMA NORTH,05-Sep,9037,8832,17869
BUNGOMA,BUNGOMA NORTH,10,2019,2058,4077
BUNGOMA,BUNGOMA NORTH,11,1895,1940,3835
BUNGOMA,BUNGOMA NORTH,12,2053,1999,4052
BUNGOMA,BUNGOMA NORTH,13,2050,2201,4251
BUNGOMA,BUNGOMA NORTH,14,1923,1910,3833
BUNGOMA,BUNGOMA NORTH,Oct-14,9940,10108,20048
BUNGOMA,BUNGOMA NORTH,15,1928,1892,3820
BUNGOMA,BUNGOMA NORTH,16,1769,1789,3558
BUNGOMA,BUNGOMA NORTH,17,1845,1817,3662
BUNGOMA,BUNGOMA NORTH,18,1491,1250,2741
BUNGOMA,BUNGOMA NORTH,19,1542,1383,2925
BUNGOMA,BUNGOMA NORTH,15-19,8575,8131,16706
BUNGOMA,BUNGOMA NORTH,20,1215,1123,2338
BUNGOMA,BUNGOMA NORTH,21,1011,1032,2043
BUNGOMA,BUNGOMA NORTH,22,920,979,1899
BUNGOMA,BUNGOMA NORTH,23,921,1019,1940
BUNGOMA,BUNGOMA NORTH,24,727,827,1554
BUNGOMA,BUNGOMA NORTH,20-24,4794,4980,9774
BUNGOMA,BUNGOMA NORTH,25,766,925,1691
BUNGOMA,BUNGOMA NORTH,26,626,786,1412
BUNGOMA,BUNGOMA NORTH,27,661,826,1487
BUNGOMA,BUNGOMA NORTH,28,479,609,1088
BUNGOMA,BUNGOMA NORTH,29,568,735,1303
BUNGOMA,BUNGOMA NORTH,25-29,3100,3881,6981
BUNGOMA,BUNGOMA NORTH,30,731,881,1612
BUNGOMA,BUNGOMA NORTH,31,565,717,1282
BUNGOMA,BUNGOMA NORTH,32,653,882,1535
BUNGOMA,BUNGOMA NORTH,33,559,683,1242
BUNGOMA,BUNGOMA NORTH,34,482,596,1078
BUNGOMA,BUNGOMA NORTH,30-34,2990,3759,6749
BUNGOMA,BUNGOMA NORTH,35,565,626,1191
BUNGOMA,BUNGOMA NORTH,36,411,500,911
BUNGOMA,BUNGOMA NORTH,37,476,504,980
BUNGOMA,BUNGOMA NORTH,38,346,373,719
BUNGOMA,BUNGOMA NORTH,39,378,469,847
BUNGOMA,BUNGOMA NORTH,35-39,2176,2472,4648
BUNGOMA,BUNGOMA NORTH,40,485,544,1029
BUNGOMA,BUNGOMA NORTH,41,452,592,1044
BUNGOMA,BUNGOMA NORTH,42,487,589,1076
BUNGOMA,BUNGOMA NORTH,43,474,603,1077
BUNGOMA,BUNGOMA NORTH,44,348,404,752
BUNGOMA,BUNGOMA NORTH,40-44,2246,2732,4978
BUNGOMA,BUNGOMA NORTH,45,508,599,1107
BUNGOMA,BUNGOMA NORTH,46,334,429,763
BUNGOMA,BUNGOMA NORTH,47,411,463,874
BUNGOMA,BUNGOMA NORTH,48,291,346,637
BUNGOMA,BUNGOMA NORTH,49,332,403,735
BUNGOMA,BUNGOMA NORTH,45-49,1876,2240,4116
BUNGOMA,BUNGOMA NORTH,50,421,495,916
BUNGOMA,BUNGOMA NORTH,51,319,463,782
BUNGOMA,BUNGOMA NORTH,52,325,382,707
BUNGOMA,BUNGOMA NORTH,53,257,336,593
BUNGOMA,BUNGOMA NORTH,54,272,372,644
BUNGOMA,BUNGOMA NORTH,50-54,1594,2048,3642
BUNGOMA,BUNGOMA NORTH,55,309,357,666
BUNGOMA,BUNGOMA NORTH,56,287,373,660
BUNGOMA,BUNGOMA NORTH,57,320,399,719
BUNGOMA,BUNGOMA NORTH,58,246,283,529
BUNGOMA,BUNGOMA NORTH,59,312,364,676
BUNGOMA,BUNGOMA NORTH,55-59,1474,1776,3250
BUNGOMA,BUNGOMA NORTH,60,317,309,626
BUNGOMA,BUNGOMA NORTH,61,285,289,574
BUNGOMA,BUNGOMA NORTH,62,244,242,486
BUNGOMA,BUNGOMA NORTH,63,282,275,557
BUNGOMA,BUNGOMA NORTH,64,165,167,332
BUNGOMA,BUNGOMA NORTH,60-64,1293,1282,2575
BUNGOMA,BUNGOMA NORTH,65,238,219,457
BUNGOMA,BUNGOMA NORTH,66,148,136,284
BUNGOMA,BUNGOMA NORTH,67,157,197,354
BUNGOMA,BUNGOMA NORTH,68,95,95,190
BUNGOMA,BUNGOMA NORTH,69,149,152,301
BUNGOMA,BUNGOMA NORTH,65-69,787,799,1586
BUNGOMA,BUNGOMA NORTH,70,104,138,242
BUNGOMA,BUNGOMA NORTH,71,114,124,238
BUNGOMA,BUNGOMA NORTH,72,89,105,194
BUNGOMA,BUNGOMA NORTH,73,55,127,182
BUNGOMA,BUNGOMA NORTH,74,60,97,157
BUNGOMA,BUNGOMA NORTH,70-74,422,591,1013
BUNGOMA,BUNGOMA NORTH,75,64,94,158
BUNGOMA,BUNGOMA NORTH,76,40,97,137
BUNGOMA,BUNGOMA NORTH,77,61,115,176
BUNGOMA,BUNGOMA NORTH,78,38,53,91
BUNGOMA,BUNGOMA NORTH,79,37,72,109
BUNGOMA,BUNGOMA NORTH,75-79,240,431,671
BUNGOMA,BUNGOMA NORTH,80,57,80,137
BUNGOMA,BUNGOMA NORTH,81,46,57,103
BUNGOMA,BUNGOMA NORTH,82,45,46,91
BUNGOMA,BUNGOMA NORTH,83,43,93,136
BUNGOMA,BUNGOMA NORTH,84,25,32,57
BUNGOMA,BUNGOMA NORTH,80-84,216,308,524
BUNGOMA,BUNGOMA NORTH,85,44,43,87
BUNGOMA,BUNGOMA NORTH,86,24,25,49
BUNGOMA,BUNGOMA NORTH,87,43,63,106
BUNGOMA,BUNGOMA NORTH,88,10,17,27
BUNGOMA,BUNGOMA NORTH,89,26,32,58
BUNGOMA,BUNGOMA NORTH,85-89,147,180,327
BUNGOMA,BUNGOMA NORTH,90,7,24,31
BUNGOMA,BUNGOMA NORTH,91,12,14,26
BUNGOMA,BUNGOMA NORTH,92,8,13,21
BUNGOMA,BUNGOMA NORTH,93,4,14,18
BUNGOMA,BUNGOMA NORTH,94,2,2,4
BUNGOMA,BUNGOMA NORTH,90-94,33,67,100
BUNGOMA,BUNGOMA NORTH,95,7,10,17
BUNGOMA,BUNGOMA NORTH,96,2,3,5
BUNGOMA,BUNGOMA NORTH,97,4,6,10
BUNGOMA,BUNGOMA NORTH,98,1,1,2
BUNGOMA,BUNGOMA NORTH,99,-,4,4
BUNGOMA,BUNGOMA NORTH,95-99,14,24,38
BUNGOMA,BUNGOMA NORTH,100+,2,3,5
BUNGOMA,BUNGOMA NORTH,Not Stated,1,-,1
BUNGOMA,BUNGOMA SOUTH,Total,139705,148055,287760
BUNGOMA,BUNGOMA SOUTH,0,3363,3427,6790
BUNGOMA,BUNGOMA SOUTH,1,3760,3693,7453
BUNGOMA,BUNGOMA SOUTH,2,3592,3592,7184
BUNGOMA,BUNGOMA SOUTH,3,3718,3893,7611
BUNGOMA,BUNGOMA SOUTH,4,3797,3795,7592
BUNGOMA,BUNGOMA SOUTH,0 - 4,18230,18400,36630
BUNGOMA,BUNGOMA SOUTH,5,4053,3874,7927
BUNGOMA,BUNGOMA SOUTH,6,3936,3993,7929
BUNGOMA,BUNGOMA SOUTH,7,3916,3895,7811
BUNGOMA,BUNGOMA SOUTH,8,3500,3788,7288
BUNGOMA,BUNGOMA SOUTH,9,4243,4238,8481
BUNGOMA,BUNGOMA SOUTH,05-Sep,19648,19788,39436
BUNGOMA,BUNGOMA SOUTH,10,4272,4346,8618
BUNGOMA,BUNGOMA SOUTH,11,3742,4137,7879
BUNGOMA,BUNGOMA SOUTH,12,4165,4042,8207
BUNGOMA,BUNGOMA SOUTH,13,4251,4384,8635
BUNGOMA,BUNGOMA SOUTH,14,3847,3994,7841
BUNGOMA,BUNGOMA SOUTH,Oct-14,20277,20903,41180
BUNGOMA,BUNGOMA SOUTH,15,3851,4014,7865
BUNGOMA,BUNGOMA SOUTH,16,3407,3699,7106
BUNGOMA,BUNGOMA SOUTH,17,3686,3891,7577
BUNGOMA,BUNGOMA SOUTH,18,2891,3006,5897
BUNGOMA,BUNGOMA SOUTH,19,3317,3466,6783
BUNGOMA,BUNGOMA SOUTH,15-19,17152,18076,35228
BUNGOMA,BUNGOMA SOUTH,20,2785,3208,5993
BUNGOMA,BUNGOMA SOUTH,21,2607,3043,5650
BUNGOMA,BUNGOMA SOUTH,22,2599,3120,5719
BUNGOMA,BUNGOMA SOUTH,23,2938,3434,6372
BUNGOMA,BUNGOMA SOUTH,24,2515,2886,5401
BUNGOMA,BUNGOMA SOUTH,20-24,13444,15691,29135
BUNGOMA,BUNGOMA SOUTH,25,2795,3168,5963
BUNGOMA,BUNGOMA SOUTH,26,2174,2501,4675
BUNGOMA,BUNGOMA SOUTH,27,2337,2687,5024
BUNGOMA,BUNGOMA SOUTH,28,1773,2031,3804
BUNGOMA,BUNGOMA SOUTH,29,2006,2116,4122
BUNGOMA,BUNGOMA SOUTH,25-29,11085,12503,23588
BUNGOMA,BUNGOMA SOUTH,30,2508,2917,5425
BUNGOMA,BUNGOMA SOUTH,31,1855,2252,4107
BUNGOMA,BUNGOMA SOUTH,32,2231,2706,4937
BUNGOMA,BUNGOMA SOUTH,33,1725,2000,3725
BUNGOMA,BUNGOMA SOUTH,34,1534,1630,3164
BUNGOMA,BUNGOMA SOUTH,30-34,9853,11505,21358
BUNGOMA,BUNGOMA SOUTH,35,1933,1898,3831
BUNGOMA,BUNGOMA SOUTH,36,1510,1393,2903
BUNGOMA,BUNGOMA SOUTH,37,1446,1407,2853
BUNGOMA,BUNGOMA SOUTH,38,1094,1124,2218
BUNGOMA,BUNGOMA SOUTH,39,1293,1195,2488
BUNGOMA,BUNGOMA SOUTH,35-39,7276,7017,14293
BUNGOMA,BUNGOMA SOUTH,40,1514,1387,2901
BUNGOMA,BUNGOMA SOUTH,41,1333,1308,2641
BUNGOMA,BUNGOMA SOUTH,42,1285,1253,2538
BUNGOMA,BUNGOMA SOUTH,43,1233,1172,2405
BUNGOMA,BUNGOMA SOUTH,44,825,870,1695
BUNGOMA,BUNGOMA SOUTH,40-44,6190,5990,12180
BUNGOMA,BUNGOMA SOUTH,45,1343,1246,2589
BUNGOMA,BUNGOMA SOUTH,46,940,886,1826
BUNGOMA,BUNGOMA SOUTH,47,1067,991,2058
BUNGOMA,BUNGOMA SOUTH,48,628,656,1284
BUNGOMA,BUNGOMA SOUTH,49,752,720,1472
BUNGOMA,BUNGOMA SOUTH,45-49,4730,4499,9229
BUNGOMA,BUNGOMA SOUTH,50,901,899,1800
BUNGOMA,BUNGOMA SOUTH,51,722,712,1434
BUNGOMA,BUNGOMA SOUTH,52,590,647,1237
BUNGOMA,BUNGOMA SOUTH,53,531,598,1129
BUNGOMA,BUNGOMA SOUTH,54,562,582,1144
BUNGOMA,BUNGOMA SOUTH,50-54,3306,3438,6744
BUNGOMA,BUNGOMA SOUTH,55,587,630,1217
BUNGOMA,BUNGOMA SOUTH,56,606,628,1234
BUNGOMA,BUNGOMA SOUTH,57,618,715,1333
BUNGOMA,BUNGOMA SOUTH,58,429,503,932
BUNGOMA,BUNGOMA SOUTH,59,604,644,1248
BUNGOMA,BUNGOMA SOUTH,55-59,2844,3120,5964
BUNGOMA,BUNGOMA SOUTH,60,548,598,1146
BUNGOMA,BUNGOMA SOUTH,61,492,541,1033
BUNGOMA,BUNGOMA SOUTH,62,342,377,719
BUNGOMA,BUNGOMA SOUTH,63,435,494,929
BUNGOMA,BUNGOMA SOUTH,64,292,367,659
BUNGOMA,BUNGOMA SOUTH,60-64,2109,2377,4486
BUNGOMA,BUNGOMA SOUTH,65,410,480,890
BUNGOMA,BUNGOMA SOUTH,66,259,304,563
BUNGOMA,BUNGOMA SOUTH,67,340,449,789
BUNGOMA,BUNGOMA SOUTH,68,146,181,327
BUNGOMA,BUNGOMA SOUTH,69,280,327,607
BUNGOMA,BUNGOMA SOUTH,65-69,1435,1741,3176
BUNGOMA,BUNGOMA SOUTH,70,246,304,550
BUNGOMA,BUNGOMA SOUTH,71,190,293,483
BUNGOMA,BUNGOMA SOUTH,72,149,215,364
BUNGOMA,BUNGOMA SOUTH,73,170,260,430
BUNGOMA,BUNGOMA SOUTH,74,155,196,351
BUNGOMA,BUNGOMA SOUTH,70-74,910,1268,2178
BUNGOMA,BUNGOMA SOUTH,75,123,186,309
BUNGOMA,BUNGOMA SOUTH,76,118,152,270
BUNGOMA,BUNGOMA SOUTH,77,148,212,360
BUNGOMA,BUNGOMA SOUTH,78,94,90,184
BUNGOMA,BUNGOMA SOUTH,79,73,120,193
BUNGOMA,BUNGOMA SOUTH,75-79,556,760,1316
BUNGOMA,BUNGOMA SOUTH,80,109,175,284
BUNGOMA,BUNGOMA SOUTH,81,55,83,138
BUNGOMA,BUNGOMA SOUTH,82,71,83,154
BUNGOMA,BUNGOMA SOUTH,83,88,108,196
BUNGOMA,BUNGOMA SOUTH,84,49,58,107
BUNGOMA,BUNGOMA SOUTH,80-84,372,507,879
BUNGOMA,BUNGOMA SOUTH,85,60,96,156
BUNGOMA,BUNGOMA SOUTH,86,29,49,78
BUNGOMA,BUNGOMA SOUTH,87,56,89,145
BUNGOMA,BUNGOMA SOUTH,88,12,19,31
BUNGOMA,BUNGOMA SOUTH,89,34,60,94
BUNGOMA,BUNGOMA SOUTH,85-89,191,313,504
BUNGOMA,BUNGOMA SOUTH,90,17,26,43
BUNGOMA,BUNGOMA SOUTH,91,25,28,53
BUNGOMA,BUNGOMA SOUTH,92,8,4,12
BUNGOMA,BUNGOMA SOUTH,93,8,12,20
BUNGOMA,BUNGOMA SOUTH,94,2,7,9
BUNGOMA,BUNGOMA SOUTH,90-94,60,77,137
BUNGOMA,BUNGOMA SOUTH,95,16,32,48
BUNGOMA,BUNGOMA SOUTH,96,4,5,9
BUNGOMA,BUNGOMA SOUTH,97,7,15,22
BUNGOMA,BUNGOMA SOUTH,98,1,6,7
BUNGOMA,BUNGOMA SOUTH,99,2,11,13
BUNGOMA,BUNGOMA SOUTH,95-99,30,69,99
BUNGOMA,BUNGOMA SOUTH,100+,5,13,18
BUNGOMA,BUNGOMA SOUTH,Not Stated,2,-,2
BUNGOMA,CHEPTAIS,Total,67717,68312,136029
BUNGOMA,CHEPTAIS,0,1697,1790,3487
BUNGOMA,CHEPTAIS,1,1935,1985,3920
BUNGOMA,CHEPTAIS,2,2090,2103,4193
BUNGOMA,CHEPTAIS,3,2225,2239,4464
BUNGOMA,CHEPTAIS,4,2286,2227,4513
BUNGOMA,CHEPTAIS,0 - 4,10233,10344,20577
BUNGOMA,CHEPTAIS,5,2529,2390,4919
BUNGOMA,CHEPTAIS,6,2398,2365,4763
BUNGOMA,CHEPTAIS,7,2385,2361,4746
BUNGOMA,CHEPTAIS,8,2100,2143,4243
BUNGOMA,CHEPTAIS,9,2609,2393,5002
BUNGOMA,CHEPTAIS,05-Sep,12021,11652,23673
BUNGOMA,CHEPTAIS,10,2278,2162,4440
BUNGOMA,CHEPTAIS,11,2389,2263,4652
BUNGOMA,CHEPTAIS,12,2355,2314,4669
BUNGOMA,CHEPTAIS,13,2427,2328,4755
BUNGOMA,CHEPTAIS,14,2152,2000,4152
BUNGOMA,CHEPTAIS,Oct-14,11601,11067,22668
BUNGOMA,CHEPTAIS,15,2188,2010,4198
BUNGOMA,CHEPTAIS,16,1776,1612,3388
BUNGOMA,CHEPTAIS,17,1854,1772,3626
BUNGOMA,CHEPTAIS,18,1237,1151,2388
BUNGOMA,CHEPTAIS,19,1524,1508,3032
BUNGOMA,CHEPTAIS,15-19,8579,8053,16632
BUNGOMA,CHEPTAIS,20,1206,1276,2482
BUNGOMA,CHEPTAIS,21,1133,1113,2246
BUNGOMA,CHEPTAIS,22,998,1054,2052
BUNGOMA,CHEPTAIS,23,1001,1157,2158
BUNGOMA,CHEPTAIS,24,867,997,1864
BUNGOMA,CHEPTAIS,20-24,5205,5597,10802
BUNGOMA,CHEPTAIS,25,1036,1123,2159
BUNGOMA,CHEPTAIS,26,795,890,1685
BUNGOMA,CHEPTAIS,27,930,923,1853
BUNGOMA,CHEPTAIS,28,587,606,1193
BUNGOMA,CHEPTAIS,29,739,799,1538
BUNGOMA,CHEPTAIS,25-29,4087,4341,8428
BUNGOMA,CHEPTAIS,30,918,999,1917
BUNGOMA,CHEPTAIS,31,811,969,1780
BUNGOMA,CHEPTAIS,32,909,993,1902
BUNGOMA,CHEPTAIS,33,672,793,1465
BUNGOMA,CHEPTAIS,34,634,592,1226
BUNGOMA,CHEPTAIS,30-34,3944,4346,8290
BUNGOMA,CHEPTAIS,35,831,687,1518
BUNGOMA,CHEPTAIS,36,627,452,1079
BUNGOMA,CHEPTAIS,37,559,447,1006
BUNGOMA,CHEPTAIS,38,321,268,589
BUNGOMA,CHEPTAIS,39,389,357,746
BUNGOMA,CHEPTAIS,35-39,2727,2211,4938
BUNGOMA,CHEPTAIS,40,416,410,826
BUNGOMA,CHEPTAIS,41,536,594,1130
BUNGOMA,CHEPTAIS,42,503,580,1083
BUNGOMA,CHEPTAIS,43,384,429,813
BUNGOMA,CHEPTAIS,44,259,273,532
BUNGOMA,CHEPTAIS,40-44,2098,2286,4384
BUNGOMA,CHEPTAIS,45,564,486,1050
BUNGOMA,CHEPTAIS,46,539,443,982
BUNGOMA,CHEPTAIS,47,447,387,834
BUNGOMA,CHEPTAIS,48,241,249,490
BUNGOMA,CHEPTAIS,49,262,224,486
BUNGOMA,CHEPTAIS,45-49,2053,1789,3842
BUNGOMA,CHEPTAIS,50,299,376,675
BUNGOMA,CHEPTAIS,51,279,359,638
BUNGOMA,CHEPTAIS,52,213,227,440
BUNGOMA,CHEPTAIS,53,204,284,488
BUNGOMA,CHEPTAIS,54,224,270,494
BUNGOMA,CHEPTAIS,50-54,1219,1516,2735
BUNGOMA,CHEPTAIS,55,252,304,556
BUNGOMA,CHEPTAIS,56,226,302,528
BUNGOMA,CHEPTAIS,57,218,362,580
BUNGOMA,CHEPTAIS,58,211,247,458
BUNGOMA,CHEPTAIS,59,311,357,668
BUNGOMA,CHEPTAIS,55-59,1218,1572,2790
BUNGOMA,CHEPTAIS,60,258,268,526
BUNGOMA,CHEPTAIS,61,213,266,479
BUNGOMA,CHEPTAIS,62,159,205,364
BUNGOMA,CHEPTAIS,63,198,200,398
BUNGOMA,CHEPTAIS,64,143,186,329
BUNGOMA,CHEPTAIS,60-64,971,1125,2096
BUNGOMA,CHEPTAIS,65,200,260,460
BUNGOMA,CHEPTAIS,66,105,147,252
BUNGOMA,CHEPTAIS,67,162,218,380
BUNGOMA,CHEPTAIS,68,72,76,148
BUNGOMA,CHEPTAIS,69,118,159,277
BUNGOMA,CHEPTAIS,65-69,657,860,1517
BUNGOMA,CHEPTAIS,70,107,135,242
BUNGOMA,CHEPTAIS,71,98,157,255
BUNGOMA,CHEPTAIS,72,73,97,170
BUNGOMA,CHEPTAIS,73,96,112,208
BUNGOMA,CHEPTAIS,74,59,62,121
BUNGOMA,CHEPTAIS,70-74,433,563,996
BUNGOMA,CHEPTAIS,75,87,107,194
BUNGOMA,CHEPTAIS,76,44,71,115
BUNGOMA,CHEPTAIS,77,73,120,193
BUNGOMA,CHEPTAIS,78,31,34,65
BUNGOMA,CHEPTAIS,79,43,62,105
BUNGOMA,CHEPTAIS,75-79,278,394,672
BUNGOMA,CHEPTAIS,80,55,69,124
BUNGOMA,CHEPTAIS,81,52,50,102
BUNGOMA,CHEPTAIS,82,34,46,80
BUNGOMA,CHEPTAIS,83,41,64,105
BUNGOMA,CHEPTAIS,84,27,39,66
BUNGOMA,CHEPTAIS,80-84,209,268,477
BUNGOMA,CHEPTAIS,85,23,45,68
BUNGOMA,CHEPTAIS,86,13,39,52
BUNGOMA,CHEPTAIS,87,31,55,86
BUNGOMA,CHEPTAIS,88,11,13,24
BUNGOMA,CHEPTAIS,89,24,38,62
BUNGOMA,CHEPTAIS,85-89,102,190,292
BUNGOMA,CHEPTAIS,90,13,18,31
BUNGOMA,CHEPTAIS,91,17,21,38
BUNGOMA,CHEPTAIS,92,7,14,21
BUNGOMA,CHEPTAIS,93,6,20,26
BUNGOMA,CHEPTAIS,94,9,4,13
BUNGOMA,CHEPTAIS,90-94,52,77,129
BUNGOMA,CHEPTAIS,95,9,18,27
BUNGOMA,CHEPTAIS,96,4,3,7
BUNGOMA,CHEPTAIS,97,7,10,17
BUNGOMA,CHEPTAIS,98,-,5,5
BUNGOMA,CHEPTAIS,99,4,14,18
BUNGOMA,CHEPTAIS,95-99,24,50,74
BUNGOMA,CHEPTAIS,100+,5,11,16
BUNGOMA,CHEPTAIS,Not Stated,1,-,1
BUNGOMA,KIMILILI,Total,78560,83475,162035
BUNGOMA,KIMILILI,0,1869,1879,3748
BUNGOMA,KIMILILI,1,1986,1933,3919
BUNGOMA,KIMILILI,2,2099,2071,4170
BUNGOMA,KIMILILI,3,2191,2185,4376
BUNGOMA,KIMILILI,4,2201,2255,4456
BUNGOMA,KIMILILI,0 - 4,10346,10323,20669
BUNGOMA,KIMILILI,5,2363,2369,4732
BUNGOMA,KIMILILI,6,2420,2429,4849
BUNGOMA,KIMILILI,7,2386,2381,4767
BUNGOMA,KIMILILI,8,2285,2281,4566
BUNGOMA,KIMILILI,9,2644,2776,5420
BUNGOMA,KIMILILI,05-Sep,12098,12236,24334
BUNGOMA,KIMILILI,10,2676,2616,5292
BUNGOMA,KIMILILI,11,2550,2546,5096
BUNGOMA,KIMILILI,12,2628,2647,5275
BUNGOMA,KIMILILI,13,2688,2823,5511
BUNGOMA,KIMILILI,14,2401,2462,4863
BUNGOMA,KIMILILI,Oct-14,12943,13094,26037
BUNGOMA,KIMILILI,15,2462,2495,4957
BUNGOMA,KIMILILI,16,2239,2266,4505
BUNGOMA,KIMILILI,17,2416,2214,4630
BUNGOMA,KIMILILI,18,1688,1631,3319
BUNGOMA,KIMILILI,19,1911,1773,3684
BUNGOMA,KIMILILI,15-19,10716,10379,21095
BUNGOMA,KIMILILI,20,1478,1630,3108
BUNGOMA,KIMILILI,21,1341,1450,2791
BUNGOMA,KIMILILI,22,1120,1283,2403
BUNGOMA,KIMILILI,23,1209,1433,2642
BUNGOMA,KIMILILI,24,1005,1244,2249
BUNGOMA,KIMILILI,20-24,6153,7040,13193
BUNGOMA,KIMILILI,25,1127,1349,2476
BUNGOMA,KIMILILI,26,915,1154,2069
BUNGOMA,KIMILILI,27,984,1175,2159
BUNGOMA,KIMILILI,28,641,892,1533
BUNGOMA,KIMILILI,29,850,1008,1858
BUNGOMA,KIMILILI,25-29,4517,5578,10095
BUNGOMA,KIMILILI,30,1071,1353,2424
BUNGOMA,KIMILILI,31,805,1033,1838
BUNGOMA,KIMILILI,32,994,1277,2271
BUNGOMA,KIMILILI,33,812,997,1809
BUNGOMA,KIMILILI,34,705,829,1534
BUNGOMA,KIMILILI,30-34,4387,5489,9876
BUNGOMA,KIMILILI,35,970,964,1934
BUNGOMA,KIMILILI,36,705,731,1436
BUNGOMA,KIMILILI,37,727,739,1466
BUNGOMA,KIMILILI,38,537,581,1118
BUNGOMA,KIMILILI,39,629,700,1329
BUNGOMA,KIMILILI,35-39,3568,3715,7283
BUNGOMA,KIMILILI,40,711,770,1481
BUNGOMA,KIMILILI,41,695,862,1557
BUNGOMA,KIMILILI,42,664,815,1479
BUNGOMA,KIMILILI,43,647,707,1354
BUNGOMA,KIMILILI,44,510,517,1027
BUNGOMA,KIMILILI,40-44,3227,3671,6898
BUNGOMA,KIMILILI,45,753,743,1496
BUNGOMA,KIMILILI,46,536,510,1046
BUNGOMA,KIMILILI,47,570,563,1133
BUNGOMA,KIMILILI,48,400,412,812
BUNGOMA,KIMILILI,49,443,476,919
BUNGOMA,KIMILILI,45-49,2702,2704,5406
BUNGOMA,KIMILILI,50,478,571,1049
BUNGOMA,KIMILILI,51,398,450,848
BUNGOMA,KIMILILI,52,407,358,765
BUNGOMA,KIMILILI,53,326,377,703
BUNGOMA,KIMILILI,54,335,391,726
BUNGOMA,KIMILILI,50-54,1944,2147,4091
BUNGOMA,KIMILILI,55,357,438,795
BUNGOMA,KIMILILI,56,370,411,781
BUNGOMA,KIMILILI,57,403,522,925
BUNGOMA,KIMILILI,58,308,350,658
BUNGOMA,KIMILILI,59,432,428,860
BUNGOMA,KIMILILI,55-59,1870,2149,4019
BUNGOMA,KIMILILI,60,395,406,801
BUNGOMA,KIMILILI,61,322,313,635
BUNGOMA,KIMILILI,62,261,298,559
BUNGOMA,KIMILILI,63,279,342,621
BUNGOMA,KIMILILI,64,217,284,501
BUNGOMA,KIMILILI,60-64,1474,1643,3117
BUNGOMA,KIMILILI,65,274,279,553
BUNGOMA,KIMILILI,66,178,169,347
BUNGOMA,KIMILILI,67,220,257,477
BUNGOMA,KIMILILI,68,118,150,268
BUNGOMA,KIMILILI,69,176,227,403
BUNGOMA,KIMILILI,65-69,966,1082,2048
BUNGOMA,KIMILILI,70,190,234,424
BUNGOMA,KIMILILI,71,158,178,336
BUNGOMA,KIMILILI,72,148,158,306
BUNGOMA,KIMILILI,73,118,123,241
BUNGOMA,KIMILILI,74,108,129,237
BUNGOMA,KIMILILI,70-74,722,822,1544
BUNGOMA,KIMILILI,75,95,129,224
BUNGOMA,KIMILILI,76,79,110,189
BUNGOMA,KIMILILI,77,97,160,257
BUNGOMA,KIMILILI,78,66,69,135
BUNGOMA,KIMILILI,79,74,85,159
BUNGOMA,KIMILILI,75-79,411,553,964
BUNGOMA,KIMILILI,80,71,109,180
BUNGOMA,KIMILILI,81,45,57,102
BUNGOMA,KIMILILI,82,53,73,126
BUNGOMA,KIMILILI,83,66,108,174
BUNGOMA,KIMILILI,84,29,64,93
BUNGOMA,KIMILILI,80-84,264,411,675
BUNGOMA,KIMILILI,85,53,67,120
BUNGOMA,KIMILILI,86,25,47,72
BUNGOMA,KIMILILI,87,50,77,127
BUNGOMA,KIMILILI,88,22,23,45
BUNGOMA,KIMILILI,89,21,54,75
BUNGOMA,KIMILILI,85-89,171,268,439
BUNGOMA,KIMILILI,90,25,38,63
BUNGOMA,KIMILILI,91,14,23,37
BUNGOMA,KIMILILI,92,11,22,33
BUNGOMA,KIMILILI,93,8,14,22
BUNGOMA,KIMILILI,94,4,11,15
BUNGOMA,KIMILILI,90-94,62,108,170
BUNGOMA,KIMILILI,95,10,22,32
BUNGOMA,KIMILILI,96,3,9,12
BUNGOMA,KIMILILI,97,3,10,13
BUNGOMA,KIMILILI,98,-,4,4
BUNGOMA,KIMILILI,99,1,6,7
BUNGOMA,KIMILILI,95-99,17,51,68
BUNGOMA,KIMILILI,100+,1,12,13
BUNGOMA,KIMILILI,Not Stated,1,-,1
BUNGOMA,MT ELGON,Total,38977,39893,78870
BUNGOMA,MT ELGON,0,984,961,1945
BUNGOMA,MT ELGON,1,949,1011,1960
BUNGOMA,MT ELGON,2,1086,1074,2160
BUNGOMA,MT ELGON,3,1155,1188,2343
BUNGOMA,MT ELGON,4,1245,1201,2446
BUNGOMA,MT ELGON,0 - 4,5419,5435,10854
BUNGOMA,MT ELGON,5,1244,1242,2486
BUNGOMA,MT ELGON,6,1278,1269,2547
BUNGOMA,MT ELGON,7,1253,1279,2532
BUNGOMA,MT ELGON,8,1183,1187,2370
BUNGOMA,MT ELGON,9,1369,1319,2688
BUNGOMA,MT ELGON,05-Sep,6327,6296,12623
BUNGOMA,MT ELGON,10,1329,1233,2562
BUNGOMA,MT ELGON,11,1189,1257,2446
BUNGOMA,MT ELGON,12,1457,1376,2833
BUNGOMA,MT ELGON,13,1341,1322,2663
BUNGOMA,MT ELGON,14,1257,1168,2425
BUNGOMA,MT ELGON,Oct-14,6573,6356,12929
BUNGOMA,MT ELGON,15,1336,1234,2570
BUNGOMA,MT ELGON,16,1057,1062,2119
BUNGOMA,MT ELGON,17,1150,1142,2292
BUNGOMA,MT ELGON,18,816,723,1539
BUNGOMA,MT ELGON,19,970,896,1866
BUNGOMA,MT ELGON,15-19,5329,5057,10386
BUNGOMA,MT ELGON,20,755,754,1509
BUNGOMA,MT ELGON,21,644,692,1336
BUNGOMA,MT ELGON,22,593,661,1254
BUNGOMA,MT ELGON,23,617,705,1322
BUNGOMA,MT ELGON,24,534,556,1090
BUNGOMA,MT ELGON,20-24,3143,3368,6511
BUNGOMA,MT ELGON,25,586,640,1226
BUNGOMA,MT ELGON,26,464,498,962
BUNGOMA,MT ELGON,27,542,564,1106
BUNGOMA,MT ELGON,28,301,368,669
BUNGOMA,MT ELGON,29,418,435,853
BUNGOMA,MT ELGON,25-29,2311,2505,4816
BUNGOMA,MT ELGON,30,462,585,1047
BUNGOMA,MT ELGON,31,424,509,933
BUNGOMA,MT ELGON,32,512,591,1103
BUNGOMA,MT ELGON,33,365,474,839
BUNGOMA,MT ELGON,34,324,351,675
BUNGOMA,MT ELGON,30-34,2087,2510,4597
BUNGOMA,MT ELGON,35,525,401,926
BUNGOMA,MT ELGON,36,359,334,693
BUNGOMA,MT ELGON,37,341,307,648
BUNGOMA,MT ELGON,38,181,193,374
BUNGOMA,MT ELGON,39,243,240,483
BUNGOMA,MT ELGON,35-39,1649,1475,3124
BUNGOMA,MT ELGON,40,258,270,528
BUNGOMA,MT ELGON,41,323,359,682
BUNGOMA,MT ELGON,42,273,350,623
BUNGOMA,MT ELGON,43,293,318,611
BUNGOMA,MT ELGON,44,188,194,382
BUNGOMA,MT ELGON,40-44,1335,1491,2826
BUNGOMA,MT ELGON,45,363,319,682
BUNGOMA,MT ELGON,46,265,262,527
BUNGOMA,MT ELGON,47,305,268,573
BUNGOMA,MT ELGON,48,165,147,312
BUNGOMA,MT ELGON,49,197,184,381
BUNGOMA,MT ELGON,45-49,1295,1180,2475
BUNGOMA,MT ELGON,50,202,181,383
BUNGOMA,MT ELGON,51,177,175,352
BUNGOMA,MT ELGON,52,145,165,310
BUNGOMA,MT ELGON,53,149,151,300
BUNGOMA,MT ELGON,54,134,173,307
BUNGOMA,MT ELGON,50-54,807,845,1652
BUNGOMA,MT ELGON,55,171,185,356
BUNGOMA,MT ELGON,56,189,205,394
BUNGOMA,MT ELGON,57,163,237,400
BUNGOMA,MT ELGON,58,135,138,273
BUNGOMA,MT ELGON,59,211,209,420
BUNGOMA,MT ELGON,55-59,869,974,1843
BUNGOMA,MT ELGON,60,155,145,300
BUNGOMA,MT ELGON,61,163,182,345
BUNGOMA,MT ELGON,62,105,119,224
BUNGOMA,MT ELGON,63,149,155,304
BUNGOMA,MT ELGON,64,79,95,174
BUNGOMA,MT ELGON,60-64,651,696,1347
BUNGOMA,MT ELGON,65,130,155,285
BUNGOMA,MT ELGON,66,70,99,169
BUNGOMA,MT ELGON,67,93,157,250
BUNGOMA,MT ELGON,68,52,62,114
BUNGOMA,MT ELGON,69,91,95,186
BUNGOMA,MT ELGON,65-69,436,568,1004
BUNGOMA,MT ELGON,70,77,94,171
BUNGOMA,MT ELGON,71,71,110,181
BUNGOMA,MT ELGON,72,62,74,136
BUNGOMA,MT ELGON,73,65,72,137
BUNGOMA,MT ELGON,74,42,59,101
BUNGOMA,MT ELGON,70-74,317,409,726
BUNGOMA,MT ELGON,75,45,89,134
BUNGOMA,MT ELGON,76,39,47,86
BUNGOMA,MT ELGON,77,54,92,146
BUNGOMA,MT ELGON,78,25,38,63
BUNGOMA,MT ELGON,79,23,58,81
BUNGOMA,MT ELGON,75-79,186,324,510
BUNGOMA,MT ELGON,80,22,46,68
BUNGOMA,MT ELGON,81,14,38,52
BUNGOMA,MT ELGON,82,16,23,39
BUNGOMA,MT ELGON,83,38,55,93
BUNGOMA,MT ELGON,84,15,22,37
BUNGOMA,MT ELGON,80-84,105,184,289
BUNGOMA,MT ELGON,85,22,26,48
BUNGOMA,MT ELGON,86,12,23,35
BUNGOMA,MT ELGON,87,31,29,60
BUNGOMA,MT ELGON,88,6,5,11
BUNGOMA,MT ELGON,89,12,30,42
BUNGOMA,MT ELGON,85-89,83,113,196
BUNGOMA,MT ELGON,90,11,15,26
BUNGOMA,MT ELGON,91,10,15,25
BUNGOMA,MT ELGON,92,11,4,15
BUNGOMA,MT ELGON,93,2,9,11
BUNGOMA,MT ELGON,94,2,4,6
BUNGOMA,MT ELGON,90-94,36,47,83
BUNGOMA,MT ELGON,95,7,17,24
BUNGOMA,MT ELGON,96,1,6,7
BUNGOMA,MT ELGON,97,4,17,21
BUNGOMA,MT ELGON,98,1,3,4
BUNGOMA,MT ELGON,99,3,4,7
BUNGOMA,MT ELGON,95-99,16,47,63
BUNGOMA,MT ELGON,100+,2,13,15
BUNGOMA,MT ELGON,Not Stated,1,-,1
BUNGOMA,BUNGOMA WEST,Total,58225,61649,119874
BUNGOMA,BUNGOMA WEST,0,1380,1483,2863
BUNGOMA,BUNGOMA WEST,1,1518,1527,3045
BUNGOMA,BUNGOMA WEST,2,1574,1475,3049
BUNGOMA,BUNGOMA WEST,3,1707,1755,3462
BUNGOMA,BUNGOMA WEST,4,1701,1732,3433
BUNGOMA,BUNGOMA WEST,0 - 4,7880,7972,15852
BUNGOMA,BUNGOMA WEST,5,1911,1881,3792
BUNGOMA,BUNGOMA WEST,6,1876,1974,3850
BUNGOMA,BUNGOMA WEST,7,1906,1899,3805
BUNGOMA,BUNGOMA WEST,8,1741,1816,3557
BUNGOMA,BUNGOMA WEST,9,2138,2049,4187
BUNGOMA,BUNGOMA WEST,05-Sep,9572,9619,19191
BUNGOMA,BUNGOMA WEST,10,1974,1968,3942
BUNGOMA,BUNGOMA WEST,11,1982,1969,3951
BUNGOMA,BUNGOMA WEST,12,1912,1978,3890
BUNGOMA,BUNGOMA WEST,13,2135,2111,4246
BUNGOMA,BUNGOMA WEST,14,1870,1841,3711
BUNGOMA,BUNGOMA WEST,Oct-14,9873,9867,19740
BUNGOMA,BUNGOMA WEST,15,1913,1923,3836
BUNGOMA,BUNGOMA WEST,16,1572,1559,3131
BUNGOMA,BUNGOMA WEST,17,1650,1550,3200
BUNGOMA,BUNGOMA WEST,18,1184,1094,2278
BUNGOMA,BUNGOMA WEST,19,1305,1271,2576
BUNGOMA,BUNGOMA WEST,15-19,7624,7397,15021
BUNGOMA,BUNGOMA WEST,20,1017,1099,2116
BUNGOMA,BUNGOMA WEST,21,868,1030,1898
BUNGOMA,BUNGOMA WEST,22,748,934,1682
BUNGOMA,BUNGOMA WEST,23,844,993,1837
BUNGOMA,BUNGOMA WEST,24,672,892,1564
BUNGOMA,BUNGOMA WEST,20-24,4149,4948,9097
BUNGOMA,BUNGOMA WEST,25,808,1061,1869
BUNGOMA,BUNGOMA WEST,26,666,820,1486
BUNGOMA,BUNGOMA WEST,27,723,879,1602
BUNGOMA,BUNGOMA WEST,28,470,635,1105
BUNGOMA,BUNGOMA WEST,29,601,679,1280
BUNGOMA,BUNGOMA WEST,25-29,3268,4074,7342
BUNGOMA,BUNGOMA WEST,30,695,848,1543
BUNGOMA,BUNGOMA WEST,31,666,883,1549
BUNGOMA,BUNGOMA WEST,32,763,861,1624
BUNGOMA,BUNGOMA WEST,33,658,648,1306
BUNGOMA,BUNGOMA WEST,34,485,491,976
BUNGOMA,BUNGOMA WEST,30-34,3267,3731,6998
BUNGOMA,BUNGOMA WEST,35,643,618,1261
BUNGOMA,BUNGOMA WEST,36,496,448,944
BUNGOMA,BUNGOMA WEST,37,532,481,1013
BUNGOMA,BUNGOMA WEST,38,366,331,697
BUNGOMA,BUNGOMA WEST,39,429,392,821
BUNGOMA,BUNGOMA WEST,35-39,2466,2270,4736
BUNGOMA,BUNGOMA WEST,40,471,456,927
BUNGOMA,BUNGOMA WEST,41,480,509,989
BUNGOMA,BUNGOMA WEST,42,495,562,1057
BUNGOMA,BUNGOMA WEST,43,503,523,1026
BUNGOMA,BUNGOMA WEST,44,323,362,685
BUNGOMA,BUNGOMA WEST,40-44,2272,2412,4684
BUNGOMA,BUNGOMA WEST,45,509,518,1027
BUNGOMA,BUNGOMA WEST,46,426,393,819
BUNGOMA,BUNGOMA WEST,47,412,392,804
BUNGOMA,BUNGOMA WEST,48,251,259,510
BUNGOMA,BUNGOMA WEST,49,289,303,592
BUNGOMA,BUNGOMA WEST,45-49,1887,1865,3752
BUNGOMA,BUNGOMA WEST,50,284,360,644
BUNGOMA,BUNGOMA WEST,51,321,337,658
BUNGOMA,BUNGOMA WEST,52,236,276,512
BUNGOMA,BUNGOMA WEST,53,235,297,532
BUNGOMA,BUNGOMA WEST,54,259,267,526
BUNGOMA,BUNGOMA WEST,50-54,1335,1537,2872
BUNGOMA,BUNGOMA WEST,55,328,356,684
BUNGOMA,BUNGOMA WEST,56,240,306,546
BUNGOMA,BUNGOMA WEST,57,268,423,691
BUNGOMA,BUNGOMA WEST,58,213,268,481
BUNGOMA,BUNGOMA WEST,59,344,335,679
BUNGOMA,BUNGOMA WEST,55-59,1393,1688,3081
BUNGOMA,BUNGOMA WEST,60,298,315,613
BUNGOMA,BUNGOMA WEST,61,232,318,550
BUNGOMA,BUNGOMA WEST,62,180,188,368
BUNGOMA,BUNGOMA WEST,63,258,280,538
BUNGOMA,BUNGOMA WEST,64,167,219,386
BUNGOMA,BUNGOMA WEST,60-64,1135,1320,2455
BUNGOMA,BUNGOMA WEST,65,189,261,450
BUNGOMA,BUNGOMA WEST,66,143,196,339
BUNGOMA,BUNGOMA WEST,67,182,244,426
BUNGOMA,BUNGOMA WEST,68,97,124,221
BUNGOMA,BUNGOMA WEST,69,169,180,349
BUNGOMA,BUNGOMA WEST,65-69,780,1005,1785
BUNGOMA,BUNGOMA WEST,70,137,180,317
BUNGOMA,BUNGOMA WEST,71,146,193,339
BUNGOMA,BUNGOMA WEST,72,94,133,227
BUNGOMA,BUNGOMA WEST,73,116,140,256
BUNGOMA,BUNGOMA WEST,74,88,106,194
BUNGOMA,BUNGOMA WEST,70-74,581,752,1333
BUNGOMA,BUNGOMA WEST,75,82,126,208
BUNGOMA,BUNGOMA WEST,76,52,86,138
BUNGOMA,BUNGOMA WEST,77,74,156,230
BUNGOMA,BUNGOMA WEST,78,52,54,106
BUNGOMA,BUNGOMA WEST,79,51,74,125
BUNGOMA,BUNGOMA WEST,75-79,311,496,807
BUNGOMA,BUNGOMA WEST,80,63,84,147
BUNGOMA,BUNGOMA WEST,81,43,61,104
BUNGOMA,BUNGOMA WEST,82,39,65,104
BUNGOMA,BUNGOMA WEST,83,58,79,137
BUNGOMA,BUNGOMA WEST,84,43,41,84
BUNGOMA,BUNGOMA WEST,80-84,246,330,576
BUNGOMA,BUNGOMA WEST,85,30,58,88
BUNGOMA,BUNGOMA WEST,86,18,45,63
BUNGOMA,BUNGOMA WEST,87,27,64,91
BUNGOMA,BUNGOMA WEST,88,18,24,42
BUNGOMA,BUNGOMA WEST,89,23,51,74
BUNGOMA,BUNGOMA WEST,85-89,116,242,358
BUNGOMA,BUNGOMA WEST,90,13,15,28
BUNGOMA,BUNGOMA WEST,91,21,27,48
BUNGOMA,BUNGOMA WEST,92,4,14,18
BUNGOMA,BUNGOMA WEST,93,8,14,22
BUNGOMA,BUNGOMA WEST,94,2,7,9
BUNGOMA,BUNGOMA WEST,90-94,48,77,125
BUNGOMA,BUNGOMA WEST,95,10,16,26
BUNGOMA,BUNGOMA WEST,96,1,4,5
BUNGOMA,BUNGOMA WEST,97,4,19,23
BUNGOMA,BUNGOMA WEST,98,2,2,4
BUNGOMA,BUNGOMA WEST,99,-,2,2
BUNGOMA,BUNGOMA WEST,95-99,17,43,60
BUNGOMA,BUNGOMA WEST,100+,5,4,9
BUNGOMA,BUNGOMA WEST,Not Stated,-,-,-
BUNGOMA,TONGAREN,Total,48685,51657,100342
BUNGOMA,TONGAREN,0,1155,1170,2325
BUNGOMA,TONGAREN,1,1227,1214,2441
BUNGOMA,TONGAREN,2,1303,1309,2612
BUNGOMA,TONGAREN,3,1384,1432,2816
BUNGOMA,TONGAREN,4,1383,1383,2766
BUNGOMA,TONGAREN,0 - 4,6452,6508,12960
BUNGOMA,TONGAREN,5,1459,1398,2857
BUNGOMA,TONGAREN,6,1474,1506,2980
BUNGOMA,TONGAREN,7,1511,1463,2974
BUNGOMA,TONGAREN,8,1428,1396,2824
BUNGOMA,TONGAREN,9,1738,1614,3352
BUNGOMA,TONGAREN,05-Sep,7610,7377,14987
BUNGOMA,TONGAREN,10,1682,1616,3298
BUNGOMA,TONGAREN,11,1521,1634,3155
BUNGOMA,TONGAREN,12,1765,1666,3431
BUNGOMA,TONGAREN,13,1685,1699,3384
BUNGOMA,TONGAREN,14,1581,1523,3104
BUNGOMA,TONGAREN,Oct-14,8234,8138,16372
BUNGOMA,TONGAREN,15,1500,1521,3021
BUNGOMA,TONGAREN,16,1422,1400,2822
BUNGOMA,TONGAREN,17,1538,1349,2887
BUNGOMA,TONGAREN,18,1206,1037,2243
BUNGOMA,TONGAREN,19,1249,1139,2388
BUNGOMA,TONGAREN,15-19,6915,6446,13361
BUNGOMA,TONGAREN,20,986,976,1962
BUNGOMA,TONGAREN,21,817,782,1599
BUNGOMA,TONGAREN,22,703,741,1444
BUNGOMA,TONGAREN,23,694,752,1446
BUNGOMA,TONGAREN,24,562,652,1214
BUNGOMA,TONGAREN,20-24,3762,3903,7665
BUNGOMA,TONGAREN,25,609,750,1359
BUNGOMA,TONGAREN,26,495,620,1115
BUNGOMA,TONGAREN,27,518,595,1113
BUNGOMA,TONGAREN,28,393,484,877
BUNGOMA,TONGAREN,29,493,573,1066
BUNGOMA,TONGAREN,25-29,2508,3022,5530
BUNGOMA,TONGAREN,30,537,717,1254
BUNGOMA,TONGAREN,31,479,617,1096
BUNGOMA,TONGAREN,32,512,710,1222
BUNGOMA,TONGAREN,33,503,580,1083
BUNGOMA,TONGAREN,34,414,443,857
BUNGOMA,TONGAREN,30-34,2445,3067,5512
BUNGOMA,TONGAREN,35,485,568,1053
BUNGOMA,TONGAREN,36,394,490,884
BUNGOMA,TONGAREN,37,382,432,814
BUNGOMA,TONGAREN,38,320,403,723
BUNGOMA,TONGAREN,39,344,418,762
BUNGOMA,TONGAREN,35-39,1925,2311,4236
BUNGOMA,TONGAREN,40,394,436,830
BUNGOMA,TONGAREN,41,394,548,942
BUNGOMA,TONGAREN,42,387,517,904
BUNGOMA,TONGAREN,43,379,486,865
BUNGOMA,TONGAREN,44,304,379,683
BUNGOMA,TONGAREN,40-44,1858,2366,4224
BUNGOMA,TONGAREN,45,439,485,924
BUNGOMA,TONGAREN,46,324,390,714
BUNGOMA,TONGAREN,47,322,404,726
BUNGOMA,TONGAREN,48,254,319,573
BUNGOMA,TONGAREN,49,293,362,655
BUNGOMA,TONGAREN,45-49,1632,1960,3592
BUNGOMA,TONGAREN,50,316,381,697
BUNGOMA,TONGAREN,51,319,380,699
BUNGOMA,TONGAREN,52,264,347,611
BUNGOMA,TONGAREN,53,209,294,503
BUNGOMA,TONGAREN,54,234,291,525
BUNGOMA,TONGAREN,50-54,1342,1693,3035
BUNGOMA,TONGAREN,55,241,313,554
BUNGOMA,TONGAREN,56,240,289,529
BUNGOMA,TONGAREN,57,290,346,636
BUNGOMA,TONGAREN,58,203,259,462
BUNGOMA,TONGAREN,59,309,323,632
BUNGOMA,TONGAREN,55-59,1283,1530,2813
BUNGOMA,TONGAREN,60,303,290,593
BUNGOMA,TONGAREN,61,209,227,436
BUNGOMA,TONGAREN,62,185,208,393
BUNGOMA,TONGAREN,63,220,245,465
BUNGOMA,TONGAREN,64,137,149,286
BUNGOMA,TONGAREN,60-64,1054,1119,2173
BUNGOMA,TONGAREN,65,188,192,380
BUNGOMA,TONGAREN,66,111,163,274
BUNGOMA,TONGAREN,67,140,169,309
BUNGOMA,TONGAREN,68,87,110,197
BUNGOMA,TONGAREN,69,116,140,256
BUNGOMA,TONGAREN,65-69,642,774,1416
BUNGOMA,TONGAREN,70,118,146,264
BUNGOMA,TONGAREN,71,110,106,216
BUNGOMA,TONGAREN,72,78,93,171
BUNGOMA,TONGAREN,73,65,112,177
BUNGOMA,TONGAREN,74,54,84,138
BUNGOMA,TONGAREN,70-74,425,541,966
BUNGOMA,TONGAREN,75,49,81,130
BUNGOMA,TONGAREN,76,63,114,177
BUNGOMA,TONGAREN,77,49,103,152
BUNGOMA,TONGAREN,78,38,49,87
BUNGOMA,TONGAREN,79,38,51,89
BUNGOMA,TONGAREN,75-79,237,398,635
BUNGOMA,TONGAREN,80,48,74,122
BUNGOMA,TONGAREN,81,36,43,79
BUNGOMA,TONGAREN,82,36,46,82
BUNGOMA,TONGAREN,83,43,59,102
BUNGOMA,TONGAREN,84,22,32,54
BUNGOMA,TONGAREN,80-84,185,254,439
BUNGOMA,TONGAREN,85,25,45,70
BUNGOMA,TONGAREN,86,15,27,42
BUNGOMA,TONGAREN,87,20,39,59
BUNGOMA,TONGAREN,88,12,15,27
BUNGOMA,TONGAREN,89,27,33,60
BUNGOMA,TONGAREN,85-89,99,159,258
BUNGOMA,TONGAREN,90,18,9,27
BUNGOMA,TONGAREN,91,10,20,30
BUNGOMA,TONGAREN,92,11,11,22
BUNGOMA,TONGAREN,93,2,12,14
BUNGOMA,TONGAREN,94,3,8,11
BUNGOMA,TONGAREN,90-94,44,60,104
BUNGOMA,TONGAREN,95,16,7,23
BUNGOMA,TONGAREN,96,5,2,7
BUNGOMA,TONGAREN,97,5,12,17
BUNGOMA,TONGAREN,98,2,3,5
BUNGOMA,TONGAREN,99,2,1,3
BUNGOMA,TONGAREN,95-99,30,25,55
BUNGOMA,TONGAREN,100+,3,6,9
BUNGOMA,TONGAREN,Not Stated,-,-,-
BUNGOMA,WEBUYE WEST,Total,74180,78331,152511
BUNGOMA,WEBUYE WEST,0,1810,1857,3667
BUNGOMA,WEBUYE WEST,1,1835,1893,3728
BUNGOMA,WEBUYE WEST,2,1913,1960,3873
BUNGOMA,WEBUYE WEST,3,2041,2104,4145
BUNGOMA,WEBUYE WEST,4,2140,2035,4175
BUNGOMA,WEBUYE WEST,0 - 4,9739,9849,19588
BUNGOMA,WEBUYE WEST,5,2337,2288,4625
BUNGOMA,WEBUYE WEST,6,2293,2279,4572
BUNGOMA,WEBUYE WEST,7,2221,2250,4471
BUNGOMA,WEBUYE WEST,8,2134,2151,4285
BUNGOMA,WEBUYE WEST,9,2505,2458,4963
BUNGOMA,WEBUYE WEST,05-Sep,11490,11426,22916
BUNGOMA,WEBUYE WEST,10,2456,2517,4973
BUNGOMA,WEBUYE WEST,11,2386,2452,4838
BUNGOMA,WEBUYE WEST,12,2545,2444,4989
BUNGOMA,WEBUYE WEST,13,2576,2588,5164
BUNGOMA,WEBUYE WEST,14,2409,2318,4727
BUNGOMA,WEBUYE WEST,Oct-14,12372,12319,24691
BUNGOMA,WEBUYE WEST,15,2415,2247,4662
BUNGOMA,WEBUYE WEST,16,2141,2087,4228
BUNGOMA,WEBUYE WEST,17,2189,2124,4313
BUNGOMA,WEBUYE WEST,18,1629,1505,3134
BUNGOMA,WEBUYE WEST,19,1788,1751,3539
BUNGOMA,WEBUYE WEST,15-19,10162,9714,19876
BUNGOMA,WEBUYE WEST,20,1372,1535,2907
BUNGOMA,WEBUYE WEST,21,1167,1316,2483
BUNGOMA,WEBUYE WEST,22,1072,1248,2320
BUNGOMA,WEBUYE WEST,23,1147,1402,2549
BUNGOMA,WEBUYE WEST,24,926,1139,2065
BUNGOMA,WEBUYE WEST,20-24,5684,6640,12324
BUNGOMA,WEBUYE WEST,25,1089,1367,2456
BUNGOMA,WEBUYE WEST,26,793,1065,1858
BUNGOMA,WEBUYE WEST,27,963,1084,2047
BUNGOMA,WEBUYE WEST,28,680,852,1532
BUNGOMA,WEBUYE WEST,29,816,982,1798
BUNGOMA,WEBUYE WEST,25-29,4341,5350,9691
BUNGOMA,WEBUYE WEST,30,896,1164,2060
BUNGOMA,WEBUYE WEST,31,822,1150,1972
BUNGOMA,WEBUYE WEST,32,1041,1284,2325
BUNGOMA,WEBUYE WEST,33,794,964,1758
BUNGOMA,WEBUYE WEST,34,674,773,1447
BUNGOMA,WEBUYE WEST,30-34,4227,5335,9562
BUNGOMA,WEBUYE WEST,35,843,879,1722
BUNGOMA,WEBUYE WEST,36,673,666,1339
BUNGOMA,WEBUYE WEST,37,690,654,1344
BUNGOMA,WEBUYE WEST,38,542,544,1086
BUNGOMA,WEBUYE WEST,39,586,645,1231
BUNGOMA,WEBUYE WEST,35-39,3334,3388,6722
BUNGOMA,WEBUYE WEST,40,622,749,1371
BUNGOMA,WEBUYE WEST,41,719,721,1440
BUNGOMA,WEBUYE WEST,42,704,714,1418
BUNGOMA,WEBUYE WEST,43,638,627,1265
BUNGOMA,WEBUYE WEST,44,402,420,822
BUNGOMA,WEBUYE WEST,40-44,3085,3231,6316
BUNGOMA,WEBUYE WEST,45,752,678,1430
BUNGOMA,WEBUYE WEST,46,528,525,1053
BUNGOMA,WEBUYE WEST,47,545,592,1137
BUNGOMA,WEBUYE WEST,48,319,374,693
BUNGOMA,WEBUYE WEST,49,430,371,801
BUNGOMA,WEBUYE WEST,45-49,2574,2540,5114
BUNGOMA,WEBUYE WEST,50,402,553,955
BUNGOMA,WEBUYE WEST,51,382,414,796
BUNGOMA,WEBUYE WEST,52,348,354,702
BUNGOMA,WEBUYE WEST,53,261,319,580
BUNGOMA,WEBUYE WEST,54,274,335,609
BUNGOMA,WEBUYE WEST,50-54,1667,1975,3642
BUNGOMA,WEBUYE WEST,55,337,397,734
BUNGOMA,WEBUYE WEST,56,317,425,742
BUNGOMA,WEBUYE WEST,57,364,422,786
BUNGOMA,WEBUYE WEST,58,289,322,611
BUNGOMA,WEBUYE WEST,59,420,394,814
BUNGOMA,WEBUYE WEST,55-59,1727,1960,3687
BUNGOMA,WEBUYE WEST,60,305,374,679
BUNGOMA,WEBUYE WEST,61,291,320,611
BUNGOMA,WEBUYE WEST,62,248,280,528
BUNGOMA,WEBUYE WEST,63,249,325,574
BUNGOMA,WEBUYE WEST,64,212,208,420
BUNGOMA,WEBUYE WEST,60-64,1305,1507,2812
BUNGOMA,WEBUYE WEST,65,246,305,551
BUNGOMA,WEBUYE WEST,66,157,188,345
BUNGOMA,WEBUYE WEST,67,214,234,448
BUNGOMA,WEBUYE WEST,68,112,133,245
BUNGOMA,WEBUYE WEST,69,176,195,371
BUNGOMA,WEBUYE WEST,65-69,905,1055,1960
BUNGOMA,WEBUYE WEST,70,162,205,367
BUNGOMA,WEBUYE WEST,71,160,161,321
BUNGOMA,WEBUYE WEST,72,120,168,288
BUNGOMA,WEBUYE WEST,73,115,137,252
BUNGOMA,WEBUYE WEST,74,100,123,223
BUNGOMA,WEBUYE WEST,70-74,657,794,1451
BUNGOMA,WEBUYE WEST,75,82,129,211
BUNGOMA,WEBUYE WEST,76,74,120,194
BUNGOMA,WEBUYE WEST,77,101,151,252
BUNGOMA,WEBUYE WEST,78,66,61,127
BUNGOMA,WEBUYE WEST,79,68,84,152
BUNGOMA,WEBUYE WEST,75-79,391,545,936
BUNGOMA,WEBUYE WEST,80,94,93,187
BUNGOMA,WEBUYE WEST,81,53,70,123
BUNGOMA,WEBUYE WEST,82,46,60,106
BUNGOMA,WEBUYE WEST,83,58,96,154
BUNGOMA,WEBUYE WEST,84,32,30,62
BUNGOMA,WEBUYE WEST,80-84,283,349,632
BUNGOMA,WEBUYE WEST,85,31,59,90
BUNGOMA,WEBUYE WEST,86,28,31,59
BUNGOMA,WEBUYE WEST,87,38,66,104
BUNGOMA,WEBUYE WEST,88,22,25,47
BUNGOMA,WEBUYE WEST,89,30,52,82
BUNGOMA,WEBUYE WEST,85-89,149,233,382
BUNGOMA,WEBUYE WEST,90,13,11,24
BUNGOMA,WEBUYE WEST,91,13,22,35
BUNGOMA,WEBUYE WEST,92,12,13,25
BUNGOMA,WEBUYE WEST,93,8,18,26
BUNGOMA,WEBUYE WEST,94,5,9,14
BUNGOMA,WEBUYE WEST,90-94,51,73,124
BUNGOMA,WEBUYE WEST,95,13,13,26
BUNGOMA,WEBUYE WEST,96,4,7,11
BUNGOMA,WEBUYE WEST,97,9,16,25
BUNGOMA,WEBUYE WEST,98,2,2,4
BUNGOMA,WEBUYE WEST,99,4,2,6
BUNGOMA,WEBUYE WEST,95-99,32,40,72
BUNGOMA,WEBUYE WEST,100+,5,8,13
BUNGOMA,WEBUYE WEST,Not Stated,-,-,-
BUNGOMA,MT ELGON FOREST,Total,1862,1759,3621
BUNGOMA,MT ELGON FOREST,0,61,70,131
BUNGOMA,MT ELGON FOREST,1,45,61,106
BUNGOMA,MT ELGON FOREST,2,58,62,120
BUNGOMA,MT ELGON FOREST,3,86,75,161
BUNGOMA,MT ELGON FOREST,4,66,64,130
BUNGOMA,MT ELGON FOREST,0 - 4,316,332,648
BUNGOMA,MT ELGON FOREST,5,75,63,138
BUNGOMA,MT ELGON FOREST,6,78,62,140
BUNGOMA,MT ELGON FOREST,7,48,61,109
BUNGOMA,MT ELGON FOREST,8,39,51,90
BUNGOMA,MT ELGON FOREST,9,44,60,104
BUNGOMA,MT ELGON FOREST,05-Sep,284,297,581
BUNGOMA,MT ELGON FOREST,10,53,59,112
BUNGOMA,MT ELGON FOREST,11,44,43,87
BUNGOMA,MT ELGON FOREST,12,76,63,139
BUNGOMA,MT ELGON FOREST,13,62,37,99
BUNGOMA,MT ELGON FOREST,14,55,49,104
BUNGOMA,MT ELGON FOREST,Oct-14,290,251,541
BUNGOMA,MT ELGON FOREST,15,50,33,83
BUNGOMA,MT ELGON FOREST,16,51,38,89
BUNGOMA,MT ELGON FOREST,17,45,34,79
BUNGOMA,MT ELGON FOREST,18,30,25,55
BUNGOMA,MT ELGON FOREST,19,39,52,91
BUNGOMA,MT ELGON FOREST,15-19,215,182,397
BUNGOMA,MT ELGON FOREST,20,47,43,90
BUNGOMA,MT ELGON FOREST,21,29,31,60
BUNGOMA,MT ELGON FOREST,22,46,34,80
BUNGOMA,MT ELGON FOREST,23,26,30,56
BUNGOMA,MT ELGON FOREST,24,27,32,59
BUNGOMA,MT ELGON FOREST,20-24,175,170,345
BUNGOMA,MT ELGON FOREST,25,33,20,53
BUNGOMA,MT ELGON FOREST,26,26,26,52
BUNGOMA,MT ELGON FOREST,27,32,27,59
BUNGOMA,MT ELGON FOREST,28,21,9,30
BUNGOMA,MT ELGON FOREST,29,34,27,61
BUNGOMA,MT ELGON FOREST,25-29,146,109,255
BUNGOMA,MT ELGON FOREST,30,27,30,57
BUNGOMA,MT ELGON FOREST,31,21,8,29
BUNGOMA,MT ELGON FOREST,32,25,21,46
BUNGOMA,MT ELGON FOREST,33,15,14,29
BUNGOMA,MT ELGON FOREST,34,12,11,23
BUNGOMA,MT ELGON FOREST,30-34,100,84,184
BUNGOMA,MT ELGON FOREST,35,25,11,36
BUNGOMA,MT ELGON FOREST,36,16,4,20
BUNGOMA,MT ELGON FOREST,37,13,8,21
BUNGOMA,MT ELGON FOREST,38,11,10,21
BUNGOMA,MT ELGON FOREST,39,9,7,16
BUNGOMA,MT ELGON FOREST,35-39,74,40,114
BUNGOMA,MT ELGON FOREST,40,10,11,21
BUNGOMA,MT ELGON FOREST,41,4,9,13
BUNGOMA,MT ELGON FOREST,42,14,14,28
BUNGOMA,MT ELGON FOREST,43,5,4,9
BUNGOMA,MT ELGON FOREST,44,5,5,10
BUNGOMA,MT ELGON FOREST,40-44,38,43,81
BUNGOMA,MT ELGON FOREST,45,12,10,22
BUNGOMA,MT ELGON FOREST,46,8,10,18
BUNGOMA,MT ELGON FOREST,47,7,10,17
BUNGOMA,MT ELGON FOREST,48,3,11,14
BUNGOMA,MT ELGON FOREST,49,4,3,7
BUNGOMA,MT ELGON FOREST,45-49,34,44,78
BUNGOMA,MT ELGON FOREST,50,10,9,19
BUNGOMA,MT ELGON FOREST,51,6,3,9
BUNGOMA,MT ELGON FOREST,52,8,4,12
BUNGOMA,MT ELGON FOREST,53,7,9,16
BUNGOMA,MT ELGON FOREST,54,6,7,13
BUNGOMA,MT ELGON FOREST,50-54,37,32,69
BUNGOMA,MT ELGON FOREST,55,6,14,20
BUNGOMA,MT ELGON FOREST,56,7,12,19
BUNGOMA,MT ELGON FOREST,57,10,6,16
BUNGOMA,MT ELGON FOREST,58,8,3,11
BUNGOMA,MT ELGON FOREST,59,9,17,26
BUNGOMA,MT ELGON FOREST,55-59,40,52,92
BUNGOMA,MT ELGON FOREST,60,10,14,24
BUNGOMA,MT ELGON FOREST,61,6,8,14
BUNGOMA,MT ELGON FOREST,62,8,7,15
BUNGOMA,MT ELGON FOREST,63,7,7,14
BUNGOMA,MT ELGON FOREST,64,5,6,11
BUNGOMA,MT ELGON FOREST,60-64,36,42,78
BUNGOMA,MT ELGON FOREST,65,11,10,21
BUNGOMA,MT ELGON FOREST,66,7,9,16
BUNGOMA,MT ELGON FOREST,67,7,8,15
BUNGOMA,MT ELGON FOREST,68,1,7,8
BUNGOMA,MT ELGON FOREST,69,5,7,12
BUNGOMA,MT ELGON FOREST,65-69,31,41,72
BUNGOMA,MT ELGON FOREST,70,2,5,7
BUNGOMA,MT ELGON FOREST,71,6,3,9
BUNGOMA,MT ELGON FOREST,72,4,3,7
BUNGOMA,MT ELGON FOREST,73,4,3,7
BUNGOMA,MT ELGON FOREST,74,5,-,5
BUNGOMA,MT ELGON FOREST,70-74,21,14,35
BUNGOMA,MT ELGON FOREST,75,5,3,8
BUNGOMA,MT ELGON FOREST,76,1,1,2
BUNGOMA,MT ELGON FOREST,77,3,3,6
BUNGOMA,MT ELGON FOREST,78,2,1,3
BUNGOMA,MT ELGON FOREST,79,1,1,2
BUNGOMA,MT ELGON FOREST,75-79,12,9,21
BUNGOMA,MT ELGON FOREST,80,1,4,5
BUNGOMA,MT ELGON FOREST,81,2,2,4
BUNGOMA,MT ELGON FOREST,82,1,2,3
BUNGOMA,MT ELGON FOREST,83,1,1,2
BUNGOMA,MT ELGON FOREST,84,1,-,1
BUNGOMA,MT ELGON FOREST,80-84,6,9,15
BUNGOMA,MT ELGON FOREST,85,2,1,3
BUNGOMA,MT ELGON FOREST,86,-,-,-
BUNGOMA,MT ELGON FOREST,87,1,1,2
BUNGOMA,MT ELGON FOREST,88,-,-,-
BUNGOMA,MT ELGON FOREST,89,1,1,2
BUNGOMA,MT ELGON FOREST,85-89,4,3,7
BUNGOMA,MT ELGON FOREST,90,-,-,-
BUNGOMA,MT ELGON FOREST,91,1,-,1
BUNGOMA,MT ELGON FOREST,92,-,1,1
BUNGOMA,MT ELGON FOREST,93,-,-,-
BUNGOMA,MT ELGON FOREST,94,1,2,3
BUNGOMA,MT ELGON FOREST,90-94,2,3,5
BUNGOMA,MT ELGON FOREST,95,1,1,2
BUNGOMA,MT ELGON FOREST,96,-,-,-
BUNGOMA,MT ELGON FOREST,97,-,-,-
BUNGOMA,MT ELGON FOREST,98,-,1,1
BUNGOMA,MT ELGON FOREST,99,-,-,-
BUNGOMA,MT ELGON FOREST,95-99,1,2,3
BUNGOMA,MT ELGON FOREST,100+,-,-,-
BUNGOMA,MT ELGON FOREST,Not Stated,-,-,-
BUSIA,ALL,Total,426252,467401,893653
BUSIA,ALL,0,10487,10707,21194
BUSIA,ALL,1,11275,11341,22616
BUSIA,ALL,2,11265,11220,22485
BUSIA,ALL,3,11671,12072,23743
BUSIA,ALL,4,11617,11649,23266
BUSIA,ALL,0 - 4,56315,56989,113304
BUSIA,ALL,5,11926,12123,24049
BUSIA,ALL,6,12614,13057,25671
BUSIA,ALL,7,12819,12909,25728
BUSIA,ALL,8,12147,12669,24816
BUSIA,ALL,9,13329,13690,27019
BUSIA,ALL,05-Sep,62835,64448,127283
BUSIA,ALL,10,14050,14084,28134
BUSIA,ALL,11,12849,13607,26456
BUSIA,ALL,12,14570,14457,29027
BUSIA,ALL,13,14102,14564,28666
BUSIA,ALL,14,13247,13404,26651
BUSIA,ALL,Oct-14,68818,70116,138934
BUSIA,ALL,15,13190,13268,26458
BUSIA,ALL,16,12152,12607,24759
BUSIA,ALL,17,12563,12436,24999
BUSIA,ALL,18,10336,9811,20147
BUSIA,ALL,19,10460,10469,20929
BUSIA,ALL,15-19,58701,58591,117292
BUSIA,ALL,20,9205,9767,18972
BUSIA,ALL,21,7253,8000,15253
BUSIA,ALL,22,6799,8220,15019
BUSIA,ALL,23,6454,7962,14416
BUSIA,ALL,24,5874,7236,13110
BUSIA,ALL,20-24,35585,41185,76770
BUSIA,ALL,25,6278,7824,14102
BUSIA,ALL,26,5196,6911,12107
BUSIA,ALL,27,5437,6780,12217
BUSIA,ALL,28,4310,5782,10092
BUSIA,ALL,29,4474,5585,10059
BUSIA,ALL,25-29,25695,32882,58577
BUSIA,ALL,30,5647,7743,13390
BUSIA,ALL,31,4328,5601,9929
BUSIA,ALL,32,5619,7174,12793
BUSIA,ALL,33,4577,5757,10334
BUSIA,ALL,34,4093,4897,8990
BUSIA,ALL,30-34,24264,31172,55436
BUSIA,ALL,35,5137,5446,10583
BUSIA,ALL,36,3960,3974,7934
BUSIA,ALL,37,4114,3994,8108
BUSIA,ALL,38,2978,3130,6108
BUSIA,ALL,39,3361,3368,6729
BUSIA,ALL,35-39,19550,19912,39462
BUSIA,ALL,40,4086,4493,8579
BUSIA,ALL,41,3509,4009,7518
BUSIA,ALL,42,3742,4118,7860
BUSIA,ALL,43,3355,3583,6938
BUSIA,ALL,44,2585,2738,5323
BUSIA,ALL,40-44,17277,18941,36218
BUSIA,ALL,45,3672,4030,7702
BUSIA,ALL,46,2530,2686,5216
BUSIA,ALL,47,2849,3118,5967
BUSIA,ALL,48,1871,2118,3989
BUSIA,ALL,49,2045,2392,4437
BUSIA,ALL,45-49,12967,14344,27311
BUSIA,ALL,50,2845,4000,6845
BUSIA,ALL,51,2351,3030,5381
BUSIA,ALL,52,1942,2412,4354
BUSIA,ALL,53,1710,2128,3838
BUSIA,ALL,54,1774,2105,3879
BUSIA,ALL,50-54,10622,13675,24297
BUSIA,ALL,55,1952,2290,4242
BUSIA,ALL,56,1969,2324,4293
BUSIA,ALL,57,2094,3296,5390
BUSIA,ALL,58,1650,2096,3746
BUSIA,ALL,59,2072,2579,4651
BUSIA,ALL,55-59,9737,12585,22322
BUSIA,ALL,60,2206,2887,5093
BUSIA,ALL,61,1755,2135,3890
BUSIA,ALL,62,1393,1745,3138
BUSIA,ALL,63,1443,1787,3230
BUSIA,ALL,64,1154,1610,2764
BUSIA,ALL,60-64,7951,10164,18115
BUSIA,ALL,65,1476,2041,3517
BUSIA,ALL,66,990,1276,2266
BUSIA,ALL,67,1471,2002,3473
BUSIA,ALL,68,675,808,1483
BUSIA,ALL,69,1039,1438,2477
BUSIA,ALL,65-69,5651,7565,13216
BUSIA,ALL,70,1314,2132,3446
BUSIA,ALL,71,1027,1214,2241
BUSIA,ALL,72,784,877,1661
BUSIA,ALL,73,652,787,1439
BUSIA,ALL,74,660,982,1642
BUSIA,ALL,70-74,4437,5992,10429
BUSIA,ALL,75,619,915,1534
BUSIA,ALL,76,490,594,1084
BUSIA,ALL,77,653,869,1522
BUSIA,ALL,78,324,407,731
BUSIA,ALL,79,434,849,1283
BUSIA,ALL,75-79,2520,3634,6154
BUSIA,ALL,80,492,901,1393
BUSIA,ALL,81,362,476,838
BUSIA,ALL,82,288,341,629
BUSIA,ALL,83,352,396,748
BUSIA,ALL,84,265,460,725
BUSIA,ALL,80-84,1759,2574,4333
BUSIA,ALL,85,207,371,578
BUSIA,ALL,86,253,278,531
BUSIA,ALL,87,261,414,675
BUSIA,ALL,88,128,160,288
BUSIA,ALL,89,196,446,642
BUSIA,ALL,85-89,1045,1669,2714
BUSIA,ALL,90,93,227,320
BUSIA,ALL,91,106,123,229
BUSIA,ALL,92,51,64,115
BUSIA,ALL,93,59,68,127
BUSIA,ALL,94,40,110,150
BUSIA,ALL,90-94,349,592,941
BUSIA,ALL,95,45,79,124
BUSIA,ALL,96,25,36,61
BUSIA,ALL,97,46,49,95
BUSIA,ALL,98,8,37,45
BUSIA,ALL,99,16,58,74
BUSIA,ALL,95-99,140,259,399
BUSIA,ALL,100+,29,108,137
BUSIA,ALL,Not Stated,5,4,9
BUSIA,BUNYALA,Total,41465,44511,85976
BUSIA,BUNYALA,0,961,973,1934
BUSIA,BUNYALA,1,1037,991,2028
BUSIA,BUNYALA,2,1051,1058,2109
BUSIA,BUNYALA,3,1081,1104,2185
BUSIA,BUNYALA,4,1080,1076,2156
BUSIA,BUNYALA,0 - 4,5210,5202,10412
BUSIA,BUNYALA,5,1140,1160,2300
BUSIA,BUNYALA,6,1169,1246,2415
BUSIA,BUNYALA,7,1341,1319,2660
BUSIA,BUNYALA,8,1190,1168,2358
BUSIA,BUNYALA,9,1215,1342,2557
BUSIA,BUNYALA,05-Sep,6055,6235,12290
BUSIA,BUNYALA,10,1275,1290,2565
BUSIA,BUNYALA,11,1220,1292,2512
BUSIA,BUNYALA,12,1451,1375,2826
BUSIA,BUNYALA,13,1377,1331,2708
BUSIA,BUNYALA,14,1328,1241,2569
BUSIA,BUNYALA,Oct-14,6651,6529,13180
BUSIA,BUNYALA,15,1227,1204,2431
BUSIA,BUNYALA,16,1120,1186,2306
BUSIA,BUNYALA,17,1204,1075,2279
BUSIA,BUNYALA,18,977,889,1866
BUSIA,BUNYALA,19,1001,898,1899
BUSIA,BUNYALA,15-19,5529,5252,10781
BUSIA,BUNYALA,20,887,961,1848
BUSIA,BUNYALA,21,671,694,1365
BUSIA,BUNYALA,22,691,807,1498
BUSIA,BUNYALA,23,674,720,1394
BUSIA,BUNYALA,24,569,651,1220
BUSIA,BUNYALA,20-24,3492,3833,7325
BUSIA,BUNYALA,25,630,753,1383
BUSIA,BUNYALA,26,495,624,1119
BUSIA,BUNYALA,27,596,655,1251
BUSIA,BUNYALA,28,468,572,1040
BUSIA,BUNYALA,29,454,544,998
BUSIA,BUNYALA,25-29,2643,3148,5791
BUSIA,BUNYALA,30,579,859,1438
BUSIA,BUNYALA,31,496,573,1069
BUSIA,BUNYALA,32,639,765,1404
BUSIA,BUNYALA,33,535,577,1112
BUSIA,BUNYALA,34,461,479,940
BUSIA,BUNYALA,30-34,2710,3253,5963
BUSIA,BUNYALA,35,575,540,1115
BUSIA,BUNYALA,36,412,369,781
BUSIA,BUNYALA,37,475,394,869
BUSIA,BUNYALA,38,315,287,602
BUSIA,BUNYALA,39,363,370,733
BUSIA,BUNYALA,35-39,2140,1960,4100
BUSIA,BUNYALA,40,447,456,903
BUSIA,BUNYALA,41,378,327,705
BUSIA,BUNYALA,42,401,370,771
BUSIA,BUNYALA,43,339,343,682
BUSIA,BUNYALA,44,241,278,519
BUSIA,BUNYALA,40-44,1806,1774,3580
BUSIA,BUNYALA,45,376,370,746
BUSIA,BUNYALA,46,242,230,472
BUSIA,BUNYALA,47,266,263,529
BUSIA,BUNYALA,48,148,142,290
BUSIA,BUNYALA,49,151,194,345
BUSIA,BUNYALA,45-49,1183,1199,2382
BUSIA,BUNYALA,50,270,377,647
BUSIA,BUNYALA,51,213,271,484
BUSIA,BUNYALA,52,218,258,476
BUSIA,BUNYALA,53,149,203,352
BUSIA,BUNYALA,54,163,186,349
BUSIA,BUNYALA,50-54,1013,1295,2308
BUSIA,BUNYALA,55,184,226,410
BUSIA,BUNYALA,56,147,231,378
BUSIA,BUNYALA,57,208,375,583
BUSIA,BUNYALA,58,169,203,372
BUSIA,BUNYALA,59,193,244,437
BUSIA,BUNYALA,55-59,901,1279,2180
BUSIA,BUNYALA,60,195,342,537
BUSIA,BUNYALA,61,141,213,354
BUSIA,BUNYALA,62,123,173,296
BUSIA,BUNYALA,63,128,156,284
BUSIA,BUNYALA,64,122,172,294
BUSIA,BUNYALA,60-64,709,1056,1765
BUSIA,BUNYALA,65,153,209,362
BUSIA,BUNYALA,66,79,120,199
BUSIA,BUNYALA,67,155,208,363
BUSIA,BUNYALA,68,62,91,153
BUSIA,BUNYALA,69,92,171,263
BUSIA,BUNYALA,65-69,541,799,1340
BUSIA,BUNYALA,70,109,247,356
BUSIA,BUNYALA,71,97,118,215
BUSIA,BUNYALA,72,54,100,154
BUSIA,BUNYALA,73,56,93,149
BUSIA,BUNYALA,74,77,94,171
BUSIA,BUNYALA,70-74,393,652,1045
BUSIA,BUNYALA,75,53,135,188
BUSIA,BUNYALA,76,51,51,102
BUSIA,BUNYALA,77,54,96,150
BUSIA,BUNYALA,78,35,36,71
BUSIA,BUNYALA,79,31,88,119
BUSIA,BUNYALA,75-79,224,406,630
BUSIA,BUNYALA,80,40,139,179
BUSIA,BUNYALA,81,34,55,89
BUSIA,BUNYALA,82,24,38,62
BUSIA,BUNYALA,83,29,35,64
BUSIA,BUNYALA,84,24,63,87
BUSIA,BUNYALA,80-84,151,330,481
BUSIA,BUNYALA,85,21,39,60
BUSIA,BUNYALA,86,12,26,38
BUSIA,BUNYALA,87,16,40,56
BUSIA,BUNYALA,88,8,26,34
BUSIA,BUNYALA,89,11,48,59
BUSIA,BUNYALA,85-89,68,179,247
BUSIA,BUNYALA,90,9,38,47
BUSIA,BUNYALA,91,13,17,30
BUSIA,BUNYALA,92,4,11,15
BUSIA,BUNYALA,93,2,9,11
BUSIA,BUNYALA,94,3,14,17
BUSIA,BUNYALA,90-94,31,89,120
BUSIA,BUNYALA,95,1,12,13
BUSIA,BUNYALA,96,5,4,9
BUSIA,BUNYALA,97,4,8,12
BUSIA,BUNYALA,98,-,6,6
BUSIA,BUNYALA,99,1,4,5
BUSIA,BUNYALA,95-99,11,34,45
BUSIA,BUNYALA,100+,4,7,11
BUSIA,BUNYALA,Not Stated,-,-,-
BUSIA,BUSIA,Total,69034,73373,142407
BUSIA,BUSIA,0,1703,1741,3444
BUSIA,BUSIA,1,1738,1713,3451
BUSIA,BUSIA,2,1761,1715,3476
BUSIA,BUSIA,3,1803,1937,3740
BUSIA,BUSIA,4,1819,1792,3611
BUSIA,BUSIA,0 - 4,8824,8898,17722
BUSIA,BUSIA,5,1792,1873,3665
BUSIA,BUSIA,6,1871,1961,3832
BUSIA,BUSIA,7,1885,1965,3850
BUSIA,BUSIA,8,1776,1879,3655
BUSIA,BUSIA,9,1999,2104,4103
BUSIA,BUSIA,05-Sep,9323,9782,19105
BUSIA,BUSIA,10,2128,2160,4288
BUSIA,BUSIA,11,1937,1957,3894
BUSIA,BUSIA,12,2201,2078,4279
BUSIA,BUSIA,13,2081,2113,4194
BUSIA,BUSIA,14,1934,2067,4001
BUSIA,BUSIA,Oct-14,10281,10375,20656
BUSIA,BUSIA,15,1916,2016,3932
BUSIA,BUSIA,16,1792,1950,3742
BUSIA,BUSIA,17,1786,1948,3734
BUSIA,BUSIA,18,1630,1504,3134
BUSIA,BUSIA,19,1593,1701,3294
BUSIA,BUSIA,15-19,8717,9119,17836
BUSIA,BUSIA,20,1544,1617,3161
BUSIA,BUSIA,21,1158,1336,2494
BUSIA,BUSIA,22,1198,1449,2647
BUSIA,BUSIA,23,1216,1385,2601
BUSIA,BUSIA,24,1121,1321,2442
BUSIA,BUSIA,20-24,6237,7108,13345
BUSIA,BUSIA,25,1216,1399,2615
BUSIA,BUSIA,26,1027,1250,2277
BUSIA,BUSIA,27,1086,1239,2325
BUSIA,BUSIA,28,850,1082,1932
BUSIA,BUSIA,29,886,1008,1894
BUSIA,BUSIA,25-29,5065,5978,11043
BUSIA,BUSIA,30,1257,1427,2684
BUSIA,BUSIA,31,811,909,1720
BUSIA,BUSIA,32,1100,1219,2319
BUSIA,BUSIA,33,842,928,1770
BUSIA,BUSIA,34,759,794,1553
BUSIA,BUSIA,30-34,4769,5277,10046
BUSIA,BUSIA,35,1069,990,2059
BUSIA,BUSIA,36,715,720,1435
BUSIA,BUSIA,37,746,676,1422
BUSIA,BUSIA,38,603,563,1166
BUSIA,BUSIA,39,615,524,1139
BUSIA,BUSIA,35-39,3748,3473,7221
BUSIA,BUSIA,40,890,825,1715
BUSIA,BUSIA,41,628,638,1266
BUSIA,BUSIA,42,673,622,1295
BUSIA,BUSIA,43,523,546,1069
BUSIA,BUSIA,44,425,383,808
BUSIA,BUSIA,40-44,3139,3014,6153
BUSIA,BUSIA,45,694,648,1342
BUSIA,BUSIA,46,455,397,852
BUSIA,BUSIA,47,523,452,975
BUSIA,BUSIA,48,353,364,717
BUSIA,BUSIA,49,376,352,728
BUSIA,BUSIA,45-49,2401,2213,4614
BUSIA,BUSIA,50,535,636,1171
BUSIA,BUSIA,51,380,452,832
BUSIA,BUSIA,52,307,339,646
BUSIA,BUSIA,53,290,279,569
BUSIA,BUSIA,54,290,325,615
BUSIA,BUSIA,50-54,1802,2031,3833
BUSIA,BUSIA,55,321,358,679
BUSIA,BUSIA,56,301,338,639
BUSIA,BUSIA,57,271,437,708
BUSIA,BUSIA,58,219,297,516
BUSIA,BUSIA,59,329,368,697
BUSIA,BUSIA,55-59,1441,1798,3239
BUSIA,BUSIA,60,350,405,755
BUSIA,BUSIA,61,260,329,589
BUSIA,BUSIA,62,226,196,422
BUSIA,BUSIA,63,212,227,439
BUSIA,BUSIA,64,189,214,403
BUSIA,BUSIA,60-64,1237,1371,2608
BUSIA,BUSIA,65,209,255,464
BUSIA,BUSIA,66,135,167,302
BUSIA,BUSIA,67,199,285,484
BUSIA,BUSIA,68,93,97,190
BUSIA,BUSIA,69,129,185,314
BUSIA,BUSIA,65-69,765,989,1754
BUSIA,BUSIA,70,169,297,466
BUSIA,BUSIA,71,121,156,277
BUSIA,BUSIA,72,110,127,237
BUSIA,BUSIA,73,88,101,189
BUSIA,BUSIA,74,85,114,199
BUSIA,BUSIA,70-74,573,795,1368
BUSIA,BUSIA,75,88,139,227
BUSIA,BUSIA,76,54,79,133
BUSIA,BUSIA,77,81,88,169
BUSIA,BUSIA,78,40,59,99
BUSIA,BUSIA,79,54,113,167
BUSIA,BUSIA,75-79,317,478,795
BUSIA,BUSIA,80,56,113,169
BUSIA,BUSIA,81,43,54,97
BUSIA,BUSIA,82,48,62,110
BUSIA,BUSIA,83,36,42,78
BUSIA,BUSIA,84,25,71,96
BUSIA,BUSIA,80-84,208,342,550
BUSIA,BUSIA,85,23,36,59
BUSIA,BUSIA,86,39,42,81
BUSIA,BUSIA,87,30,41,71
BUSIA,BUSIA,88,9,19,28
BUSIA,BUSIA,89,23,61,84
BUSIA,BUSIA,85-89,124,199,323
BUSIA,BUSIA,90,5,34,39
BUSIA,BUSIA,91,14,20,34
BUSIA,BUSIA,92,6,8,14
BUSIA,BUSIA,93,9,10,19
BUSIA,BUSIA,94,2,19,21
BUSIA,BUSIA,90-94,36,91,127
BUSIA,BUSIA,95,5,7,12
BUSIA,BUSIA,96,3,2,5
BUSIA,BUSIA,97,9,1,10
BUSIA,BUSIA,98,2,6,8
BUSIA,BUSIA,99,2,8,10
BUSIA,BUSIA,95-99,21,24,45
BUSIA,BUSIA,100+,3,15,18
BUSIA,BUSIA,Not Stated,3,3,6
BUSIA,BUTULA,Total,65136,75195,140331
BUSIA,BUTULA,0,1595,1685,3280
BUSIA,BUTULA,1,1817,1762,3579
BUSIA,BUTULA,2,1736,1726,3462
BUSIA,BUTULA,3,1886,1885,3771
BUSIA,BUTULA,4,1817,1855,3672
BUSIA,BUTULA,0 - 4,8851,8913,17764
BUSIA,BUTULA,5,1911,1997,3908
BUSIA,BUTULA,6,2071,2016,4087
BUSIA,BUTULA,7,1988,2151,4139
BUSIA,BUTULA,8,1895,2058,3953
BUSIA,BUTULA,9,2195,2203,4398
BUSIA,BUTULA,05-Sep,10060,10425,20485
BUSIA,BUTULA,10,2379,2266,4645
BUSIA,BUTULA,11,2068,2182,4250
BUSIA,BUTULA,12,2420,2431,4851
BUSIA,BUTULA,13,2338,2468,4806
BUSIA,BUTULA,14,2214,2204,4418
BUSIA,BUTULA,Oct-14,11419,11551,22970
BUSIA,BUTULA,15,2222,2210,4432
BUSIA,BUTULA,16,2070,2027,4097
BUSIA,BUTULA,17,2108,2031,4139
BUSIA,BUTULA,18,1567,1515,3082
BUSIA,BUTULA,19,1574,1614,3188
BUSIA,BUTULA,15-19,9541,9397,18938
BUSIA,BUTULA,20,1280,1401,2681
BUSIA,BUTULA,21,974,1146,2120
BUSIA,BUTULA,22,890,1150,2040
BUSIA,BUTULA,23,832,1127,1959
BUSIA,BUTULA,24,696,957,1653
BUSIA,BUTULA,20-24,4672,5781,10453
BUSIA,BUTULA,25,785,1040,1825
BUSIA,BUTULA,26,628,932,1560
BUSIA,BUTULA,27,718,1041,1759
BUSIA,BUTULA,28,543,861,1404
BUSIA,BUTULA,29,568,785,1353
BUSIA,BUTULA,25-29,3242,4659,7901
BUSIA,BUTULA,30,739,1174,1913
BUSIA,BUTULA,31,510,771,1281
BUSIA,BUTULA,32,680,1043,1723
BUSIA,BUTULA,33,549,816,1365
BUSIA,BUTULA,34,487,715,1202
BUSIA,BUTULA,30-34,2965,4519,7484
BUSIA,BUTULA,35,649,849,1498
BUSIA,BUTULA,36,463,582,1045
BUSIA,BUTULA,37,535,659,1194
BUSIA,BUTULA,38,392,516,908
BUSIA,BUTULA,39,434,587,1021
BUSIA,BUTULA,35-39,2473,3193,5666
BUSIA,BUTULA,40,554,754,1308
BUSIA,BUTULA,41,507,692,1199
BUSIA,BUTULA,42,517,666,1183
BUSIA,BUTULA,43,433,575,1008
BUSIA,BUTULA,44,347,433,780
BUSIA,BUTULA,40-44,2358,3120,5478
BUSIA,BUTULA,45,496,707,1203
BUSIA,BUTULA,46,319,456,775
BUSIA,BUTULA,47,398,515,913
BUSIA,BUTULA,48,282,397,679
BUSIA,BUTULA,49,326,408,734
BUSIA,BUTULA,45-49,1821,2483,4304
BUSIA,BUTULA,50,460,786,1246
BUSIA,BUTULA,51,365,561,926
BUSIA,BUTULA,52,304,442,746
BUSIA,BUTULA,53,278,422,700
BUSIA,BUTULA,54,286,406,692
BUSIA,BUTULA,50-54,1693,2617,4310
BUSIA,BUTULA,55,340,463,803
BUSIA,BUTULA,56,288,428,716
BUSIA,BUTULA,57,335,564,899
BUSIA,BUTULA,58,289,360,649
BUSIA,BUTULA,59,341,492,833
BUSIA,BUTULA,55-59,1593,2307,3900
BUSIA,BUTULA,60,402,541,943
BUSIA,BUTULA,61,329,368,697
BUSIA,BUTULA,62,242,311,553
BUSIA,BUTULA,63,246,301,547
BUSIA,BUTULA,64,199,289,488
BUSIA,BUTULA,60-64,1418,1810,3228
BUSIA,BUTULA,65,277,391,668
BUSIA,BUTULA,66,194,246,440
BUSIA,BUTULA,67,263,389,652
BUSIA,BUTULA,68,123,160,283
BUSIA,BUTULA,69,166,261,427
BUSIA,BUTULA,65-69,1023,1447,2470
BUSIA,BUTULA,70,265,470,735
BUSIA,BUTULA,71,172,220,392
BUSIA,BUTULA,72,161,182,343
BUSIA,BUTULA,73,129,151,280
BUSIA,BUTULA,74,121,185,306
BUSIA,BUTULA,70-74,848,1208,2056
BUSIA,BUTULA,75,112,183,295
BUSIA,BUTULA,76,82,140,222
BUSIA,BUTULA,77,126,172,298
BUSIA,BUTULA,78,68,84,152
BUSIA,BUTULA,79,75,174,249
BUSIA,BUTULA,75-79,463,753,1216
BUSIA,BUTULA,80,106,196,302
BUSIA,BUTULA,81,82,85,167
BUSIA,BUTULA,82,50,70,120
BUSIA,BUTULA,83,69,92,161
BUSIA,BUTULA,84,57,74,131
BUSIA,BUTULA,80-84,364,517,881
BUSIA,BUTULA,85,49,90,139
BUSIA,BUTULA,86,63,48,111
BUSIA,BUTULA,87,48,83,131
BUSIA,BUTULA,88,23,35,58
BUSIA,BUTULA,89,36,69,105
BUSIA,BUTULA,85-89,219,325,544
BUSIA,BUTULA,90,25,43,68
BUSIA,BUTULA,91,23,31,54
BUSIA,BUTULA,92,13,10,23
BUSIA,BUTULA,93,11,7,18
BUSIA,BUTULA,94,11,16,27
BUSIA,BUTULA,90-94,83,107,190
BUSIA,BUTULA,95,7,16,23
BUSIA,BUTULA,96,6,6,12
BUSIA,BUTULA,97,6,7,13
BUSIA,BUTULA,98,1,4,5
BUSIA,BUTULA,99,2,9,11
BUSIA,BUTULA,95-99,22,42,64
BUSIA,BUTULA,100+,8,21,29
BUSIA,BUTULA,Not Stated,-,-,-
BUSIA,NAMBALE,Total,52900,58732,111632
BUSIA,NAMBALE,0,1312,1285,2597
BUSIA,NAMBALE,1,1419,1444,2863
BUSIA,NAMBALE,2,1463,1450,2913
BUSIA,NAMBALE,3,1416,1514,2930
BUSIA,NAMBALE,4,1414,1518,2932
BUSIA,NAMBALE,0 - 4,7024,7211,14235
BUSIA,NAMBALE,5,1501,1545,3046
BUSIA,NAMBALE,6,1598,1739,3337
BUSIA,NAMBALE,7,1645,1659,3304
BUSIA,NAMBALE,8,1613,1641,3254
BUSIA,NAMBALE,9,1752,1872,3624
BUSIA,NAMBALE,05-Sep,8109,8456,16565
BUSIA,NAMBALE,10,1889,1917,3806
BUSIA,NAMBALE,11,1723,1829,3552
BUSIA,NAMBALE,12,1879,1894,3773
BUSIA,NAMBALE,13,1823,1798,3621
BUSIA,NAMBALE,14,1697,1713,3410
BUSIA,NAMBALE,Oct-14,9011,9151,18162
BUSIA,NAMBALE,15,1715,1753,3468
BUSIA,NAMBALE,16,1623,1672,3295
BUSIA,NAMBALE,17,1593,1674,3267
BUSIA,NAMBALE,18,1360,1252,2612
BUSIA,NAMBALE,19,1296,1299,2595
BUSIA,NAMBALE,15-19,7587,7650,15237
BUSIA,NAMBALE,20,1180,1239,2419
BUSIA,NAMBALE,21,858,947,1805
BUSIA,NAMBALE,22,769,990,1759
BUSIA,NAMBALE,23,749,919,1668
BUSIA,NAMBALE,24,711,815,1526
BUSIA,NAMBALE,20-24,4267,4910,9177
BUSIA,NAMBALE,25,694,924,1618
BUSIA,NAMBALE,26,611,821,1432
BUSIA,NAMBALE,27,558,792,1350
BUSIA,NAMBALE,28,477,664,1141
BUSIA,NAMBALE,29,478,640,1118
BUSIA,NAMBALE,25-29,2818,3841,6659
BUSIA,NAMBALE,30,604,920,1524
BUSIA,NAMBALE,31,450,665,1115
BUSIA,NAMBALE,32,609,808,1417
BUSIA,NAMBALE,33,472,668,1140
BUSIA,NAMBALE,34,467,609,1076
BUSIA,NAMBALE,30-34,2602,3670,6272
BUSIA,NAMBALE,35,553,694,1247
BUSIA,NAMBALE,36,463,511,974
BUSIA,NAMBALE,37,458,495,953
BUSIA,NAMBALE,38,352,429,781
BUSIA,NAMBALE,39,363,433,796
BUSIA,NAMBALE,35-39,2189,2562,4751
BUSIA,NAMBALE,40,463,568,1031
BUSIA,NAMBALE,41,387,531,918
BUSIA,NAMBALE,42,435,570,1005
BUSIA,NAMBALE,43,396,470,866
BUSIA,NAMBALE,44,318,384,702
BUSIA,NAMBALE,40-44,1999,2523,4522
BUSIA,NAMBALE,45,449,513,962
BUSIA,NAMBALE,46,321,349,670
BUSIA,NAMBALE,47,348,435,783
BUSIA,NAMBALE,48,242,282,524
BUSIA,NAMBALE,49,271,309,580
BUSIA,NAMBALE,45-49,1631,1888,3519
BUSIA,NAMBALE,50,304,446,750
BUSIA,NAMBALE,51,307,376,683
BUSIA,NAMBALE,52,261,310,571
BUSIA,NAMBALE,53,220,277,497
BUSIA,NAMBALE,54,226,246,472
BUSIA,NAMBALE,50-54,1318,1655,2973
BUSIA,NAMBALE,55,259,294,553
BUSIA,NAMBALE,56,285,291,576
BUSIA,NAMBALE,57,270,352,622
BUSIA,NAMBALE,58,196,265,461
BUSIA,NAMBALE,59,260,309,569
BUSIA,NAMBALE,55-59,1270,1511,2781
BUSIA,NAMBALE,60,314,320,634
BUSIA,NAMBALE,61,216,250,466
BUSIA,NAMBALE,62,169,196,365
BUSIA,NAMBALE,63,178,225,403
BUSIA,NAMBALE,64,134,209,343
BUSIA,NAMBALE,60-64,1011,1200,2211
BUSIA,NAMBALE,65,201,257,458
BUSIA,NAMBALE,66,139,146,285
BUSIA,NAMBALE,67,190,229,419
BUSIA,NAMBALE,68,81,84,165
BUSIA,NAMBALE,69,138,165,303
BUSIA,NAMBALE,65-69,749,881,1630
BUSIA,NAMBALE,70,142,228,370
BUSIA,NAMBALE,71,129,145,274
BUSIA,NAMBALE,72,92,116,208
BUSIA,NAMBALE,73,85,91,176
BUSIA,NAMBALE,74,90,114,204
BUSIA,NAMBALE,70-74,538,694,1232
BUSIA,NAMBALE,75,81,96,177
BUSIA,NAMBALE,76,74,67,141
BUSIA,NAMBALE,77,90,100,190
BUSIA,NAMBALE,78,33,37,70
BUSIA,NAMBALE,79,59,59,118
BUSIA,NAMBALE,75-79,337,359,696
BUSIA,NAMBALE,80,69,103,172
BUSIA,NAMBALE,81,54,54,108
BUSIA,NAMBALE,82,30,39,69
BUSIA,NAMBALE,83,49,50,99
BUSIA,NAMBALE,84,31,40,71
BUSIA,NAMBALE,80-84,233,286,519
BUSIA,NAMBALE,85,24,41,65
BUSIA,NAMBALE,86,25,31,56
BUSIA,NAMBALE,87,34,51,85
BUSIA,NAMBALE,88,19,16,35
BUSIA,NAMBALE,89,24,52,76
BUSIA,NAMBALE,85-89,126,191,317
BUSIA,NAMBALE,90,15,23,38
BUSIA,NAMBALE,91,12,15,27
BUSIA,NAMBALE,92,8,5,13
BUSIA,NAMBALE,93,11,10,21
BUSIA,NAMBALE,94,7,6,13
BUSIA,NAMBALE,90-94,53,59,112
BUSIA,NAMBALE,95,9,7,16
BUSIA,NAMBALE,96,5,2,7
BUSIA,NAMBALE,97,5,4,9
BUSIA,NAMBALE,98,1,5,6
BUSIA,NAMBALE,99,3,5,8
BUSIA,NAMBALE,95-99,23,23,46
BUSIA,NAMBALE,100+,4,10,14
BUSIA,NAMBALE,Not Stated,1,1,2
BUSIA,SAMIA,Total,50821,56341,107162
BUSIA,SAMIA,0,1207,1240,2447
BUSIA,SAMIA,1,1385,1414,2799
BUSIA,SAMIA,2,1331,1327,2658
BUSIA,SAMIA,3,1384,1466,2850
BUSIA,SAMIA,4,1414,1433,2847
BUSIA,SAMIA,0 - 4,6721,6880,13601
BUSIA,SAMIA,5,1459,1432,2891
BUSIA,SAMIA,6,1423,1523,2946
BUSIA,SAMIA,7,1537,1442,2979
BUSIA,SAMIA,8,1411,1450,2861
BUSIA,SAMIA,9,1578,1638,3216
BUSIA,SAMIA,05-Sep,7408,7485,14893
BUSIA,SAMIA,10,1580,1730,3310
BUSIA,SAMIA,11,1466,1589,3055
BUSIA,SAMIA,12,1687,1749,3436
BUSIA,SAMIA,13,1702,1771,3473
BUSIA,SAMIA,14,1678,1589,3267
BUSIA,SAMIA,Oct-14,8113,8428,16541
BUSIA,SAMIA,15,1674,1608,3282
BUSIA,SAMIA,16,1484,1458,2942
BUSIA,SAMIA,17,1585,1451,3036
BUSIA,SAMIA,18,1299,1181,2480
BUSIA,SAMIA,19,1308,1285,2593
BUSIA,SAMIA,15-19,7350,6983,14333
BUSIA,SAMIA,20,1112,1086,2198
BUSIA,SAMIA,21,872,909,1781
BUSIA,SAMIA,22,772,890,1662
BUSIA,SAMIA,23,755,858,1613
BUSIA,SAMIA,24,655,834,1489
BUSIA,SAMIA,20-24,4166,4577,8743
BUSIA,SAMIA,25,739,865,1604
BUSIA,SAMIA,26,533,745,1278
BUSIA,SAMIA,27,601,666,1267
BUSIA,SAMIA,28,452,617,1069
BUSIA,SAMIA,29,489,663,1152
BUSIA,SAMIA,25-29,2814,3556,6370
BUSIA,SAMIA,30,588,833,1421
BUSIA,SAMIA,31,466,666,1132
BUSIA,SAMIA,32,627,786,1413
BUSIA,SAMIA,33,530,661,1191
BUSIA,SAMIA,34,477,567,1044
BUSIA,SAMIA,30-34,2688,3513,6201
BUSIA,SAMIA,35,546,598,1144
BUSIA,SAMIA,36,478,495,973
BUSIA,SAMIA,37,506,476,982
BUSIA,SAMIA,38,331,385,716
BUSIA,SAMIA,39,379,353,732
BUSIA,SAMIA,35-39,2240,2307,4547
BUSIA,SAMIA,40,456,514,970
BUSIA,SAMIA,41,382,475,857
BUSIA,SAMIA,42,389,473,862
BUSIA,SAMIA,43,401,374,775
BUSIA,SAMIA,44,256,282,538
BUSIA,SAMIA,40-44,1884,2118,4002
BUSIA,SAMIA,45,429,458,887
BUSIA,SAMIA,46,331,331,662
BUSIA,SAMIA,47,305,361,666
BUSIA,SAMIA,48,202,246,448
BUSIA,SAMIA,49,187,285,472
BUSIA,SAMIA,45-49,1454,1681,3135
BUSIA,SAMIA,50,331,560,891
BUSIA,SAMIA,51,306,425,731
BUSIA,SAMIA,52,217,330,547
BUSIA,SAMIA,53,226,278,504
BUSIA,SAMIA,54,246,307,553
BUSIA,SAMIA,50-54,1326,1900,3226
BUSIA,SAMIA,55,251,306,557
BUSIA,SAMIA,56,245,286,531
BUSIA,SAMIA,57,309,517,826
BUSIA,SAMIA,58,235,317,552
BUSIA,SAMIA,59,275,360,635
BUSIA,SAMIA,55-59,1315,1786,3101
BUSIA,SAMIA,60,296,467,763
BUSIA,SAMIA,61,228,299,527
BUSIA,SAMIA,62,200,287,487
BUSIA,SAMIA,63,185,264,449
BUSIA,SAMIA,64,170,229,399
BUSIA,SAMIA,60-64,1079,1546,2625
BUSIA,SAMIA,65,215,302,517
BUSIA,SAMIA,66,123,211,334
BUSIA,SAMIA,67,208,309,517
BUSIA,SAMIA,68,85,117,202
BUSIA,SAMIA,69,154,196,350
BUSIA,SAMIA,65-69,785,1135,1920
BUSIA,SAMIA,70,209,334,543
BUSIA,SAMIA,71,157,175,332
BUSIA,SAMIA,72,119,118,237
BUSIA,SAMIA,73,93,114,207
BUSIA,SAMIA,74,103,198,301
BUSIA,SAMIA,70-74,681,939,1620
BUSIA,SAMIA,75,85,140,225
BUSIA,SAMIA,76,73,99,172
BUSIA,SAMIA,77,82,134,216
BUSIA,SAMIA,78,57,62,119
BUSIA,SAMIA,79,67,132,199
BUSIA,SAMIA,75-79,364,567,931
BUSIA,SAMIA,80,67,136,203
BUSIA,SAMIA,81,53,98,151
BUSIA,SAMIA,82,33,45,78
BUSIA,SAMIA,83,45,61,106
BUSIA,SAMIA,84,38,76,114
BUSIA,SAMIA,80-84,236,416,652
BUSIA,SAMIA,85,30,59,89
BUSIA,SAMIA,86,27,58,85
BUSIA,SAMIA,87,30,86,116
BUSIA,SAMIA,88,20,25,45
BUSIA,SAMIA,89,25,93,118
BUSIA,SAMIA,85-89,132,321,453
BUSIA,SAMIA,90,15,43,58
BUSIA,SAMIA,91,13,17,30
BUSIA,SAMIA,92,9,17,26
BUSIA,SAMIA,93,7,10,17
BUSIA,SAMIA,94,4,29,33
BUSIA,SAMIA,90-94,48,116,164
BUSIA,SAMIA,95,8,13,21
BUSIA,SAMIA,96,1,10,11
BUSIA,SAMIA,97,2,9,11
BUSIA,SAMIA,98,-,8,8
BUSIA,SAMIA,99,2,23,25
BUSIA,SAMIA,95-99,13,63,76
BUSIA,SAMIA,100+,4,24,28
BUSIA,SAMIA,Not Stated,-,-,-
BUSIA,TESO NORTH,Total,66412,71619,138031
BUSIA,TESO NORTH,0,1683,1700,3383
BUSIA,TESO NORTH,1,1680,1926,3606
BUSIA,TESO NORTH,2,1759,1718,3477
BUSIA,TESO NORTH,3,1893,1905,3798
BUSIA,TESO NORTH,4,1787,1773,3560
BUSIA,TESO NORTH,0 - 4,8802,9022,17824
BUSIA,TESO NORTH,5,1904,1931,3835
BUSIA,TESO NORTH,6,2017,2091,4108
BUSIA,TESO NORTH,7,2042,1998,4040
BUSIA,TESO NORTH,8,1924,1985,3909
BUSIA,TESO NORTH,9,2084,2015,4099
BUSIA,TESO NORTH,05-Sep,9971,10020,19991
BUSIA,TESO NORTH,10,2243,2168,4411
BUSIA,TESO NORTH,11,2009,2114,4123
BUSIA,TESO NORTH,12,2111,2191,4302
BUSIA,TESO NORTH,13,2100,2275,4375
BUSIA,TESO NORTH,14,1954,2017,3971
BUSIA,TESO NORTH,Oct-14,10417,10765,21182
BUSIA,TESO NORTH,15,1975,1958,3933
BUSIA,TESO NORTH,16,1785,1921,3706
BUSIA,TESO NORTH,17,1946,1945,3891
BUSIA,TESO NORTH,18,1569,1515,3084
BUSIA,TESO NORTH,19,1696,1688,3384
BUSIA,TESO NORTH,15-19,8971,9027,17998
BUSIA,TESO NORTH,20,1444,1513,2957
BUSIA,TESO NORTH,21,1207,1316,2523
BUSIA,TESO NORTH,22,1098,1336,2434
BUSIA,TESO NORTH,23,1012,1343,2355
BUSIA,TESO NORTH,24,953,1171,2124
BUSIA,TESO NORTH,20-24,5714,6679,12393
BUSIA,TESO NORTH,25,974,1279,2253
BUSIA,TESO NORTH,26,860,1152,2012
BUSIA,TESO NORTH,27,793,1073,1866
BUSIA,TESO NORTH,28,693,844,1537
BUSIA,TESO NORTH,29,705,824,1529
BUSIA,TESO NORTH,25-29,4025,5172,9197
BUSIA,TESO NORTH,30,807,1109,1916
BUSIA,TESO NORTH,31,760,907,1667
BUSIA,TESO NORTH,32,881,1124,2005
BUSIA,TESO NORTH,33,798,996,1794
BUSIA,TESO NORTH,34,658,787,1445
BUSIA,TESO NORTH,30-34,3904,4923,8827
BUSIA,TESO NORTH,35,805,805,1610
BUSIA,TESO NORTH,36,677,566,1243
BUSIA,TESO NORTH,37,677,594,1271
BUSIA,TESO NORTH,38,462,441,903
BUSIA,TESO NORTH,39,534,503,1037
BUSIA,TESO NORTH,35-39,3155,2909,6064
BUSIA,TESO NORTH,40,547,612,1159
BUSIA,TESO NORTH,41,584,606,1190
BUSIA,TESO NORTH,42,599,681,1280
BUSIA,TESO NORTH,43,599,580,1179
BUSIA,TESO NORTH,44,449,454,903
BUSIA,TESO NORTH,40-44,2778,2933,5711
BUSIA,TESO NORTH,45,589,611,1200
BUSIA,TESO NORTH,46,414,426,840
BUSIA,TESO NORTH,47,476,475,951
BUSIA,TESO NORTH,48,296,311,607
BUSIA,TESO NORTH,49,330,355,685
BUSIA,TESO NORTH,45-49,2105,2178,4283
BUSIA,TESO NORTH,50,427,485,912
BUSIA,TESO NORTH,51,341,382,723
BUSIA,TESO NORTH,52,270,331,601
BUSIA,TESO NORTH,53,244,322,566
BUSIA,TESO NORTH,54,254,297,551
BUSIA,TESO NORTH,50-54,1536,1817,3353
BUSIA,TESO NORTH,55,300,311,611
BUSIA,TESO NORTH,56,302,320,622
BUSIA,TESO NORTH,57,314,517,831
BUSIA,TESO NORTH,58,250,296,546
BUSIA,TESO NORTH,59,318,378,696
BUSIA,TESO NORTH,55-59,1484,1822,3306
BUSIA,TESO NORTH,60,314,337,651
BUSIA,TESO NORTH,61,282,308,590
BUSIA,TESO NORTH,62,221,261,482
BUSIA,TESO NORTH,63,240,283,523
BUSIA,TESO NORTH,64,155,209,364
BUSIA,TESO NORTH,60-64,1212,1398,2610
BUSIA,TESO NORTH,65,209,274,483
BUSIA,TESO NORTH,66,153,183,336
BUSIA,TESO NORTH,67,200,279,479
BUSIA,TESO NORTH,68,99,100,199
BUSIA,TESO NORTH,69,174,209,383
BUSIA,TESO NORTH,65-69,835,1045,1880
BUSIA,TESO NORTH,70,188,238,426
BUSIA,TESO NORTH,71,156,206,362
BUSIA,TESO NORTH,72,108,127,235
BUSIA,TESO NORTH,73,97,116,213
BUSIA,TESO NORTH,74,80,116,196
BUSIA,TESO NORTH,70-74,629,803,1432
BUSIA,TESO NORTH,75,98,115,213
BUSIA,TESO NORTH,76,70,72,142
BUSIA,TESO NORTH,77,106,138,244
BUSIA,TESO NORTH,78,35,56,91
BUSIA,TESO NORTH,79,48,109,157
BUSIA,TESO NORTH,75-79,357,490,847
BUSIA,TESO NORTH,80,77,84,161
BUSIA,TESO NORTH,81,36,69,105
BUSIA,TESO NORTH,82,45,37,82
BUSIA,TESO NORTH,83,63,63,126
BUSIA,TESO NORTH,84,41,45,86
BUSIA,TESO NORTH,80-84,262,298,560
BUSIA,TESO NORTH,85,26,36,62
BUSIA,TESO NORTH,86,37,39,76
BUSIA,TESO NORTH,87,61,60,121
BUSIA,TESO NORTH,88,18,22,40
BUSIA,TESO NORTH,89,35,53,88
BUSIA,TESO NORTH,85-89,177,210,387
BUSIA,TESO NORTH,90,11,20,31
BUSIA,TESO NORTH,91,17,12,29
BUSIA,TESO NORTH,92,5,9,14
BUSIA,TESO NORTH,93,9,12,21
BUSIA,TESO NORTH,94,4,10,14
BUSIA,TESO NORTH,90-94,46,63,109
BUSIA,TESO NORTH,95,11,13,24
BUSIA,TESO NORTH,96,1,3,4
BUSIA,TESO NORTH,97,12,10,22
BUSIA,TESO NORTH,98,1,4,5
BUSIA,TESO NORTH,99,2,4,6
BUSIA,TESO NORTH,95-99,27,34,61
BUSIA,TESO NORTH,100+,4,11,15
BUSIA,TESO NORTH,Not Stated,1,-,1
BUSIA,TESO SOUTH,Total,80484,87630,168114
BUSIA,TESO SOUTH,0,2026,2083,4109
BUSIA,TESO SOUTH,1,2199,2091,4290
BUSIA,TESO SOUTH,2,2164,2226,4390
BUSIA,TESO SOUTH,3,2208,2261,4469
BUSIA,TESO SOUTH,4,2286,2202,4488
BUSIA,TESO SOUTH,0 - 4,10883,10863,21746
BUSIA,TESO SOUTH,5,2219,2185,4404
BUSIA,TESO SOUTH,6,2465,2481,4946
BUSIA,TESO SOUTH,7,2381,2375,4756
BUSIA,TESO SOUTH,8,2338,2488,4826
BUSIA,TESO SOUTH,9,2506,2516,5022
BUSIA,TESO SOUTH,05-Sep,11909,12045,23954
BUSIA,TESO SOUTH,10,2556,2553,5109
BUSIA,TESO SOUTH,11,2426,2644,5070
BUSIA,TESO SOUTH,12,2821,2739,5560
BUSIA,TESO SOUTH,13,2681,2808,5489
BUSIA,TESO SOUTH,14,2442,2573,5015
BUSIA,TESO SOUTH,Oct-14,12926,13317,26243
BUSIA,TESO SOUTH,15,2461,2519,4980
BUSIA,TESO SOUTH,16,2278,2393,4671
BUSIA,TESO SOUTH,17,2341,2312,4653
BUSIA,TESO SOUTH,18,1934,1955,3889
BUSIA,TESO SOUTH,19,1992,1984,3976
BUSIA,TESO SOUTH,15-19,11006,11163,22169
BUSIA,TESO SOUTH,20,1758,1950,3708
BUSIA,TESO SOUTH,21,1513,1652,3165
BUSIA,TESO SOUTH,22,1381,1598,2979
BUSIA,TESO SOUTH,23,1216,1610,2826
BUSIA,TESO SOUTH,24,1169,1487,2656
BUSIA,TESO SOUTH,20-24,7037,8297,15334
BUSIA,TESO SOUTH,25,1240,1564,2804
BUSIA,TESO SOUTH,26,1042,1387,2429
BUSIA,TESO SOUTH,27,1085,1314,2399
BUSIA,TESO SOUTH,28,827,1142,1969
BUSIA,TESO SOUTH,29,894,1121,2015
BUSIA,TESO SOUTH,25-29,5088,6528,11616
BUSIA,TESO SOUTH,30,1073,1421,2494
BUSIA,TESO SOUTH,31,835,1110,1945
BUSIA,TESO SOUTH,32,1083,1429,2512
BUSIA,TESO SOUTH,33,851,1111,1962
BUSIA,TESO SOUTH,34,784,946,1730
BUSIA,TESO SOUTH,30-34,4626,6017,10643
BUSIA,TESO SOUTH,35,940,970,1910
BUSIA,TESO SOUTH,36,752,731,1483
BUSIA,TESO SOUTH,37,717,700,1417
BUSIA,TESO SOUTH,38,523,509,1032
BUSIA,TESO SOUTH,39,673,598,1271
BUSIA,TESO SOUTH,35-39,3605,3508,7113
BUSIA,TESO SOUTH,40,729,764,1493
BUSIA,TESO SOUTH,41,643,740,1383
BUSIA,TESO SOUTH,42,728,736,1464
BUSIA,TESO SOUTH,43,664,695,1359
BUSIA,TESO SOUTH,44,549,524,1073
BUSIA,TESO SOUTH,40-44,3313,3459,6772
BUSIA,TESO SOUTH,45,639,723,1362
BUSIA,TESO SOUTH,46,448,497,945
BUSIA,TESO SOUTH,47,533,617,1150
BUSIA,TESO SOUTH,48,348,376,724
BUSIA,TESO SOUTH,49,404,489,893
BUSIA,TESO SOUTH,45-49,2372,2702,5074
BUSIA,TESO SOUTH,50,518,710,1228
BUSIA,TESO SOUTH,51,439,563,1002
BUSIA,TESO SOUTH,52,365,402,767
BUSIA,TESO SOUTH,53,303,347,650
BUSIA,TESO SOUTH,54,309,338,647
BUSIA,TESO SOUTH,50-54,1934,2360,4294
BUSIA,TESO SOUTH,55,297,332,629
BUSIA,TESO SOUTH,56,401,430,831
BUSIA,TESO SOUTH,57,387,534,921
BUSIA,TESO SOUTH,58,292,358,650
BUSIA,TESO SOUTH,59,356,428,784
BUSIA,TESO SOUTH,55-59,1733,2082,3815
BUSIA,TESO SOUTH,60,335,475,810
BUSIA,TESO SOUTH,61,299,368,667
BUSIA,TESO SOUTH,62,212,321,533
BUSIA,TESO SOUTH,63,254,331,585
BUSIA,TESO SOUTH,64,185,288,473
BUSIA,TESO SOUTH,60-64,1285,1783,3068
BUSIA,TESO SOUTH,65,212,353,565
BUSIA,TESO SOUTH,66,167,203,370
BUSIA,TESO SOUTH,67,256,303,559
BUSIA,TESO SOUTH,68,132,159,291
BUSIA,TESO SOUTH,69,186,251,437
BUSIA,TESO SOUTH,65-69,953,1269,2222
BUSIA,TESO SOUTH,70,232,318,550
BUSIA,TESO SOUTH,71,195,194,389
BUSIA,TESO SOUTH,72,140,107,247
BUSIA,TESO SOUTH,73,104,121,225
BUSIA,TESO SOUTH,74,104,161,265
BUSIA,TESO SOUTH,70-74,775,901,1676
BUSIA,TESO SOUTH,75,102,107,209
BUSIA,TESO SOUTH,76,86,86,172
BUSIA,TESO SOUTH,77,114,141,255
BUSIA,TESO SOUTH,78,56,73,129
BUSIA,TESO SOUTH,79,100,174,274
BUSIA,TESO SOUTH,75-79,458,581,1039
BUSIA,TESO SOUTH,80,77,130,207
BUSIA,TESO SOUTH,81,60,61,121
BUSIA,TESO SOUTH,82,58,50,108
BUSIA,TESO SOUTH,83,61,53,114
BUSIA,TESO SOUTH,84,49,91,140
BUSIA,TESO SOUTH,80-84,305,385,690
BUSIA,TESO SOUTH,85,34,70,104
BUSIA,TESO SOUTH,86,50,34,84
BUSIA,TESO SOUTH,87,42,53,95
BUSIA,TESO SOUTH,88,31,17,48
BUSIA,TESO SOUTH,89,42,70,112
BUSIA,TESO SOUTH,85-89,199,244,443
BUSIA,TESO SOUTH,90,13,26,39
BUSIA,TESO SOUTH,91,14,11,25
BUSIA,TESO SOUTH,92,6,4,10
BUSIA,TESO SOUTH,93,10,10,20
BUSIA,TESO SOUTH,94,9,16,25
BUSIA,TESO SOUTH,90-94,52,67,119
BUSIA,TESO SOUTH,95,4,11,15
BUSIA,TESO SOUTH,96,4,9,13
BUSIA,TESO SOUTH,97,8,10,18
BUSIA,TESO SOUTH,98,3,4,7
BUSIA,TESO SOUTH,99,4,5,9
BUSIA,TESO SOUTH,95-99,23,39,62
BUSIA,TESO SOUTH,100+,2,20,22
BUSIA,TESO SOUTH,Not Stated,-,-,-
ELGEYO-MARAKWET,ALL,Total,227317,227151,454468
ELGEYO-MARAKWET,ALL,0,5668,5731,11399
ELGEYO-MARAKWET,ALL,1,5888,5634,11522
ELGEYO-MARAKWET,ALL,2,5915,5830,11745
ELGEYO-MARAKWET,ALL,3,6344,6442,12786
ELGEYO-MARAKWET,ALL,4,6771,6709,13480
ELGEYO-MARAKWET,ALL,0 - 4,30586,30346,60932
ELGEYO-MARAKWET,ALL,5,6654,6480,13134
ELGEYO-MARAKWET,ALL,6,6705,6616,13321
ELGEYO-MARAKWET,ALL,7,6605,6458,13063
ELGEYO-MARAKWET,ALL,8,5932,5842,11774
ELGEYO-MARAKWET,ALL,9,6876,6533,13409
ELGEYO-MARAKWET,ALL,05-Sep,32772,31929,64701
ELGEYO-MARAKWET,ALL,10,6846,6615,13461
ELGEYO-MARAKWET,ALL,11,6052,6247,12299
ELGEYO-MARAKWET,ALL,12,6935,6739,13674
ELGEYO-MARAKWET,ALL,13,6584,6720,13304
ELGEYO-MARAKWET,ALL,14,6489,6314,12803
ELGEYO-MARAKWET,ALL,Oct-14,32906,32635,65541
ELGEYO-MARAKWET,ALL,15,6431,6242,12673
ELGEYO-MARAKWET,ALL,16,5775,5768,11543
ELGEYO-MARAKWET,ALL,17,5904,5541,11445
ELGEYO-MARAKWET,ALL,18,4479,4289,8768
ELGEYO-MARAKWET,ALL,19,5551,5272,10823
ELGEYO-MARAKWET,ALL,15-19,28140,27112,55252
ELGEYO-MARAKWET,ALL,20,4989,4813,9802
ELGEYO-MARAKWET,ALL,21,4515,4408,8923
ELGEYO-MARAKWET,ALL,22,4133,4106,8239
ELGEYO-MARAKWET,ALL,23,4113,4275,8388
ELGEYO-MARAKWET,ALL,24,3657,3857,7514
ELGEYO-MARAKWET,ALL,20-24,21407,21459,42866
ELGEYO-MARAKWET,ALL,25,4241,4278,8519
ELGEYO-MARAKWET,ALL,26,3217,3405,6622
ELGEYO-MARAKWET,ALL,27,3361,3411,6772
ELGEYO-MARAKWET,ALL,28,2491,2575,5066
ELGEYO-MARAKWET,ALL,29,2973,3030,6003
ELGEYO-MARAKWET,ALL,25-29,16283,16699,32982
ELGEYO-MARAKWET,ALL,30,3408,3650,7058
ELGEYO-MARAKWET,ALL,31,2522,2629,5151
ELGEYO-MARAKWET,ALL,32,3098,3359,6457
ELGEYO-MARAKWET,ALL,33,2645,2893,5538
ELGEYO-MARAKWET,ALL,34,2245,2499,4744
ELGEYO-MARAKWET,ALL,30-34,13918,15030,28948
ELGEYO-MARAKWET,ALL,35,3517,3316,6833
ELGEYO-MARAKWET,ALL,36,1982,1736,3718
ELGEYO-MARAKWET,ALL,37,2168,1835,4003
ELGEYO-MARAKWET,ALL,38,1311,1213,2524
ELGEYO-MARAKWET,ALL,39,1813,1751,3564
ELGEYO-MARAKWET,ALL,35-39,10791,9851,20642
ELGEYO-MARAKWET,ALL,40,2197,1874,4071
ELGEYO-MARAKWET,ALL,41,2154,2028,4182
ELGEYO-MARAKWET,ALL,42,2052,1931,3983
ELGEYO-MARAKWET,ALL,43,1750,1759,3509
ELGEYO-MARAKWET,ALL,44,1183,1273,2456
ELGEYO-MARAKWET,ALL,40-44,9336,8865,18201
ELGEYO-MARAKWET,ALL,45,3044,2753,5797
ELGEYO-MARAKWET,ALL,46,1564,1570,3134
ELGEYO-MARAKWET,ALL,47,1660,1633,3293
ELGEYO-MARAKWET,ALL,48,840,891,1731
ELGEYO-MARAKWET,ALL,49,1196,1223,2419
ELGEYO-MARAKWET,ALL,45-49,8304,8070,16374
ELGEYO-MARAKWET,ALL,50,1453,1541,2994
ELGEYO-MARAKWET,ALL,51,1057,1130,2187
ELGEYO-MARAKWET,ALL,52,870,913,1783
ELGEYO-MARAKWET,ALL,53,637,686,1323
ELGEYO-MARAKWET,ALL,54,1067,1009,2076
ELGEYO-MARAKWET,ALL,50-54,5084,5279,10363
ELGEYO-MARAKWET,ALL,55,1004,876,1880
ELGEYO-MARAKWET,ALL,56,938,1048,1986
ELGEYO-MARAKWET,ALL,57,938,1165,2103
ELGEYO-MARAKWET,ALL,58,1099,1215,2314
ELGEYO-MARAKWET,ALL,59,1096,987,2083
ELGEYO-MARAKWET,ALL,55-59,5075,5291,10366
ELGEYO-MARAKWET,ALL,60,1233,1234,2467
ELGEYO-MARAKWET,ALL,61,981,950,1931
ELGEYO-MARAKWET,ALL,62,632,605,1237
ELGEYO-MARAKWET,ALL,63,688,801,1489
ELGEYO-MARAKWET,ALL,64,463,495,958
ELGEYO-MARAKWET,ALL,60-64,3997,4085,8082
ELGEYO-MARAKWET,ALL,65,948,952,1900
ELGEYO-MARAKWET,ALL,66,418,413,831
ELGEYO-MARAKWET,ALL,67,849,805,1654
ELGEYO-MARAKWET,ALL,68,381,358,739
ELGEYO-MARAKWET,ALL,69,733,774,1507
ELGEYO-MARAKWET,ALL,65-69,3329,3302,6631
ELGEYO-MARAKWET,ALL,70,760,933,1693
ELGEYO-MARAKWET,ALL,71,581,679,1260
ELGEYO-MARAKWET,ALL,72,383,387,770
ELGEYO-MARAKWET,ALL,73,343,392,735
ELGEYO-MARAKWET,ALL,74,348,456,804
ELGEYO-MARAKWET,ALL,70-74,2415,2847,5262
ELGEYO-MARAKWET,ALL,75,370,453,823
ELGEYO-MARAKWET,ALL,76,290,314,604
ELGEYO-MARAKWET,ALL,77,252,310,562
ELGEYO-MARAKWET,ALL,78,144,151,295
ELGEYO-MARAKWET,ALL,79,266,501,767
ELGEYO-MARAKWET,ALL,75-79,1322,1729,3051
ELGEYO-MARAKWET,ALL,80,278,457,735
ELGEYO-MARAKWET,ALL,81,154,282,436
ELGEYO-MARAKWET,ALL,82,83,139,222
ELGEYO-MARAKWET,ALL,83,146,209,355
ELGEYO-MARAKWET,ALL,84,136,203,339
ELGEYO-MARAKWET,ALL,80-84,797,1290,2087
ELGEYO-MARAKWET,ALL,85,97,154,251
ELGEYO-MARAKWET,ALL,86,75,71,146
ELGEYO-MARAKWET,ALL,87,91,113,204
ELGEYO-MARAKWET,ALL,88,53,70,123
ELGEYO-MARAKWET,ALL,89,165,274,439
ELGEYO-MARAKWET,ALL,85-89,481,682,1163
ELGEYO-MARAKWET,ALL,90,74,143,217
ELGEYO-MARAKWET,ALL,91,43,69,112
ELGEYO-MARAKWET,ALL,92,16,40,56
ELGEYO-MARAKWET,ALL,93,34,38,72
ELGEYO-MARAKWET,ALL,94,31,47,78
ELGEYO-MARAKWET,ALL,90-94,198,337,535
ELGEYO-MARAKWET,ALL,95,64,81,145
ELGEYO-MARAKWET,ALL,96,12,20,32
ELGEYO-MARAKWET,ALL,97,13,20,33
ELGEYO-MARAKWET,ALL,98,13,18,31
ELGEYO-MARAKWET,ALL,99,31,63,94
ELGEYO-MARAKWET,ALL,95-99,133,202,335
ELGEYO-MARAKWET,ALL,100+,43,110,153
ELGEYO-MARAKWET,ALL,Not Stated,-,1,1
ELGEYO-MARAKWET,KEIYO NORTH,Total,49601,49574,99175
ELGEYO-MARAKWET,KEIYO NORTH,0,1241,1270,2511
ELGEYO-MARAKWET,KEIYO NORTH,1,1246,1106,2352
ELGEYO-MARAKWET,KEIYO NORTH,2,1215,1181,2396
ELGEYO-MARAKWET,KEIYO NORTH,3,1275,1382,2657
ELGEYO-MARAKWET,KEIYO NORTH,4,1351,1344,2695
ELGEYO-MARAKWET,KEIYO NORTH,0 - 4,6328,6283,12611
ELGEYO-MARAKWET,KEIYO NORTH,5,1378,1252,2630
ELGEYO-MARAKWET,KEIYO NORTH,6,1368,1306,2674
ELGEYO-MARAKWET,KEIYO NORTH,7,1346,1293,2639
ELGEYO-MARAKWET,KEIYO NORTH,8,1187,1212,2399
ELGEYO-MARAKWET,KEIYO NORTH,9,1405,1292,2697
ELGEYO-MARAKWET,KEIYO NORTH,05-Sep,6684,6355,13039
ELGEYO-MARAKWET,KEIYO NORTH,10,1288,1307,2595
ELGEYO-MARAKWET,KEIYO NORTH,11,1247,1223,2470
ELGEYO-MARAKWET,KEIYO NORTH,12,1359,1290,2649
ELGEYO-MARAKWET,KEIYO NORTH,13,1282,1317,2599
ELGEYO-MARAKWET,KEIYO NORTH,14,1282,1252,2534
ELGEYO-MARAKWET,KEIYO NORTH,Oct-14,6458,6389,12847
ELGEYO-MARAKWET,KEIYO NORTH,15,1253,1245,2498
ELGEYO-MARAKWET,KEIYO NORTH,16,1100,1197,2297
ELGEYO-MARAKWET,KEIYO NORTH,17,1333,1261,2594
ELGEYO-MARAKWET,KEIYO NORTH,18,986,934,1920
ELGEYO-MARAKWET,KEIYO NORTH,19,1191,1172,2363
ELGEYO-MARAKWET,KEIYO NORTH,15-19,5863,5809,11672
ELGEYO-MARAKWET,KEIYO NORTH,20,1134,1172,2306
ELGEYO-MARAKWET,KEIYO NORTH,21,1069,1049,2118
ELGEYO-MARAKWET,KEIYO NORTH,22,980,1023,2003
ELGEYO-MARAKWET,KEIYO NORTH,23,1053,1180,2233
ELGEYO-MARAKWET,KEIYO NORTH,24,895,1034,1929
ELGEYO-MARAKWET,KEIYO NORTH,20-24,5131,5458,10589
ELGEYO-MARAKWET,KEIYO NORTH,25,1047,1058,2105
ELGEYO-MARAKWET,KEIYO NORTH,26,825,861,1686
ELGEYO-MARAKWET,KEIYO NORTH,27,816,833,1649
ELGEYO-MARAKWET,KEIYO NORTH,28,664,621,1285
ELGEYO-MARAKWET,KEIYO NORTH,29,789,795,1584
ELGEYO-MARAKWET,KEIYO NORTH,25-29,4141,4168,8309
ELGEYO-MARAKWET,KEIYO NORTH,30,857,839,1696
ELGEYO-MARAKWET,KEIYO NORTH,31,641,606,1247
ELGEYO-MARAKWET,KEIYO NORTH,32,804,783,1587
ELGEYO-MARAKWET,KEIYO NORTH,33,645,662,1307
ELGEYO-MARAKWET,KEIYO NORTH,34,572,638,1210
ELGEYO-MARAKWET,KEIYO NORTH,30-34,3519,3528,7047
ELGEYO-MARAKWET,KEIYO NORTH,35,849,825,1674
ELGEYO-MARAKWET,KEIYO NORTH,36,500,431,931
ELGEYO-MARAKWET,KEIYO NORTH,37,530,481,1011
ELGEYO-MARAKWET,KEIYO NORTH,38,344,324,668
ELGEYO-MARAKWET,KEIYO NORTH,39,470,480,950
ELGEYO-MARAKWET,KEIYO NORTH,35-39,2693,2541,5234
ELGEYO-MARAKWET,KEIYO NORTH,40,530,441,971
ELGEYO-MARAKWET,KEIYO NORTH,41,522,493,1015
ELGEYO-MARAKWET,KEIYO NORTH,42,473,415,888
ELGEYO-MARAKWET,KEIYO NORTH,43,401,401,802
ELGEYO-MARAKWET,KEIYO NORTH,44,299,296,595
ELGEYO-MARAKWET,KEIYO NORTH,40-44,2225,2046,4271
ELGEYO-MARAKWET,KEIYO NORTH,45,627,534,1161
ELGEYO-MARAKWET,KEIYO NORTH,46,361,361,722
ELGEYO-MARAKWET,KEIYO NORTH,47,401,347,748
ELGEYO-MARAKWET,KEIYO NORTH,48,189,258,447
ELGEYO-MARAKWET,KEIYO NORTH,49,307,313,620
ELGEYO-MARAKWET,KEIYO NORTH,45-49,1885,1813,3698
ELGEYO-MARAKWET,KEIYO NORTH,50,329,329,658
ELGEYO-MARAKWET,KEIYO NORTH,51,233,248,481
ELGEYO-MARAKWET,KEIYO NORTH,52,177,204,381
ELGEYO-MARAKWET,KEIYO NORTH,53,156,142,298
ELGEYO-MARAKWET,KEIYO NORTH,54,222,233,455
ELGEYO-MARAKWET,KEIYO NORTH,50-54,1117,1156,2273
ELGEYO-MARAKWET,KEIYO NORTH,55,202,194,396
ELGEYO-MARAKWET,KEIYO NORTH,56,218,237,455
ELGEYO-MARAKWET,KEIYO NORTH,57,176,241,417
ELGEYO-MARAKWET,KEIYO NORTH,58,229,267,496
ELGEYO-MARAKWET,KEIYO NORTH,59,228,220,448
ELGEYO-MARAKWET,KEIYO NORTH,55-59,1053,1159,2212
ELGEYO-MARAKWET,KEIYO NORTH,60,239,258,497
ELGEYO-MARAKWET,KEIYO NORTH,61,229,219,448
ELGEYO-MARAKWET,KEIYO NORTH,62,155,150,305
ELGEYO-MARAKWET,KEIYO NORTH,63,139,178,317
ELGEYO-MARAKWET,KEIYO NORTH,64,113,100,213
ELGEYO-MARAKWET,KEIYO NORTH,60-64,875,905,1780
ELGEYO-MARAKWET,KEIYO NORTH,65,192,194,386
ELGEYO-MARAKWET,KEIYO NORTH,66,86,91,177
ELGEYO-MARAKWET,KEIYO NORTH,67,161,191,352
ELGEYO-MARAKWET,KEIYO NORTH,68,75,59,134
ELGEYO-MARAKWET,KEIYO NORTH,69,132,130,262
ELGEYO-MARAKWET,KEIYO NORTH,65-69,646,665,1311
ELGEYO-MARAKWET,KEIYO NORTH,70,135,127,262
ELGEYO-MARAKWET,KEIYO NORTH,71,104,131,235
ELGEYO-MARAKWET,KEIYO NORTH,72,76,62,138
ELGEYO-MARAKWET,KEIYO NORTH,73,74,73,147
ELGEYO-MARAKWET,KEIYO NORTH,74,74,79,153
ELGEYO-MARAKWET,KEIYO NORTH,70-74,463,472,935
ELGEYO-MARAKWET,KEIYO NORTH,75,58,79,137
ELGEYO-MARAKWET,KEIYO NORTH,76,55,69,124
ELGEYO-MARAKWET,KEIYO NORTH,77,48,59,107
ELGEYO-MARAKWET,KEIYO NORTH,78,24,34,58
ELGEYO-MARAKWET,KEIYO NORTH,79,39,94,133
ELGEYO-MARAKWET,KEIYO NORTH,75-79,224,335,559
ELGEYO-MARAKWET,KEIYO NORTH,80,45,80,125
ELGEYO-MARAKWET,KEIYO NORTH,81,36,59,95
ELGEYO-MARAKWET,KEIYO NORTH,82,14,36,50
ELGEYO-MARAKWET,KEIYO NORTH,83,31,53,84
ELGEYO-MARAKWET,KEIYO NORTH,84,26,42,68
ELGEYO-MARAKWET,KEIYO NORTH,80-84,152,270,422
ELGEYO-MARAKWET,KEIYO NORTH,85,21,29,50
ELGEYO-MARAKWET,KEIYO NORTH,86,21,14,35
ELGEYO-MARAKWET,KEIYO NORTH,87,12,18,30
ELGEYO-MARAKWET,KEIYO NORTH,88,9,7,16
ELGEYO-MARAKWET,KEIYO NORTH,89,20,37,57
ELGEYO-MARAKWET,KEIYO NORTH,85-89,83,105,188
ELGEYO-MARAKWET,KEIYO NORTH,90,7,14,21
ELGEYO-MARAKWET,KEIYO NORTH,91,8,15,23
ELGEYO-MARAKWET,KEIYO NORTH,92,8,4,12
ELGEYO-MARAKWET,KEIYO NORTH,93,4,13,17
ELGEYO-MARAKWET,KEIYO NORTH,94,4,7,11
ELGEYO-MARAKWET,KEIYO NORTH,90-94,31,53,84
ELGEYO-MARAKWET,KEIYO NORTH,95,10,21,31
ELGEYO-MARAKWET,KEIYO NORTH,96,-,4,4
ELGEYO-MARAKWET,KEIYO NORTH,97,6,5,11
ELGEYO-MARAKWET,KEIYO NORTH,98,3,4,7
ELGEYO-MARAKWET,KEIYO NORTH,99,1,12,13
ELGEYO-MARAKWET,KEIYO NORTH,95-99,20,46,66
ELGEYO-MARAKWET,KEIYO NORTH,100+,10,17,27
ELGEYO-MARAKWET,KEIYO NORTH,Not Stated,-,1,1
ELGEYO-MARAKWET,KEIYO SOUTH,Total,60919,59827,120746
ELGEYO-MARAKWET,KEIYO SOUTH,0,1391,1393,2784
ELGEYO-MARAKWET,KEIYO SOUTH,1,1382,1389,2771
ELGEYO-MARAKWET,KEIYO SOUTH,2,1469,1385,2854
ELGEYO-MARAKWET,KEIYO SOUTH,3,1542,1547,3089
ELGEYO-MARAKWET,KEIYO SOUTH,4,1618,1573,3191
ELGEYO-MARAKWET,KEIYO SOUTH,0 - 4,7402,7287,14689
ELGEYO-MARAKWET,KEIYO SOUTH,5,1476,1478,2954
ELGEYO-MARAKWET,KEIYO SOUTH,6,1623,1578,3201
ELGEYO-MARAKWET,KEIYO SOUTH,7,1567,1563,3130
ELGEYO-MARAKWET,KEIYO SOUTH,8,1448,1434,2882
ELGEYO-MARAKWET,KEIYO SOUTH,9,1742,1646,3388
ELGEYO-MARAKWET,KEIYO SOUTH,05-Sep,7856,7699,15555
ELGEYO-MARAKWET,KEIYO SOUTH,10,1748,1603,3351
ELGEYO-MARAKWET,KEIYO SOUTH,11,1588,1633,3221
ELGEYO-MARAKWET,KEIYO SOUTH,12,1864,1703,3567
ELGEYO-MARAKWET,KEIYO SOUTH,13,1741,1752,3493
ELGEYO-MARAKWET,KEIYO SOUTH,14,1666,1634,3300
ELGEYO-MARAKWET,KEIYO SOUTH,Oct-14,8607,8325,16932
ELGEYO-MARAKWET,KEIYO SOUTH,15,1734,1692,3426
ELGEYO-MARAKWET,KEIYO SOUTH,16,1570,1521,3091
ELGEYO-MARAKWET,KEIYO SOUTH,17,1733,1647,3380
ELGEYO-MARAKWET,KEIYO SOUTH,18,1287,1229,2516
ELGEYO-MARAKWET,KEIYO SOUTH,19,1607,1373,2980
ELGEYO-MARAKWET,KEIYO SOUTH,15-19,7931,7462,15393
ELGEYO-MARAKWET,KEIYO SOUTH,20,1424,1235,2659
ELGEYO-MARAKWET,KEIYO SOUTH,21,1303,1221,2524
ELGEYO-MARAKWET,KEIYO SOUTH,22,1235,1086,2321
ELGEYO-MARAKWET,KEIYO SOUTH,23,1263,1137,2400
ELGEYO-MARAKWET,KEIYO SOUTH,24,1036,1018,2054
ELGEYO-MARAKWET,KEIYO SOUTH,20-24,6261,5697,11958
ELGEYO-MARAKWET,KEIYO SOUTH,25,1047,1029,2076
ELGEYO-MARAKWET,KEIYO SOUTH,26,811,814,1625
ELGEYO-MARAKWET,KEIYO SOUTH,27,832,813,1645
ELGEYO-MARAKWET,KEIYO SOUTH,28,651,652,1303
ELGEYO-MARAKWET,KEIYO SOUTH,29,772,770,1542
ELGEYO-MARAKWET,KEIYO SOUTH,25-29,4113,4078,8191
ELGEYO-MARAKWET,KEIYO SOUTH,30,905,939,1844
ELGEYO-MARAKWET,KEIYO SOUTH,31,692,682,1374
ELGEYO-MARAKWET,KEIYO SOUTH,32,826,897,1723
ELGEYO-MARAKWET,KEIYO SOUTH,33,728,806,1534
ELGEYO-MARAKWET,KEIYO SOUTH,34,622,684,1306
ELGEYO-MARAKWET,KEIYO SOUTH,30-34,3773,4008,7781
ELGEYO-MARAKWET,KEIYO SOUTH,35,944,938,1882
ELGEYO-MARAKWET,KEIYO SOUTH,36,578,512,1090
ELGEYO-MARAKWET,KEIYO SOUTH,37,683,617,1300
ELGEYO-MARAKWET,KEIYO SOUTH,38,371,384,755
ELGEYO-MARAKWET,KEIYO SOUTH,39,560,554,1114
ELGEYO-MARAKWET,KEIYO SOUTH,35-39,3136,3005,6141
ELGEYO-MARAKWET,KEIYO SOUTH,40,614,560,1174
ELGEYO-MARAKWET,KEIYO SOUTH,41,673,605,1278
ELGEYO-MARAKWET,KEIYO SOUTH,42,582,537,1119
ELGEYO-MARAKWET,KEIYO SOUTH,43,512,512,1024
ELGEYO-MARAKWET,KEIYO SOUTH,44,312,371,683
ELGEYO-MARAKWET,KEIYO SOUTH,40-44,2693,2585,5278
ELGEYO-MARAKWET,KEIYO SOUTH,45,840,765,1605
ELGEYO-MARAKWET,KEIYO SOUTH,46,458,488,946
ELGEYO-MARAKWET,KEIYO SOUTH,47,463,487,950
ELGEYO-MARAKWET,KEIYO SOUTH,48,269,274,543
ELGEYO-MARAKWET,KEIYO SOUTH,49,335,377,712
ELGEYO-MARAKWET,KEIYO SOUTH,45-49,2365,2391,4756
ELGEYO-MARAKWET,KEIYO SOUTH,50,398,409,807
ELGEYO-MARAKWET,KEIYO SOUTH,51,332,343,675
ELGEYO-MARAKWET,KEIYO SOUTH,52,262,287,549
ELGEYO-MARAKWET,KEIYO SOUTH,53,206,217,423
ELGEYO-MARAKWET,KEIYO SOUTH,54,335,330,665
ELGEYO-MARAKWET,KEIYO SOUTH,50-54,1533,1586,3119
ELGEYO-MARAKWET,KEIYO SOUTH,55,285,242,527
ELGEYO-MARAKWET,KEIYO SOUTH,56,236,265,501
ELGEYO-MARAKWET,KEIYO SOUTH,57,265,362,627
ELGEYO-MARAKWET,KEIYO SOUTH,58,346,443,789
ELGEYO-MARAKWET,KEIYO SOUTH,59,326,297,623
ELGEYO-MARAKWET,KEIYO SOUTH,55-59,1458,1609,3067
ELGEYO-MARAKWET,KEIYO SOUTH,60,333,351,684
ELGEYO-MARAKWET,KEIYO SOUTH,61,262,274,536
ELGEYO-MARAKWET,KEIYO SOUTH,62,190,188,378
ELGEYO-MARAKWET,KEIYO SOUTH,63,195,216,411
ELGEYO-MARAKWET,KEIYO SOUTH,64,138,173,311
ELGEYO-MARAKWET,KEIYO SOUTH,60-64,1118,1202,2320
ELGEYO-MARAKWET,KEIYO SOUTH,65,293,266,559
ELGEYO-MARAKWET,KEIYO SOUTH,66,140,110,250
ELGEYO-MARAKWET,KEIYO SOUTH,67,325,268,593
ELGEYO-MARAKWET,KEIYO SOUTH,68,113,109,222
ELGEYO-MARAKWET,KEIYO SOUTH,69,239,211,450
ELGEYO-MARAKWET,KEIYO SOUTH,65-69,1110,964,2074
ELGEYO-MARAKWET,KEIYO SOUTH,70,210,271,481
ELGEYO-MARAKWET,KEIYO SOUTH,71,178,161,339
ELGEYO-MARAKWET,KEIYO SOUTH,72,127,107,234
ELGEYO-MARAKWET,KEIYO SOUTH,73,94,83,177
ELGEYO-MARAKWET,KEIYO SOUTH,74,92,133,225
ELGEYO-MARAKWET,KEIYO SOUTH,70-74,701,755,1456
ELGEYO-MARAKWET,KEIYO SOUTH,75,100,113,213
ELGEYO-MARAKWET,KEIYO SOUTH,76,109,100,209
ELGEYO-MARAKWET,KEIYO SOUTH,77,66,68,134
ELGEYO-MARAKWET,KEIYO SOUTH,78,44,46,90
ELGEYO-MARAKWET,KEIYO SOUTH,79,68,145,213
ELGEYO-MARAKWET,KEIYO SOUTH,75-79,387,472,859
ELGEYO-MARAKWET,KEIYO SOUTH,80,77,119,196
ELGEYO-MARAKWET,KEIYO SOUTH,81,39,52,91
ELGEYO-MARAKWET,KEIYO SOUTH,82,31,35,66
ELGEYO-MARAKWET,KEIYO SOUTH,83,45,34,79
ELGEYO-MARAKWET,KEIYO SOUTH,84,31,61,92
ELGEYO-MARAKWET,KEIYO SOUTH,80-84,223,301,524
ELGEYO-MARAKWET,KEIYO SOUTH,85,24,43,67
ELGEYO-MARAKWET,KEIYO SOUTH,86,20,19,39
ELGEYO-MARAKWET,KEIYO SOUTH,87,26,25,51
ELGEYO-MARAKWET,KEIYO SOUTH,88,17,15,32
ELGEYO-MARAKWET,KEIYO SOUTH,89,48,93,141
ELGEYO-MARAKWET,KEIYO SOUTH,85-89,135,195,330
ELGEYO-MARAKWET,KEIYO SOUTH,90,23,50,73
ELGEYO-MARAKWET,KEIYO SOUTH,91,17,15,32
ELGEYO-MARAKWET,KEIYO SOUTH,92,7,15,22
ELGEYO-MARAKWET,KEIYO SOUTH,93,7,9,16
ELGEYO-MARAKWET,KEIYO SOUTH,94,8,15,23
ELGEYO-MARAKWET,KEIYO SOUTH,90-94,62,104,166
ELGEYO-MARAKWET,KEIYO SOUTH,95,19,25,44
ELGEYO-MARAKWET,KEIYO SOUTH,96,5,6,11
ELGEYO-MARAKWET,KEIYO SOUTH,97,1,5,6
ELGEYO-MARAKWET,KEIYO SOUTH,98,5,5,10
ELGEYO-MARAKWET,KEIYO SOUTH,99,14,22,36
ELGEYO-MARAKWET,KEIYO SOUTH,95-99,44,63,107
ELGEYO-MARAKWET,KEIYO SOUTH,100+,11,39,50
ELGEYO-MARAKWET,KEIYO SOUTH,Not Stated,-,-,-
ELGEYO-MARAKWET,MARAKWET EAST,Total,47849,49190,97039
ELGEYO-MARAKWET,MARAKWET EAST,0,1251,1335,2586
ELGEYO-MARAKWET,MARAKWET EAST,1,1318,1262,2580
ELGEYO-MARAKWET,MARAKWET EAST,2,1392,1370,2762
ELGEYO-MARAKWET,MARAKWET EAST,3,1499,1575,3074
ELGEYO-MARAKWET,MARAKWET EAST,4,1737,1715,3452
ELGEYO-MARAKWET,MARAKWET EAST,0 - 4,7197,7257,14454
ELGEYO-MARAKWET,MARAKWET EAST,5,1659,1599,3258
ELGEYO-MARAKWET,MARAKWET EAST,6,1696,1672,3368
ELGEYO-MARAKWET,MARAKWET EAST,7,1654,1657,3311
ELGEYO-MARAKWET,MARAKWET EAST,8,1521,1454,2975
ELGEYO-MARAKWET,MARAKWET EAST,9,1627,1518,3145
ELGEYO-MARAKWET,MARAKWET EAST,05-Sep,8157,7900,16057
ELGEYO-MARAKWET,MARAKWET EAST,10,1752,1743,3495
ELGEYO-MARAKWET,MARAKWET EAST,11,1274,1540,2814
ELGEYO-MARAKWET,MARAKWET EAST,12,1624,1633,3257
ELGEYO-MARAKWET,MARAKWET EAST,13,1503,1562,3065
ELGEYO-MARAKWET,MARAKWET EAST,14,1422,1410,2832
ELGEYO-MARAKWET,MARAKWET EAST,Oct-14,7575,7888,15463
ELGEYO-MARAKWET,MARAKWET EAST,15,1373,1302,2675
ELGEYO-MARAKWET,MARAKWET EAST,16,1224,1214,2438
ELGEYO-MARAKWET,MARAKWET EAST,17,1119,1016,2135
ELGEYO-MARAKWET,MARAKWET EAST,18,849,803,1652
ELGEYO-MARAKWET,MARAKWET EAST,19,1017,1031,2048
ELGEYO-MARAKWET,MARAKWET EAST,15-19,5582,5366,10948
ELGEYO-MARAKWET,MARAKWET EAST,20,967,900,1867
ELGEYO-MARAKWET,MARAKWET EAST,21,802,807,1609
ELGEYO-MARAKWET,MARAKWET EAST,22,720,768,1488
ELGEYO-MARAKWET,MARAKWET EAST,23,660,750,1410
ELGEYO-MARAKWET,MARAKWET EAST,24,651,687,1338
ELGEYO-MARAKWET,MARAKWET EAST,20-24,3800,3912,7712
ELGEYO-MARAKWET,MARAKWET EAST,25,867,943,1810
ELGEYO-MARAKWET,MARAKWET EAST,26,632,705,1337
ELGEYO-MARAKWET,MARAKWET EAST,27,685,779,1464
ELGEYO-MARAKWET,MARAKWET EAST,28,465,566,1031
ELGEYO-MARAKWET,MARAKWET EAST,29,528,627,1155
ELGEYO-MARAKWET,MARAKWET EAST,25-29,3177,3620,6797
ELGEYO-MARAKWET,MARAKWET EAST,30,641,745,1386
ELGEYO-MARAKWET,MARAKWET EAST,31,456,510,966
ELGEYO-MARAKWET,MARAKWET EAST,32,536,660,1196
ELGEYO-MARAKWET,MARAKWET EAST,33,467,528,995
ELGEYO-MARAKWET,MARAKWET EAST,34,387,435,822
ELGEYO-MARAKWET,MARAKWET EAST,30-34,2487,2878,5365
ELGEYO-MARAKWET,MARAKWET EAST,35,671,573,1244
ELGEYO-MARAKWET,MARAKWET EAST,36,333,301,634
ELGEYO-MARAKWET,MARAKWET EAST,37,331,265,596
ELGEYO-MARAKWET,MARAKWET EAST,38,224,175,399
ELGEYO-MARAKWET,MARAKWET EAST,39,273,246,519
ELGEYO-MARAKWET,MARAKWET EAST,35-39,1832,1560,3392
ELGEYO-MARAKWET,MARAKWET EAST,40,410,346,756
ELGEYO-MARAKWET,MARAKWET EAST,41,393,369,762
ELGEYO-MARAKWET,MARAKWET EAST,42,367,424,791
ELGEYO-MARAKWET,MARAKWET EAST,43,272,295,567
ELGEYO-MARAKWET,MARAKWET EAST,44,171,198,369
ELGEYO-MARAKWET,MARAKWET EAST,40-44,1613,1632,3245
ELGEYO-MARAKWET,MARAKWET EAST,45,723,679,1402
ELGEYO-MARAKWET,MARAKWET EAST,46,285,250,535
ELGEYO-MARAKWET,MARAKWET EAST,47,305,299,604
ELGEYO-MARAKWET,MARAKWET EAST,48,135,101,236
ELGEYO-MARAKWET,MARAKWET EAST,49,187,177,364
ELGEYO-MARAKWET,MARAKWET EAST,45-49,1635,1506,3141
ELGEYO-MARAKWET,MARAKWET EAST,50,298,333,631
ELGEYO-MARAKWET,MARAKWET EAST,51,166,176,342
ELGEYO-MARAKWET,MARAKWET EAST,52,171,163,334
ELGEYO-MARAKWET,MARAKWET EAST,53,87,106,193
ELGEYO-MARAKWET,MARAKWET EAST,54,189,161,350
ELGEYO-MARAKWET,MARAKWET EAST,50-54,911,939,1850
ELGEYO-MARAKWET,MARAKWET EAST,55,186,169,355
ELGEYO-MARAKWET,MARAKWET EAST,56,156,192,348
ELGEYO-MARAKWET,MARAKWET EAST,57,167,208,375
ELGEYO-MARAKWET,MARAKWET EAST,58,180,177,357
ELGEYO-MARAKWET,MARAKWET EAST,59,205,208,413
ELGEYO-MARAKWET,MARAKWET EAST,55-59,894,954,1848
ELGEYO-MARAKWET,MARAKWET EAST,60,304,308,612
ELGEYO-MARAKWET,MARAKWET EAST,61,182,185,367
ELGEYO-MARAKWET,MARAKWET EAST,62,112,107,219
ELGEYO-MARAKWET,MARAKWET EAST,63,141,195,336
ELGEYO-MARAKWET,MARAKWET EAST,64,91,105,196
ELGEYO-MARAKWET,MARAKWET EAST,60-64,830,900,1730
ELGEYO-MARAKWET,MARAKWET EAST,65,239,245,484
ELGEYO-MARAKWET,MARAKWET EAST,66,78,102,180
ELGEYO-MARAKWET,MARAKWET EAST,67,164,161,325
ELGEYO-MARAKWET,MARAKWET EAST,68,101,102,203
ELGEYO-MARAKWET,MARAKWET EAST,69,179,229,408
ELGEYO-MARAKWET,MARAKWET EAST,65-69,761,839,1600
ELGEYO-MARAKWET,MARAKWET EAST,70,195,301,496
ELGEYO-MARAKWET,MARAKWET EAST,71,138,204,342
ELGEYO-MARAKWET,MARAKWET EAST,72,83,131,214
ELGEYO-MARAKWET,MARAKWET EAST,73,89,129,218
ELGEYO-MARAKWET,MARAKWET EAST,74,92,129,221
ELGEYO-MARAKWET,MARAKWET EAST,70-74,597,894,1491
ELGEYO-MARAKWET,MARAKWET EAST,75,112,140,252
ELGEYO-MARAKWET,MARAKWET EAST,76,50,73,123
ELGEYO-MARAKWET,MARAKWET EAST,77,64,83,147
ELGEYO-MARAKWET,MARAKWET EAST,78,39,45,84
ELGEYO-MARAKWET,MARAKWET EAST,79,93,144,237
ELGEYO-MARAKWET,MARAKWET EAST,75-79,358,485,843
ELGEYO-MARAKWET,MARAKWET EAST,80,87,132,219
ELGEYO-MARAKWET,MARAKWET EAST,81,37,78,115
ELGEYO-MARAKWET,MARAKWET EAST,82,22,34,56
ELGEYO-MARAKWET,MARAKWET EAST,83,34,51,85
ELGEYO-MARAKWET,MARAKWET EAST,84,37,39,76
ELGEYO-MARAKWET,MARAKWET EAST,80-84,217,334,551
ELGEYO-MARAKWET,MARAKWET EAST,85,26,38,64
ELGEYO-MARAKWET,MARAKWET EAST,86,13,17,30
ELGEYO-MARAKWET,MARAKWET EAST,87,25,33,58
ELGEYO-MARAKWET,MARAKWET EAST,88,8,17,25
ELGEYO-MARAKWET,MARAKWET EAST,89,55,71,126
ELGEYO-MARAKWET,MARAKWET EAST,85-89,127,176,303
ELGEYO-MARAKWET,MARAKWET EAST,90,22,37,59
ELGEYO-MARAKWET,MARAKWET EAST,91,11,19,30
ELGEYO-MARAKWET,MARAKWET EAST,92,-,6,6
ELGEYO-MARAKWET,MARAKWET EAST,93,10,7,17
ELGEYO-MARAKWET,MARAKWET EAST,94,10,13,23
ELGEYO-MARAKWET,MARAKWET EAST,90-94,53,82,135
ELGEYO-MARAKWET,MARAKWET EAST,95,14,17,31
ELGEYO-MARAKWET,MARAKWET EAST,96,4,5,9
ELGEYO-MARAKWET,MARAKWET EAST,97,-,6,6
ELGEYO-MARAKWET,MARAKWET EAST,98,3,4,7
ELGEYO-MARAKWET,MARAKWET EAST,99,12,14,26
ELGEYO-MARAKWET,MARAKWET EAST,95-99,33,46,79
ELGEYO-MARAKWET,MARAKWET EAST,100+,13,22,35
ELGEYO-MARAKWET,MARAKWET EAST,Not Stated,-,-,-
ELGEYO-MARAKWET,MARAKWET WEST,Total,68948,68560,137508
ELGEYO-MARAKWET,MARAKWET WEST,0,1785,1733,3518
ELGEYO-MARAKWET,MARAKWET WEST,1,1942,1877,3819
ELGEYO-MARAKWET,MARAKWET WEST,2,1839,1894,3733
ELGEYO-MARAKWET,MARAKWET WEST,3,2028,1938,3966
ELGEYO-MARAKWET,MARAKWET WEST,4,2065,2077,4142
ELGEYO-MARAKWET,MARAKWET WEST,0 - 4,9659,9519,19178
ELGEYO-MARAKWET,MARAKWET WEST,5,2141,2151,4292
ELGEYO-MARAKWET,MARAKWET WEST,6,2018,2060,4078
ELGEYO-MARAKWET,MARAKWET WEST,7,2038,1945,3983
ELGEYO-MARAKWET,MARAKWET WEST,8,1776,1742,3518
ELGEYO-MARAKWET,MARAKWET WEST,9,2102,2077,4179
ELGEYO-MARAKWET,MARAKWET WEST,05-Sep,10075,9975,20050
ELGEYO-MARAKWET,MARAKWET WEST,10,2058,1962,4020
ELGEYO-MARAKWET,MARAKWET WEST,11,1943,1851,3794
ELGEYO-MARAKWET,MARAKWET WEST,12,2088,2113,4201
ELGEYO-MARAKWET,MARAKWET WEST,13,2058,2089,4147
ELGEYO-MARAKWET,MARAKWET WEST,14,2119,2018,4137
ELGEYO-MARAKWET,MARAKWET WEST,Oct-14,10266,10033,20299
ELGEYO-MARAKWET,MARAKWET WEST,15,2071,2003,4074
ELGEYO-MARAKWET,MARAKWET WEST,16,1881,1836,3717
ELGEYO-MARAKWET,MARAKWET WEST,17,1719,1617,3336
ELGEYO-MARAKWET,MARAKWET WEST,18,1357,1323,2680
ELGEYO-MARAKWET,MARAKWET WEST,19,1736,1696,3432
ELGEYO-MARAKWET,MARAKWET WEST,15-19,8764,8475,17239
ELGEYO-MARAKWET,MARAKWET WEST,20,1464,1506,2970
ELGEYO-MARAKWET,MARAKWET WEST,21,1341,1331,2672
ELGEYO-MARAKWET,MARAKWET WEST,22,1198,1229,2427
ELGEYO-MARAKWET,MARAKWET WEST,23,1137,1208,2345
ELGEYO-MARAKWET,MARAKWET WEST,24,1075,1118,2193
ELGEYO-MARAKWET,MARAKWET WEST,20-24,6215,6392,12607
ELGEYO-MARAKWET,MARAKWET WEST,25,1280,1248,2528
ELGEYO-MARAKWET,MARAKWET WEST,26,949,1025,1974
ELGEYO-MARAKWET,MARAKWET WEST,27,1028,986,2014
ELGEYO-MARAKWET,MARAKWET WEST,28,711,736,1447
ELGEYO-MARAKWET,MARAKWET WEST,29,884,838,1722
ELGEYO-MARAKWET,MARAKWET WEST,25-29,4852,4833,9685
ELGEYO-MARAKWET,MARAKWET WEST,30,1005,1127,2132
ELGEYO-MARAKWET,MARAKWET WEST,31,733,831,1564
ELGEYO-MARAKWET,MARAKWET WEST,32,932,1019,1951
ELGEYO-MARAKWET,MARAKWET WEST,33,805,897,1702
ELGEYO-MARAKWET,MARAKWET WEST,34,664,742,1406
ELGEYO-MARAKWET,MARAKWET WEST,30-34,4139,4616,8755
ELGEYO-MARAKWET,MARAKWET WEST,35,1053,980,2033
ELGEYO-MARAKWET,MARAKWET WEST,36,571,492,1063
ELGEYO-MARAKWET,MARAKWET WEST,37,624,472,1096
ELGEYO-MARAKWET,MARAKWET WEST,38,372,330,702
ELGEYO-MARAKWET,MARAKWET WEST,39,510,471,981
ELGEYO-MARAKWET,MARAKWET WEST,35-39,3130,2745,5875
ELGEYO-MARAKWET,MARAKWET WEST,40,643,527,1170
ELGEYO-MARAKWET,MARAKWET WEST,41,566,561,1127
ELGEYO-MARAKWET,MARAKWET WEST,42,630,555,1185
ELGEYO-MARAKWET,MARAKWET WEST,43,565,551,1116
ELGEYO-MARAKWET,MARAKWET WEST,44,401,408,809
ELGEYO-MARAKWET,MARAKWET WEST,40-44,2805,2602,5407
ELGEYO-MARAKWET,MARAKWET WEST,45,854,775,1629
ELGEYO-MARAKWET,MARAKWET WEST,46,460,471,931
ELGEYO-MARAKWET,MARAKWET WEST,47,491,500,991
ELGEYO-MARAKWET,MARAKWET WEST,48,247,258,505
ELGEYO-MARAKWET,MARAKWET WEST,49,367,356,723
ELGEYO-MARAKWET,MARAKWET WEST,45-49,2419,2360,4779
ELGEYO-MARAKWET,MARAKWET WEST,50,428,470,898
ELGEYO-MARAKWET,MARAKWET WEST,51,326,363,689
ELGEYO-MARAKWET,MARAKWET WEST,52,260,259,519
ELGEYO-MARAKWET,MARAKWET WEST,53,188,221,409
ELGEYO-MARAKWET,MARAKWET WEST,54,321,285,606
ELGEYO-MARAKWET,MARAKWET WEST,50-54,1523,1598,3121
ELGEYO-MARAKWET,MARAKWET WEST,55,331,271,602
ELGEYO-MARAKWET,MARAKWET WEST,56,328,354,682
ELGEYO-MARAKWET,MARAKWET WEST,57,330,354,684
ELGEYO-MARAKWET,MARAKWET WEST,58,344,328,672
ELGEYO-MARAKWET,MARAKWET WEST,59,337,262,599
ELGEYO-MARAKWET,MARAKWET WEST,55-59,1670,1569,3239
ELGEYO-MARAKWET,MARAKWET WEST,60,357,317,674
ELGEYO-MARAKWET,MARAKWET WEST,61,308,272,580
ELGEYO-MARAKWET,MARAKWET WEST,62,175,160,335
ELGEYO-MARAKWET,MARAKWET WEST,63,213,212,425
ELGEYO-MARAKWET,MARAKWET WEST,64,121,117,238
ELGEYO-MARAKWET,MARAKWET WEST,60-64,1174,1078,2252
ELGEYO-MARAKWET,MARAKWET WEST,65,224,247,471
ELGEYO-MARAKWET,MARAKWET WEST,66,114,110,224
ELGEYO-MARAKWET,MARAKWET WEST,67,199,185,384
ELGEYO-MARAKWET,MARAKWET WEST,68,92,88,180
ELGEYO-MARAKWET,MARAKWET WEST,69,183,204,387
ELGEYO-MARAKWET,MARAKWET WEST,65-69,812,834,1646
ELGEYO-MARAKWET,MARAKWET WEST,70,220,234,454
ELGEYO-MARAKWET,MARAKWET WEST,71,161,183,344
ELGEYO-MARAKWET,MARAKWET WEST,72,97,87,184
ELGEYO-MARAKWET,MARAKWET WEST,73,86,107,193
ELGEYO-MARAKWET,MARAKWET WEST,74,90,115,205
ELGEYO-MARAKWET,MARAKWET WEST,70-74,654,726,1380
ELGEYO-MARAKWET,MARAKWET WEST,75,100,121,221
ELGEYO-MARAKWET,MARAKWET WEST,76,76,72,148
ELGEYO-MARAKWET,MARAKWET WEST,77,74,100,174
ELGEYO-MARAKWET,MARAKWET WEST,78,37,26,63
ELGEYO-MARAKWET,MARAKWET WEST,79,66,118,184
ELGEYO-MARAKWET,MARAKWET WEST,75-79,353,437,790
ELGEYO-MARAKWET,MARAKWET WEST,80,69,126,195
ELGEYO-MARAKWET,MARAKWET WEST,81,42,93,135
ELGEYO-MARAKWET,MARAKWET WEST,82,16,34,50
ELGEYO-MARAKWET,MARAKWET WEST,83,36,71,107
ELGEYO-MARAKWET,MARAKWET WEST,84,42,61,103
ELGEYO-MARAKWET,MARAKWET WEST,80-84,205,385,590
ELGEYO-MARAKWET,MARAKWET WEST,85,26,44,70
ELGEYO-MARAKWET,MARAKWET WEST,86,21,21,42
ELGEYO-MARAKWET,MARAKWET WEST,87,28,37,65
ELGEYO-MARAKWET,MARAKWET WEST,88,19,31,50
ELGEYO-MARAKWET,MARAKWET WEST,89,42,73,115
ELGEYO-MARAKWET,MARAKWET WEST,85-89,136,206,342
ELGEYO-MARAKWET,MARAKWET WEST,90,22,42,64
ELGEYO-MARAKWET,MARAKWET WEST,91,7,20,27
ELGEYO-MARAKWET,MARAKWET WEST,92,1,15,16
ELGEYO-MARAKWET,MARAKWET WEST,93,13,9,22
ELGEYO-MARAKWET,MARAKWET WEST,94,9,12,21
ELGEYO-MARAKWET,MARAKWET WEST,90-94,52,98,150
ELGEYO-MARAKWET,MARAKWET WEST,95,21,18,39
ELGEYO-MARAKWET,MARAKWET WEST,96,3,5,8
ELGEYO-MARAKWET,MARAKWET WEST,97,6,4,10
ELGEYO-MARAKWET,MARAKWET WEST,98,2,5,7
ELGEYO-MARAKWET,MARAKWET WEST,99,4,15,19
ELGEYO-MARAKWET,MARAKWET WEST,95-99,36,47,83
ELGEYO-MARAKWET,MARAKWET WEST,100+,9,32,41
ELGEYO-MARAKWET,MARAKWET WEST,Not Stated,-,-,-
EMBU,ALL,Total,304208,304367,608575
EMBU,ALL,0,5812,5846,11658
EMBU,ALL,1,6602,6238,12840
EMBU,ALL,2,6134,6076,12210
EMBU,ALL,3,6389,6202,12591
EMBU,ALL,4,6221,6027,12248
EMBU,ALL,0 - 4,31158,30389,61547
EMBU,ALL,5,6031,5765,11796
EMBU,ALL,6,5805,5992,11797
EMBU,ALL,7,6090,6026,12116
EMBU,ALL,8,6094,5936,12030
EMBU,ALL,9,6603,6527,13130
EMBU,ALL,05-Sep,30623,30246,60869
EMBU,ALL,10,6560,6460,13020
EMBU,ALL,11,6327,6450,12777
EMBU,ALL,12,7234,6828,14062
EMBU,ALL,13,7294,7160,14454
EMBU,ALL,14,7000,6655,13655
EMBU,ALL,Oct-14,34415,33553,67968
EMBU,ALL,15,6791,6727,13518
EMBU,ALL,16,6870,6744,13614
EMBU,ALL,17,6948,6386,13334
EMBU,ALL,18,5772,5405,11177
EMBU,ALL,19,6150,5671,11821
EMBU,ALL,15-19,32531,30933,63464
EMBU,ALL,20,5905,5666,11571
EMBU,ALL,21,5139,4998,10137
EMBU,ALL,22,5240,5335,10575
EMBU,ALL,23,5378,5534,10912
EMBU,ALL,24,4949,4697,9646
EMBU,ALL,20-24,26611,26230,52841
EMBU,ALL,25,5230,4832,10062
EMBU,ALL,26,4343,4223,8566
EMBU,ALL,27,4729,4337,9066
EMBU,ALL,28,4240,4022,8262
EMBU,ALL,29,4640,4564,9204
EMBU,ALL,25-29,23182,21978,45160
EMBU,ALL,30,5597,5484,11081
EMBU,ALL,31,4039,3959,7998
EMBU,ALL,32,4950,5165,10115
EMBU,ALL,33,4658,4743,9401
EMBU,ALL,34,3979,4160,8139
EMBU,ALL,30-34,23223,23511,46734
EMBU,ALL,35,5545,5175,10720
EMBU,ALL,36,3969,4013,7982
EMBU,ALL,37,4291,3875,8166
EMBU,ALL,38,3566,3565,7131
EMBU,ALL,39,4143,3964,8107
EMBU,ALL,35-39,21514,20592,42106
EMBU,ALL,40,4769,4409,9178
EMBU,ALL,41,3885,3563,7448
EMBU,ALL,42,3634,3469,7103
EMBU,ALL,43,3385,3306,6691
EMBU,ALL,44,3044,2862,5906
EMBU,ALL,40-44,18717,17609,36326
EMBU,ALL,45,3978,3851,7829
EMBU,ALL,46,3101,3073,6174
EMBU,ALL,47,3058,2946,6004
EMBU,ALL,48,2528,2472,5000
EMBU,ALL,49,2785,2694,5479
EMBU,ALL,45-49,15450,15036,30486
EMBU,ALL,50,3074,3320,6394
EMBU,ALL,51,2513,2526,5039
EMBU,ALL,52,2483,2527,5010
EMBU,ALL,53,1860,2095,3955
EMBU,ALL,54,2147,2187,4334
EMBU,ALL,50-54,12077,12655,24732
EMBU,ALL,55,2477,2414,4891
EMBU,ALL,56,2755,2887,5642
EMBU,ALL,57,2045,2394,4439
EMBU,ALL,58,1606,1778,3384
EMBU,ALL,59,1953,2080,4033
EMBU,ALL,55-59,10836,11553,22389
EMBU,ALL,60,2288,2306,4594
EMBU,ALL,61,1641,1731,3372
EMBU,ALL,62,1408,1439,2847
EMBU,ALL,63,1103,1269,2372
EMBU,ALL,64,949,1040,1989
EMBU,ALL,60-64,7389,7785,15174
EMBU,ALL,65,1551,1770,3321
EMBU,ALL,66,1202,1156,2358
EMBU,ALL,67,1839,1772,3611
EMBU,ALL,68,779,844,1623
EMBU,ALL,69,1099,1343,2442
EMBU,ALL,65-69,6470,6885,13355
EMBU,ALL,70,1316,2080,3396
EMBU,ALL,71,935,1148,2083
EMBU,ALL,72,715,844,1559
EMBU,ALL,73,620,754,1374
EMBU,ALL,74,555,826,1381
EMBU,ALL,70-74,4141,5652,9793
EMBU,ALL,75,554,881,1435
EMBU,ALL,76,417,492,909
EMBU,ALL,77,463,623,1086
EMBU,ALL,78,358,382,740
EMBU,ALL,79,428,755,1183
EMBU,ALL,75-79,2220,3133,5353
EMBU,ALL,80,603,1126,1729
EMBU,ALL,81,290,560,850
EMBU,ALL,82,271,296,567
EMBU,ALL,83,316,373,689
EMBU,ALL,84,295,459,754
EMBU,ALL,80-84,1775,2814,4589
EMBU,ALL,85,270,421,691
EMBU,ALL,86,187,216,403
EMBU,ALL,87,209,293,502
EMBU,ALL,88,126,172,298
EMBU,ALL,89,227,562,789
EMBU,ALL,85-89,1019,1664,2683
EMBU,ALL,90,151,440,591
EMBU,ALL,91,140,341,481
EMBU,ALL,92,75,128,203
EMBU,ALL,93,42,146,188
EMBU,ALL,94,55,136,191
EMBU,ALL,90-94,463,1191,1654
EMBU,ALL,95,84,189,273
EMBU,ALL,96,33,89,122
EMBU,ALL,97,61,88,149
EMBU,ALL,98,31,69,100
EMBU,ALL,99,61,163,224
EMBU,ALL,95-99,270,598,868
EMBU,ALL,100+,120,357,477
EMBU,ALL,Not Stated,4,3,7
EMBU,EMBU EAST,Total,64571,64991,129562
EMBU,EMBU EAST,0,1054,1084,2138
EMBU,EMBU EAST,1,1288,1208,2496
EMBU,EMBU EAST,2,1215,1202,2417
EMBU,EMBU EAST,3,1254,1225,2479
EMBU,EMBU EAST,4,1278,1254,2532
EMBU,EMBU EAST,0 - 4,6089,5973,12062
EMBU,EMBU EAST,5,1249,1117,2366
EMBU,EMBU EAST,6,1189,1068,2257
EMBU,EMBU EAST,7,1266,1225,2491
EMBU,EMBU EAST,8,1241,1165,2406
EMBU,EMBU EAST,9,1343,1278,2621
EMBU,EMBU EAST,05-Sep,6288,5853,12141
EMBU,EMBU EAST,10,1262,1311,2573
EMBU,EMBU EAST,11,1209,1250,2459
EMBU,EMBU EAST,12,1425,1433,2858
EMBU,EMBU EAST,13,1460,1463,2923
EMBU,EMBU EAST,14,1441,1329,2770
EMBU,EMBU EAST,Oct-14,6797,6786,13583
EMBU,EMBU EAST,15,1404,1414,2818
EMBU,EMBU EAST,16,1395,1360,2755
EMBU,EMBU EAST,17,1408,1338,2746
EMBU,EMBU EAST,18,1241,1101,2342
EMBU,EMBU EAST,19,1285,1128,2413
EMBU,EMBU EAST,15-19,6733,6341,13074
EMBU,EMBU EAST,20,1133,1080,2213
EMBU,EMBU EAST,21,1007,914,1921
EMBU,EMBU EAST,22,1049,1008,2057
EMBU,EMBU EAST,23,1034,995,2029
EMBU,EMBU EAST,24,902,892,1794
EMBU,EMBU EAST,20-24,5125,4889,10014
EMBU,EMBU EAST,25,867,864,1731
EMBU,EMBU EAST,26,802,731,1533
EMBU,EMBU EAST,27,835,834,1669
EMBU,EMBU EAST,28,790,786,1576
EMBU,EMBU EAST,29,822,835,1657
EMBU,EMBU EAST,25-29,4116,4050,8166
EMBU,EMBU EAST,30,1046,1098,2144
EMBU,EMBU EAST,31,758,837,1595
EMBU,EMBU EAST,32,986,1031,2017
EMBU,EMBU EAST,33,985,948,1933
EMBU,EMBU EAST,34,914,911,1825
EMBU,EMBU EAST,30-34,4689,4825,9514
EMBU,EMBU EAST,35,1194,1149,2343
EMBU,EMBU EAST,36,883,877,1760
EMBU,EMBU EAST,37,931,885,1816
EMBU,EMBU EAST,38,851,811,1662
EMBU,EMBU EAST,39,879,924,1803
EMBU,EMBU EAST,35-39,4738,4646,9384
EMBU,EMBU EAST,40,1075,1030,2105
EMBU,EMBU EAST,41,817,836,1653
EMBU,EMBU EAST,42,861,811,1672
EMBU,EMBU EAST,43,772,771,1543
EMBU,EMBU EAST,44,764,651,1415
EMBU,EMBU EAST,40-44,4289,4099,8388
EMBU,EMBU EAST,45,841,901,1742
EMBU,EMBU EAST,46,734,777,1511
EMBU,EMBU EAST,47,726,791,1517
EMBU,EMBU EAST,48,639,620,1259
EMBU,EMBU EAST,49,678,711,1389
EMBU,EMBU EAST,45-49,3618,3800,7418
EMBU,EMBU EAST,50,719,811,1530
EMBU,EMBU EAST,51,640,588,1228
EMBU,EMBU EAST,52,595,617,1212
EMBU,EMBU EAST,53,449,440,889
EMBU,EMBU EAST,54,542,553,1095
EMBU,EMBU EAST,50-54,2945,3009,5954
EMBU,EMBU EAST,55,635,625,1260
EMBU,EMBU EAST,56,750,771,1521
EMBU,EMBU EAST,57,566,630,1196
EMBU,EMBU EAST,58,394,452,846
EMBU,EMBU EAST,59,544,541,1085
EMBU,EMBU EAST,55-59,2889,3019,5908
EMBU,EMBU EAST,60,610,612,1222
EMBU,EMBU EAST,61,452,433,885
EMBU,EMBU EAST,62,401,374,775
EMBU,EMBU EAST,63,263,307,570
EMBU,EMBU EAST,64,245,253,498
EMBU,EMBU EAST,60-64,1971,1979,3950
EMBU,EMBU EAST,65,380,445,825
EMBU,EMBU EAST,66,349,334,683
EMBU,EMBU EAST,67,464,426,890
EMBU,EMBU EAST,68,202,222,424
EMBU,EMBU EAST,69,296,358,654
EMBU,EMBU EAST,65-69,1691,1785,3476
EMBU,EMBU EAST,70,328,549,877
EMBU,EMBU EAST,71,239,322,561
EMBU,EMBU EAST,72,200,227,427
EMBU,EMBU EAST,73,146,199,345
EMBU,EMBU EAST,74,147,188,335
EMBU,EMBU EAST,70-74,1060,1485,2545
EMBU,EMBU EAST,75,147,226,373
EMBU,EMBU EAST,76,106,159,265
EMBU,EMBU EAST,77,140,159,299
EMBU,EMBU EAST,78,99,105,204
EMBU,EMBU EAST,79,111,158,269
EMBU,EMBU EAST,75-79,603,807,1410
EMBU,EMBU EAST,80,173,245,418
EMBU,EMBU EAST,81,77,141,218
EMBU,EMBU EAST,82,75,80,155
EMBU,EMBU EAST,83,93,116,209
EMBU,EMBU EAST,84,77,105,182
EMBU,EMBU EAST,80-84,495,687,1182
EMBU,EMBU EAST,85,65,111,176
EMBU,EMBU EAST,86,56,77,133
EMBU,EMBU EAST,87,47,64,111
EMBU,EMBU EAST,88,37,44,81
EMBU,EMBU EAST,89,41,113,154
EMBU,EMBU EAST,85-89,246,409,655
EMBU,EMBU EAST,90,33,99,132
EMBU,EMBU EAST,91,29,110,139
EMBU,EMBU EAST,92,18,45,63
EMBU,EMBU EAST,93,14,26,40
EMBU,EMBU EAST,94,10,43,53
EMBU,EMBU EAST,90-94,104,323,427
EMBU,EMBU EAST,95,12,36,48
EMBU,EMBU EAST,96,8,22,30
EMBU,EMBU EAST,97,13,26,39
EMBU,EMBU EAST,98,9,18,27
EMBU,EMBU EAST,99,10,31,41
EMBU,EMBU EAST,95-99,52,133,185
EMBU,EMBU EAST,100+,32,93,125
EMBU,EMBU EAST,Not Stated,1,-,1
EMBU,EMBU NORTH,Total,39665,39888,79553
EMBU,EMBU NORTH,0,694,696,1390
EMBU,EMBU NORTH,1,727,681,1408
EMBU,EMBU NORTH,2,747,726,1473
EMBU,EMBU NORTH,3,785,750,1535
EMBU,EMBU NORTH,4,780,754,1534
EMBU,EMBU NORTH,0 - 4,3733,3607,7340
EMBU,EMBU NORTH,5,746,678,1424
EMBU,EMBU NORTH,6,757,748,1505
EMBU,EMBU NORTH,7,689,744,1433
EMBU,EMBU NORTH,8,756,655,1411
EMBU,EMBU NORTH,9,765,763,1528
EMBU,EMBU NORTH,05-Sep,3713,3588,7301
EMBU,EMBU NORTH,10,778,752,1530
EMBU,EMBU NORTH,11,744,739,1483
EMBU,EMBU NORTH,12,882,782,1664
EMBU,EMBU NORTH,13,941,829,1770
EMBU,EMBU NORTH,14,841,788,1629
EMBU,EMBU NORTH,Oct-14,4186,3890,8076
EMBU,EMBU NORTH,15,826,867,1693
EMBU,EMBU NORTH,16,884,821,1705
EMBU,EMBU NORTH,17,871,806,1677
EMBU,EMBU NORTH,18,818,726,1544
EMBU,EMBU NORTH,19,832,672,1504
EMBU,EMBU NORTH,15-19,4231,3892,8123
EMBU,EMBU NORTH,20,752,634,1386
EMBU,EMBU NORTH,21,661,574,1235
EMBU,EMBU NORTH,22,656,598,1254
EMBU,EMBU NORTH,23,635,625,1260
EMBU,EMBU NORTH,24,607,543,1150
EMBU,EMBU NORTH,20-24,3311,2974,6285
EMBU,EMBU NORTH,25,581,538,1119
EMBU,EMBU NORTH,26,492,512,1004
EMBU,EMBU NORTH,27,525,495,1020
EMBU,EMBU NORTH,28,462,457,919
EMBU,EMBU NORTH,29,520,558,1078
EMBU,EMBU NORTH,25-29,2580,2560,5140
EMBU,EMBU NORTH,30,683,694,1377
EMBU,EMBU NORTH,31,490,510,1000
EMBU,EMBU NORTH,32,639,732,1371
EMBU,EMBU NORTH,33,520,618,1138
EMBU,EMBU NORTH,34,545,631,1176
EMBU,EMBU NORTH,30-34,2877,3185,6062
EMBU,EMBU NORTH,35,699,735,1434
EMBU,EMBU NORTH,36,538,564,1102
EMBU,EMBU NORTH,37,605,521,1126
EMBU,EMBU NORTH,38,480,537,1017
EMBU,EMBU NORTH,39,573,582,1155
EMBU,EMBU NORTH,35-39,2895,2939,5834
EMBU,EMBU NORTH,40,651,626,1277
EMBU,EMBU NORTH,41,552,521,1073
EMBU,EMBU NORTH,42,499,524,1023
EMBU,EMBU NORTH,43,500,492,992
EMBU,EMBU NORTH,44,431,401,832
EMBU,EMBU NORTH,40-44,2633,2564,5197
EMBU,EMBU NORTH,45,605,573,1178
EMBU,EMBU NORTH,46,467,486,953
EMBU,EMBU NORTH,47,478,414,892
EMBU,EMBU NORTH,48,401,386,787
EMBU,EMBU NORTH,49,419,420,839
EMBU,EMBU NORTH,45-49,2370,2279,4649
EMBU,EMBU NORTH,50,507,530,1037
EMBU,EMBU NORTH,51,401,385,786
EMBU,EMBU NORTH,52,431,409,840
EMBU,EMBU NORTH,53,324,346,670
EMBU,EMBU NORTH,54,345,364,709
EMBU,EMBU NORTH,50-54,2008,2034,4042
EMBU,EMBU NORTH,55,384,370,754
EMBU,EMBU NORTH,56,432,470,902
EMBU,EMBU NORTH,57,317,368,685
EMBU,EMBU NORTH,58,269,281,550
EMBU,EMBU NORTH,59,332,337,669
EMBU,EMBU NORTH,55-59,1734,1826,3560
EMBU,EMBU NORTH,60,354,354,708
EMBU,EMBU NORTH,61,233,296,529
EMBU,EMBU NORTH,62,195,243,438
EMBU,EMBU NORTH,63,162,163,325
EMBU,EMBU NORTH,64,121,129,250
EMBU,EMBU NORTH,60-64,1065,1185,2250
EMBU,EMBU NORTH,65,234,260,494
EMBU,EMBU NORTH,66,182,171,353
EMBU,EMBU NORTH,67,239,252,491
EMBU,EMBU NORTH,68,115,116,231
EMBU,EMBU NORTH,69,166,174,340
EMBU,EMBU NORTH,65-69,936,973,1909
EMBU,EMBU NORTH,70,203,301,504
EMBU,EMBU NORTH,71,135,154,289
EMBU,EMBU NORTH,72,94,121,215
EMBU,EMBU NORTH,73,95,123,218
EMBU,EMBU NORTH,74,77,119,196
EMBU,EMBU NORTH,70-74,604,818,1422
EMBU,EMBU NORTH,75,72,133,205
EMBU,EMBU NORTH,76,68,72,140
EMBU,EMBU NORTH,77,57,111,168
EMBU,EMBU NORTH,78,47,67,114
EMBU,EMBU NORTH,79,65,125,190
EMBU,EMBU NORTH,75-79,309,508,817
EMBU,EMBU NORTH,80,68,178,246
EMBU,EMBU NORTH,81,40,75,115
EMBU,EMBU NORTH,82,28,43,71
EMBU,EMBU NORTH,83,39,55,94
EMBU,EMBU NORTH,84,38,75,113
EMBU,EMBU NORTH,80-84,213,426,639
EMBU,EMBU NORTH,85,34,72,106
EMBU,EMBU NORTH,86,35,28,63
EMBU,EMBU NORTH,87,35,58,93
EMBU,EMBU NORTH,88,21,31,52
EMBU,EMBU NORTH,89,31,81,112
EMBU,EMBU NORTH,85-89,156,270,426
EMBU,EMBU NORTH,90,24,67,91
EMBU,EMBU NORTH,91,25,71,96
EMBU,EMBU NORTH,92,7,33,40
EMBU,EMBU NORTH,93,6,38,44
EMBU,EMBU NORTH,94,10,19,29
EMBU,EMBU NORTH,90-94,72,228,300
EMBU,EMBU NORTH,95,6,29,35
EMBU,EMBU NORTH,96,1,15,16
EMBU,EMBU NORTH,97,9,18,27
EMBU,EMBU NORTH,98,3,12,15
EMBU,EMBU NORTH,99,7,24,31
EMBU,EMBU NORTH,95-99,26,98,124
EMBU,EMBU NORTH,100+,13,44,57
EMBU,EMBU NORTH,Not Stated,-,-,-
EMBU,EMBU WEST,Total,63125,63966,127091
EMBU,EMBU WEST,0,1319,1386,2705
EMBU,EMBU WEST,1,1426,1284,2710
EMBU,EMBU WEST,2,1256,1253,2509
EMBU,EMBU WEST,3,1245,1210,2455
EMBU,EMBU WEST,4,1183,1128,2311
EMBU,EMBU WEST,0 - 4,6429,6261,12690
EMBU,EMBU WEST,5,1091,1135,2226
EMBU,EMBU WEST,6,1071,1183,2254
EMBU,EMBU WEST,7,1182,1118,2300
EMBU,EMBU WEST,8,1050,1068,2118
EMBU,EMBU WEST,9,1163,1179,2342
EMBU,EMBU WEST,05-Sep,5557,5683,11240
EMBU,EMBU WEST,10,1128,1147,2275
EMBU,EMBU WEST,11,1045,1094,2139
EMBU,EMBU WEST,12,1241,1154,2395
EMBU,EMBU WEST,13,1183,1202,2385
EMBU,EMBU WEST,14,1165,1131,2296
EMBU,EMBU WEST,Oct-14,5762,5728,11490
EMBU,EMBU WEST,15,1093,1128,2221
EMBU,EMBU WEST,16,1130,1208,2338
EMBU,EMBU WEST,17,1158,1144,2302
EMBU,EMBU WEST,18,1009,1086,2095
EMBU,EMBU WEST,19,1208,1385,2593
EMBU,EMBU WEST,15-19,5598,5951,11549
EMBU,EMBU WEST,20,1227,1410,2637
EMBU,EMBU WEST,21,1188,1338,2526
EMBU,EMBU WEST,22,1291,1527,2818
EMBU,EMBU WEST,23,1391,1593,2984
EMBU,EMBU WEST,24,1284,1349,2633
EMBU,EMBU WEST,20-24,6381,7217,13598
EMBU,EMBU WEST,25,1401,1355,2756
EMBU,EMBU WEST,26,1174,1199,2373
EMBU,EMBU WEST,27,1261,1142,2403
EMBU,EMBU WEST,28,1116,1063,2179
EMBU,EMBU WEST,29,1174,1161,2335
EMBU,EMBU WEST,25-29,6126,5920,12046
EMBU,EMBU WEST,30,1415,1371,2786
EMBU,EMBU WEST,31,976,966,1942
EMBU,EMBU WEST,32,1219,1257,2476
EMBU,EMBU WEST,33,1144,1160,2304
EMBU,EMBU WEST,34,972,995,1967
EMBU,EMBU WEST,30-34,5726,5749,11475
EMBU,EMBU WEST,35,1317,1181,2498
EMBU,EMBU WEST,36,914,931,1845
EMBU,EMBU WEST,37,955,838,1793
EMBU,EMBU WEST,38,838,836,1674
EMBU,EMBU WEST,39,977,843,1820
EMBU,EMBU WEST,35-39,5001,4629,9630
EMBU,EMBU WEST,40,1087,983,2070
EMBU,EMBU WEST,41,827,755,1582
EMBU,EMBU WEST,42,830,765,1595
EMBU,EMBU WEST,43,730,654,1384
EMBU,EMBU WEST,44,634,632,1266
EMBU,EMBU WEST,40-44,4108,3789,7897
EMBU,EMBU WEST,45,865,844,1709
EMBU,EMBU WEST,46,649,589,1238
EMBU,EMBU WEST,47,626,586,1212
EMBU,EMBU WEST,48,530,529,1059
EMBU,EMBU WEST,49,593,474,1067
EMBU,EMBU WEST,45-49,3263,3022,6285
EMBU,EMBU WEST,50,679,673,1352
EMBU,EMBU WEST,51,502,521,1023
EMBU,EMBU WEST,52,589,547,1136
EMBU,EMBU WEST,53,411,451,862
EMBU,EMBU WEST,54,455,456,911
EMBU,EMBU WEST,50-54,2636,2648,5284
EMBU,EMBU WEST,55,541,490,1031
EMBU,EMBU WEST,56,537,599,1136
EMBU,EMBU WEST,57,412,448,860
EMBU,EMBU WEST,58,371,387,758
EMBU,EMBU WEST,59,382,402,784
EMBU,EMBU WEST,55-59,2243,2326,4569
EMBU,EMBU WEST,60,487,457,944
EMBU,EMBU WEST,61,287,302,589
EMBU,EMBU WEST,62,280,249,529
EMBU,EMBU WEST,63,188,218,406
EMBU,EMBU WEST,64,189,178,367
EMBU,EMBU WEST,60-64,1431,1404,2835
EMBU,EMBU WEST,65,270,300,570
EMBU,EMBU WEST,66,204,218,422
EMBU,EMBU WEST,67,351,305,656
EMBU,EMBU WEST,68,166,140,306
EMBU,EMBU WEST,69,207,203,410
EMBU,EMBU WEST,65-69,1198,1166,2364
EMBU,EMBU WEST,70,217,303,520
EMBU,EMBU WEST,71,163,179,342
EMBU,EMBU WEST,72,109,129,238
EMBU,EMBU WEST,73,119,130,249
EMBU,EMBU WEST,74,102,142,244
EMBU,EMBU WEST,70-74,710,883,1593
EMBU,EMBU WEST,75,95,160,255
EMBU,EMBU WEST,76,73,84,157
EMBU,EMBU WEST,77,81,110,191
EMBU,EMBU WEST,78,55,57,112
EMBU,EMBU WEST,79,71,106,177
EMBU,EMBU WEST,75-79,375,517,892
EMBU,EMBU WEST,80,65,194,259
EMBU,EMBU WEST,81,48,99,147
EMBU,EMBU WEST,82,42,36,78
EMBU,EMBU WEST,83,69,55,124
EMBU,EMBU WEST,84,52,66,118
EMBU,EMBU WEST,80-84,276,450,726
EMBU,EMBU WEST,85,64,61,125
EMBU,EMBU WEST,86,33,34,67
EMBU,EMBU WEST,87,27,58,85
EMBU,EMBU WEST,88,21,21,42
EMBU,EMBU WEST,89,28,89,117
EMBU,EMBU WEST,85-89,173,263,436
EMBU,EMBU WEST,90,18,78,96
EMBU,EMBU WEST,91,32,61,93
EMBU,EMBU WEST,92,10,18,28
EMBU,EMBU WEST,93,9,15,24
EMBU,EMBU WEST,94,7,18,25
EMBU,EMBU WEST,90-94,76,190,266
EMBU,EMBU WEST,95,12,28,40
EMBU,EMBU WEST,96,6,15,21
EMBU,EMBU WEST,97,9,17,26
EMBU,EMBU WEST,98,3,15,18
EMBU,EMBU WEST,99,9,23,32
EMBU,EMBU WEST,95-99,39,98,137
EMBU,EMBU WEST,100+,17,72,89
EMBU,EMBU WEST,Not Stated,-,-,-
EMBU,MBEERE SOUTH,Total,83311,80159,163470
EMBU,MBEERE SOUTH,0,1583,1557,3140
EMBU,MBEERE SOUTH,1,1856,1825,3681
EMBU,MBEERE SOUTH,2,1720,1691,3411
EMBU,MBEERE SOUTH,3,1796,1768,3564
EMBU,MBEERE SOUTH,4,1783,1663,3446
EMBU,MBEERE SOUTH,0 - 4,8738,8504,17242
EMBU,MBEERE SOUTH,5,1754,1707,3461
EMBU,MBEERE SOUTH,6,1541,1658,3199
EMBU,MBEERE SOUTH,7,1729,1736,3465
EMBU,MBEERE SOUTH,8,1774,1777,3551
EMBU,MBEERE SOUTH,9,1987,1963,3950
EMBU,MBEERE SOUTH,05-Sep,8785,8841,17626
EMBU,MBEERE SOUTH,10,2002,1826,3828
EMBU,MBEERE SOUTH,11,1907,1952,3859
EMBU,MBEERE SOUTH,12,2154,1973,4127
EMBU,MBEERE SOUTH,13,2166,2105,4271
EMBU,MBEERE SOUTH,14,2165,2005,4170
EMBU,MBEERE SOUTH,Oct-14,10394,9861,20255
EMBU,MBEERE SOUTH,15,2094,2027,4121
EMBU,MBEERE SOUTH,16,2100,1944,4044
EMBU,MBEERE SOUTH,17,2073,1861,3934
EMBU,MBEERE SOUTH,18,1615,1466,3081
EMBU,MBEERE SOUTH,19,1701,1443,3144
EMBU,MBEERE SOUTH,15-19,9583,8741,18324
EMBU,MBEERE SOUTH,20,1732,1530,3262
EMBU,MBEERE SOUTH,21,1434,1292,2726
EMBU,MBEERE SOUTH,22,1445,1328,2773
EMBU,MBEERE SOUTH,23,1503,1365,2868
EMBU,MBEERE SOUTH,24,1375,1155,2530
EMBU,MBEERE SOUTH,20-24,7489,6670,14159
EMBU,MBEERE SOUTH,25,1505,1216,2721
EMBU,MBEERE SOUTH,26,1149,1062,2211
EMBU,MBEERE SOUTH,27,1321,1083,2404
EMBU,MBEERE SOUTH,28,1168,1004,2172
EMBU,MBEERE SOUTH,29,1309,1266,2575
EMBU,MBEERE SOUTH,25-29,6452,5631,12083
EMBU,MBEERE SOUTH,30,1537,1336,2873
EMBU,MBEERE SOUTH,31,1117,1007,2124
EMBU,MBEERE SOUTH,32,1313,1268,2581
EMBU,MBEERE SOUTH,33,1251,1217,2468
EMBU,MBEERE SOUTH,34,975,976,1951
EMBU,MBEERE SOUTH,30-34,6193,5804,11997
EMBU,MBEERE SOUTH,35,1438,1232,2670
EMBU,MBEERE SOUTH,36,1041,1012,2053
EMBU,MBEERE SOUTH,37,1086,1004,2090
EMBU,MBEERE SOUTH,38,882,815,1697
EMBU,MBEERE SOUTH,39,1122,978,2100
EMBU,MBEERE SOUTH,35-39,5569,5041,10610
EMBU,MBEERE SOUTH,40,1236,1106,2342
EMBU,MBEERE SOUTH,41,1049,878,1927
EMBU,MBEERE SOUTH,42,907,849,1756
EMBU,MBEERE SOUTH,43,891,832,1723
EMBU,MBEERE SOUTH,44,756,660,1416
EMBU,MBEERE SOUTH,40-44,4839,4325,9164
EMBU,MBEERE SOUTH,45,1050,897,1947
EMBU,MBEERE SOUTH,46,787,728,1515
EMBU,MBEERE SOUTH,47,781,704,1485
EMBU,MBEERE SOUTH,48,613,603,1216
EMBU,MBEERE SOUTH,49,702,691,1393
EMBU,MBEERE SOUTH,45-49,3933,3623,7556
EMBU,MBEERE SOUTH,50,759,801,1560
EMBU,MBEERE SOUTH,51,634,661,1295
EMBU,MBEERE SOUTH,52,550,601,1151
EMBU,MBEERE SOUTH,53,401,506,907
EMBU,MBEERE SOUTH,54,501,495,996
EMBU,MBEERE SOUTH,50-54,2845,3064,5909
EMBU,MBEERE SOUTH,55,559,546,1105
EMBU,MBEERE SOUTH,56,625,611,1236
EMBU,MBEERE SOUTH,57,468,566,1034
EMBU,MBEERE SOUTH,58,339,369,708
EMBU,MBEERE SOUTH,59,447,463,910
EMBU,MBEERE SOUTH,55-59,2438,2555,4993
EMBU,MBEERE SOUTH,60,516,528,1044
EMBU,MBEERE SOUTH,61,401,412,813
EMBU,MBEERE SOUTH,62,333,359,692
EMBU,MBEERE SOUTH,63,309,300,609
EMBU,MBEERE SOUTH,64,238,285,523
EMBU,MBEERE SOUTH,60-64,1797,1884,3681
EMBU,MBEERE SOUTH,65,386,407,793
EMBU,MBEERE SOUTH,66,284,277,561
EMBU,MBEERE SOUTH,67,497,513,1010
EMBU,MBEERE SOUTH,68,184,243,427
EMBU,MBEERE SOUTH,69,266,353,619
EMBU,MBEERE SOUTH,65-69,1617,1793,3410
EMBU,MBEERE SOUTH,70,361,536,897
EMBU,MBEERE SOUTH,71,241,295,536
EMBU,MBEERE SOUTH,72,200,201,401
EMBU,MBEERE SOUTH,73,155,173,328
EMBU,MBEERE SOUTH,74,119,199,318
EMBU,MBEERE SOUTH,70-74,1076,1404,2480
EMBU,MBEERE SOUTH,75,142,203,345
EMBU,MBEERE SOUTH,76,109,105,214
EMBU,MBEERE SOUTH,77,115,145,260
EMBU,MBEERE SOUTH,78,82,93,175
EMBU,MBEERE SOUTH,79,113,188,301
EMBU,MBEERE SOUTH,75-79,561,734,1295
EMBU,MBEERE SOUTH,80,186,321,507
EMBU,MBEERE SOUTH,81,77,115,192
EMBU,MBEERE SOUTH,82,73,84,157
EMBU,MBEERE SOUTH,83,77,87,164
EMBU,MBEERE SOUTH,84,67,124,191
EMBU,MBEERE SOUTH,80-84,480,731,1211
EMBU,MBEERE SOUTH,85,61,124,185
EMBU,MBEERE SOUTH,86,40,49,89
EMBU,MBEERE SOUTH,87,58,66,124
EMBU,MBEERE SOUTH,88,32,48,80
EMBU,MBEERE SOUTH,89,63,142,205
EMBU,MBEERE SOUTH,85-89,254,429,683
EMBU,MBEERE SOUTH,90,48,112,160
EMBU,MBEERE SOUTH,91,41,63,104
EMBU,MBEERE SOUTH,92,30,21,51
EMBU,MBEERE SOUTH,93,8,40,48
EMBU,MBEERE SOUTH,94,14,28,42
EMBU,MBEERE SOUTH,90-94,141,264,405
EMBU,MBEERE SOUTH,95,29,68,97
EMBU,MBEERE SOUTH,96,12,17,29
EMBU,MBEERE SOUTH,97,19,20,39
EMBU,MBEERE SOUTH,98,10,16,26
EMBU,MBEERE SOUTH,99,20,40,60
EMBU,MBEERE SOUTH,95-99,90,161,251
EMBU,MBEERE SOUTH,100+,36,96,132
EMBU,MBEERE SOUTH,Not Stated,1,3,4
EMBU,MBEERE NORTH,Total,53517,55360,108877
EMBU,MBEERE NORTH,0,1162,1123,2285
EMBU,MBEERE NORTH,1,1305,1240,2545
EMBU,MBEERE NORTH,2,1195,1204,2399
EMBU,MBEERE NORTH,3,1309,1249,2558
EMBU,MBEERE NORTH,4,1197,1228,2425
EMBU,MBEERE NORTH,0 - 4,6168,6044,12212
EMBU,MBEERE NORTH,5,1191,1128,2319
EMBU,MBEERE NORTH,6,1247,1335,2582
EMBU,MBEERE NORTH,7,1224,1203,2427
EMBU,MBEERE NORTH,8,1273,1271,2544
EMBU,MBEERE NORTH,9,1345,1344,2689
EMBU,MBEERE NORTH,05-Sep,6280,6281,12561
EMBU,MBEERE NORTH,10,1390,1424,2814
EMBU,MBEERE NORTH,11,1422,1415,2837
EMBU,MBEERE NORTH,12,1532,1486,3018
EMBU,MBEERE NORTH,13,1544,1561,3105
EMBU,MBEERE NORTH,14,1388,1402,2790
EMBU,MBEERE NORTH,Oct-14,7276,7288,14564
EMBU,MBEERE NORTH,15,1374,1291,2665
EMBU,MBEERE NORTH,16,1361,1411,2772
EMBU,MBEERE NORTH,17,1438,1237,2675
EMBU,MBEERE NORTH,18,1089,1026,2115
EMBU,MBEERE NORTH,19,1124,1043,2167
EMBU,MBEERE NORTH,15-19,6386,6008,12394
EMBU,MBEERE NORTH,20,1061,1012,2073
EMBU,MBEERE NORTH,21,849,880,1729
EMBU,MBEERE NORTH,22,799,874,1673
EMBU,MBEERE NORTH,23,815,956,1771
EMBU,MBEERE NORTH,24,781,758,1539
EMBU,MBEERE NORTH,20-24,4305,4480,8785
EMBU,MBEERE NORTH,25,876,858,1734
EMBU,MBEERE NORTH,26,726,718,1444
EMBU,MBEERE NORTH,27,784,783,1567
EMBU,MBEERE NORTH,28,702,712,1414
EMBU,MBEERE NORTH,29,814,744,1558
EMBU,MBEERE NORTH,25-29,3902,3815,7717
EMBU,MBEERE NORTH,30,916,985,1901
EMBU,MBEERE NORTH,31,697,639,1336
EMBU,MBEERE NORTH,32,793,876,1669
EMBU,MBEERE NORTH,33,758,800,1558
EMBU,MBEERE NORTH,34,573,647,1220
EMBU,MBEERE NORTH,30-34,3737,3947,7684
EMBU,MBEERE NORTH,35,896,878,1774
EMBU,MBEERE NORTH,36,593,629,1222
EMBU,MBEERE NORTH,37,712,627,1339
EMBU,MBEERE NORTH,38,514,566,1080
EMBU,MBEERE NORTH,39,591,637,1228
EMBU,MBEERE NORTH,35-39,3306,3337,6643
EMBU,MBEERE NORTH,40,719,664,1383
EMBU,MBEERE NORTH,41,640,573,1213
EMBU,MBEERE NORTH,42,537,520,1057
EMBU,MBEERE NORTH,43,491,557,1048
EMBU,MBEERE NORTH,44,459,518,977
EMBU,MBEERE NORTH,40-44,2846,2832,5678
EMBU,MBEERE NORTH,45,617,636,1253
EMBU,MBEERE NORTH,46,464,493,957
EMBU,MBEERE NORTH,47,447,451,898
EMBU,MBEERE NORTH,48,344,334,678
EMBU,MBEERE NORTH,49,392,398,790
EMBU,MBEERE NORTH,45-49,2264,2312,4576
EMBU,MBEERE NORTH,50,410,505,915
EMBU,MBEERE NORTH,51,336,371,707
EMBU,MBEERE NORTH,52,318,353,671
EMBU,MBEERE NORTH,53,275,352,627
EMBU,MBEERE NORTH,54,304,319,623
EMBU,MBEERE NORTH,50-54,1643,1900,3543
EMBU,MBEERE NORTH,55,358,383,741
EMBU,MBEERE NORTH,56,410,436,846
EMBU,MBEERE NORTH,57,282,382,664
EMBU,MBEERE NORTH,58,232,289,521
EMBU,MBEERE NORTH,59,248,337,585
EMBU,MBEERE NORTH,55-59,1530,1827,3357
EMBU,MBEERE NORTH,60,321,355,676
EMBU,MBEERE NORTH,61,268,288,556
EMBU,MBEERE NORTH,62,199,214,413
EMBU,MBEERE NORTH,63,181,281,462
EMBU,MBEERE NORTH,64,156,195,351
EMBU,MBEERE NORTH,60-64,1125,1333,2458
EMBU,MBEERE NORTH,65,281,358,639
EMBU,MBEERE NORTH,66,183,156,339
EMBU,MBEERE NORTH,67,288,276,564
EMBU,MBEERE NORTH,68,112,123,235
EMBU,MBEERE NORTH,69,164,255,419
EMBU,MBEERE NORTH,65-69,1028,1168,2196
EMBU,MBEERE NORTH,70,207,391,598
EMBU,MBEERE NORTH,71,157,198,355
EMBU,MBEERE NORTH,72,112,166,278
EMBU,MBEERE NORTH,73,105,129,234
EMBU,MBEERE NORTH,74,110,178,288
EMBU,MBEERE NORTH,70-74,691,1062,1753
EMBU,MBEERE NORTH,75,98,159,257
EMBU,MBEERE NORTH,76,61,72,133
EMBU,MBEERE NORTH,77,70,98,168
EMBU,MBEERE NORTH,78,75,60,135
EMBU,MBEERE NORTH,79,68,178,246
EMBU,MBEERE NORTH,75-79,372,567,939
EMBU,MBEERE NORTH,80,111,188,299
EMBU,MBEERE NORTH,81,48,130,178
EMBU,MBEERE NORTH,82,53,53,106
EMBU,MBEERE NORTH,83,38,60,98
EMBU,MBEERE NORTH,84,61,89,150
EMBU,MBEERE NORTH,80-84,311,520,831
EMBU,MBEERE NORTH,85,46,53,99
EMBU,MBEERE NORTH,86,23,28,51
EMBU,MBEERE NORTH,87,42,47,89
EMBU,MBEERE NORTH,88,15,28,43
EMBU,MBEERE NORTH,89,64,137,201
EMBU,MBEERE NORTH,85-89,190,293,483
EMBU,MBEERE NORTH,90,28,84,112
EMBU,MBEERE NORTH,91,13,36,49
EMBU,MBEERE NORTH,92,10,11,21
EMBU,MBEERE NORTH,93,5,27,32
EMBU,MBEERE NORTH,94,14,28,42
EMBU,MBEERE NORTH,90-94,70,186,256
EMBU,MBEERE NORTH,95,25,28,53
EMBU,MBEERE NORTH,96,6,20,26
EMBU,MBEERE NORTH,97,11,7,18
EMBU,MBEERE NORTH,98,6,8,14
EMBU,MBEERE NORTH,99,15,45,60
EMBU,MBEERE NORTH,95-99,63,108,171
EMBU,MBEERE NORTH,100+,22,52,74
EMBU,MBEERE NORTH,Not Stated,2,-,2
EMBU,MT. KENYA FOREST,Total,19,3,22
EMBU,MT. KENYA FOREST,0,-,-,-
EMBU,MT. KENYA FOREST,1,-,-,-
EMBU,MT. KENYA FOREST,2,1,-,1
EMBU,MT. KENYA FOREST,3,-,-,-
EMBU,MT. KENYA FOREST,4,-,-,-
EMBU,MT. KENYA FOREST,0 - 4,1,-,1
EMBU,MT. KENYA FOREST,5,-,-,-
EMBU,MT. KENYA FOREST,6,-,-,-
EMBU,MT. KENYA FOREST,7,-,-,-
EMBU,MT. KENYA FOREST,8,-,-,-
EMBU,MT. KENYA FOREST,9,-,-,-
EMBU,MT. KENYA FOREST,05-Sep,-,-,-
EMBU,MT. KENYA FOREST,10,-,-,-
EMBU,MT. KENYA FOREST,11,-,-,-
EMBU,MT. KENYA FOREST,12,-,-,-
EMBU,MT. KENYA FOREST,13,-,-,-
EMBU,MT. KENYA FOREST,14,-,-,-
EMBU,MT. KENYA FOREST,Oct-14,-,-,-
EMBU,MT. KENYA FOREST,15,-,-,-
EMBU,MT. KENYA FOREST,16,-,-,-
EMBU,MT. KENYA FOREST,17,-,-,-
EMBU,MT. KENYA FOREST,18,-,-,-
EMBU,MT. KENYA FOREST,19,-,-,-
EMBU,MT. KENYA FOREST,15-19,-,-,-
EMBU,MT. KENYA FOREST,20,-,-,-
EMBU,MT. KENYA FOREST,21,-,-,-
EMBU,MT. KENYA FOREST,22,-,-,-
EMBU,MT. KENYA FOREST,23,-,-,-
EMBU,MT. KENYA FOREST,24,-,-,-
EMBU,MT. KENYA FOREST,20-24,-,-,-
EMBU,MT. KENYA FOREST,25,-,1,1
EMBU,MT. KENYA FOREST,26,-,1,1
EMBU,MT. KENYA FOREST,27,3,-,3
EMBU,MT. KENYA FOREST,28,2,-,2
EMBU,MT. KENYA FOREST,29,1,-,1
EMBU,MT. KENYA FOREST,25-29,6,2,8
EMBU,MT. KENYA FOREST,30,-,-,-
EMBU,MT. KENYA FOREST,31,1,-,1
EMBU,MT. KENYA FOREST,32,-,1,1
EMBU,MT. KENYA FOREST,33,-,-,-
EMBU,MT. KENYA FOREST,34,-,-,-
EMBU,MT. KENYA FOREST,30-34,1,1,2
EMBU,MT. KENYA FOREST,35,1,-,1
EMBU,MT. KENYA FOREST,36,-,-,-
EMBU,MT. KENYA FOREST,37,2,-,2
EMBU,MT. KENYA FOREST,38,1,-,1
EMBU,MT. KENYA FOREST,39,1,-,1
EMBU,MT. KENYA FOREST,35-39,5,-,5
EMBU,MT. KENYA FOREST,40,1,-,1
EMBU,MT. KENYA FOREST,41,-,-,-
EMBU,MT. KENYA FOREST,42,-,-,-
EMBU,MT. KENYA FOREST,43,1,-,1
EMBU,MT. KENYA FOREST,44,-,-,-
EMBU,MT. KENYA FOREST,40-44,2,-,2
EMBU,MT. KENYA FOREST,45,-,-,-
EMBU,MT. KENYA FOREST,46,-,-,-
EMBU,MT. KENYA FOREST,47,-,-,-
EMBU,MT. KENYA FOREST,48,1,-,1
EMBU,MT. KENYA FOREST,49,1,-,1
EMBU,MT. KENYA FOREST,45-49,2,-,2
EMBU,MT. KENYA FOREST,50,-,-,-
EMBU,MT. KENYA FOREST,51,-,-,-
EMBU,MT. KENYA FOREST,52,-,-,-
EMBU,MT. KENYA FOREST,53,-,-,-
EMBU,MT. KENYA FOREST,54,-,-,-
EMBU,MT. KENYA FOREST,50-54,-,-,-
EMBU,MT. KENYA FOREST,55,-,-,-
EMBU,MT. KENYA FOREST,56,1,-,1
EMBU,MT. KENYA FOREST,57,-,-,-
EMBU,MT. KENYA FOREST,58,1,-,1
EMBU,MT. KENYA FOREST,59,-,-,-
EMBU,MT. KENYA FOREST,55-59,2,-,2
EMBU,MT. KENYA FOREST,60,-,-,-
EMBU,MT. KENYA FOREST,61,-,-,-
EMBU,MT. KENYA FOREST,62,-,-,-
EMBU,MT. KENYA FOREST,63,-,-,-
EMBU,MT. KENYA FOREST,64,-,-,-
EMBU,MT. KENYA FOREST,60-64,-,-,-
EMBU,MT. KENYA FOREST,65,-,-,-
EMBU,MT. KENYA FOREST,66,-,-,-
EMBU,MT. KENYA FOREST,67,-,-,-
EMBU,MT. KENYA FOREST,68,-,-,-
EMBU,MT. KENYA FOREST,69,-,-,-
EMBU,MT. KENYA FOREST,65-69,-,-,-
EMBU,MT. KENYA FOREST,70,-,-,-
EMBU,MT. KENYA FOREST,71,-,-,-
EMBU,MT. KENYA FOREST,72,-,-,-
EMBU,MT. KENYA FOREST,73,-,-,-
EMBU,MT. KENYA FOREST,74,-,-,-
EMBU,MT. KENYA FOREST,70-74,-,-,-
EMBU,MT. KENYA FOREST,75,-,-,-
EMBU,MT. KENYA FOREST,76,-,-,-
EMBU,MT. KENYA FOREST,77,-,-,-
EMBU,MT. KENYA FOREST,78,-,-,-
EMBU,MT. KENYA FOREST,79,-,-,-
EMBU,MT. KENYA FOREST,75-79,-,-,-
EMBU,MT. KENYA FOREST,80,-,-,-
EMBU,MT. KENYA FOREST,81,-,-,-
EMBU,MT. KENYA FOREST,82,-,-,-
EMBU,MT. KENYA FOREST,83,-,-,-
EMBU,MT. KENYA FOREST,84,-,-,-
EMBU,MT. KENYA FOREST,80-84,-,-,-
EMBU,MT. KENYA FOREST,85,-,-,-
EMBU,MT. KENYA FOREST,86,-,-,-
EMBU,MT. KENYA FOREST,87,-,-,-
EMBU,MT. KENYA FOREST,88,-,-,-
EMBU,MT. KENYA FOREST,89,-,-,-
EMBU,MT. KENYA FOREST,85-89,-,-,-
EMBU,MT. KENYA FOREST,90,-,-,-
EMBU,MT. KENYA FOREST,91,-,-,-
EMBU,MT. KENYA FOREST,92,-,-,-
EMBU,MT. KENYA FOREST,93,-,-,-
EMBU,MT. KENYA FOREST,94,-,-,-
EMBU,MT. KENYA FOREST,90-94,-,-,-
EMBU,MT. KENYA FOREST,95,-,-,-
EMBU,MT. KENYA FOREST,96,-,-,-
EMBU,MT. KENYA FOREST,97,-,-,-
EMBU,MT. KENYA FOREST,98,-,-,-
EMBU,MT. KENYA FOREST,99,-,-,-
EMBU,MT. KENYA FOREST,95-99,-,-,-
EMBU,MT. KENYA FOREST,100+,-,-,-
EMBU,MT. KENYA FOREST,Not Stated,-,-,-
GARISSA,ALL,Total,458975,382344,841319
GARISSA,ALL,0,6185,6242,12427
GARISSA,ALL,1,8506,8323,16829
GARISSA,ALL,2,14351,13897,28248
GARISSA,ALL,3,12780,12173,24953
GARISSA,ALL,4,15204,13955,29159
GARISSA,ALL,0 - 4,57026,54590,111616
GARISSA,ALL,5,14020,12877,26897
GARISSA,ALL,6,15676,14411,30087
GARISSA,ALL,7,11774,10584,22358
GARISSA,ALL,8,17657,15572,33229
GARISSA,ALL,9,11900,10745,22645
GARISSA,ALL,05-Sep,71027,64189,135216
GARISSA,ALL,10,22359,18002,40361
GARISSA,ALL,11,10025,9570,19595
GARISSA,ALL,12,18139,11715,29854
GARISSA,ALL,13,12830,8902,21732
GARISSA,ALL,14,15381,9740,25121
GARISSA,ALL,Oct-14,78734,57929,136663
GARISSA,ALL,15,18683,11661,30344
GARISSA,ALL,16,14577,9264,23841
GARISSA,ALL,17,13681,9001,22682
GARISSA,ALL,18,14795,10404,25199
GARISSA,ALL,19,8839,7190,16029
GARISSA,ALL,15-19,70575,47520,118095
GARISSA,ALL,20,18115,14578,32693
GARISSA,ALL,21,6924,5785,12709
GARISSA,ALL,22,8090,7193,15283
GARISSA,ALL,23,6991,5982,12973
GARISSA,ALL,24,6051,5364,11415
GARISSA,ALL,20-24,46171,38902,85073
GARISSA,ALL,25,11781,10875,22656
GARISSA,ALL,26,5408,4836,10244
GARISSA,ALL,27,4740,4174,8914
GARISSA,ALL,28,6293,6280,12573
GARISSA,ALL,29,4554,4327,8881
GARISSA,ALL,25-29,32776,30492,63268
GARISSA,ALL,30,13086,12429,25515
GARISSA,ALL,31,3183,3138,6321
GARISSA,ALL,32,4630,4589,9219
GARISSA,ALL,33,3044,2997,6041
GARISSA,ALL,34,2735,2678,5413
GARISSA,ALL,30-34,26678,25831,52509
GARISSA,ALL,35,7043,7163,14206
GARISSA,ALL,36,2888,3062,5950
GARISSA,ALL,37,2342,2488,4830
GARISSA,ALL,38,3412,3574,6986
GARISSA,ALL,39,2367,2343,4710
GARISSA,ALL,35-39,18052,18630,36682
GARISSA,ALL,40,9731,7476,17207
GARISSA,ALL,41,2222,2261,4483
GARISSA,ALL,42,2639,2164,4803
GARISSA,ALL,43,1990,1837,3827
GARISSA,ALL,44,1143,910,2053
GARISSA,ALL,40-44,17725,14648,32373
GARISSA,ALL,45,5187,3904,9091
GARISSA,ALL,46,1400,1141,2541
GARISSA,ALL,47,1329,1041,2370
GARISSA,ALL,48,1668,1292,2960
GARISSA,ALL,49,1241,1079,2320
GARISSA,ALL,45-49,10825,8457,19282
GARISSA,ALL,50,5838,3934,9772
GARISSA,ALL,51,903,668,1571
GARISSA,ALL,52,1619,1156,2775
GARISSA,ALL,53,810,572,1382
GARISSA,ALL,54,1110,782,1892
GARISSA,ALL,50-54,10280,7112,17392
GARISSA,ALL,55,1591,1142,2733
GARISSA,ALL,56,1036,789,1825
GARISSA,ALL,57,765,617,1382
GARISSA,ALL,58,988,718,1706
GARISSA,ALL,59,959,738,1697
GARISSA,ALL,55-59,5339,4004,9343
GARISSA,ALL,60,3210,2266,5476
GARISSA,ALL,61,670,440,1110
GARISSA,ALL,62,691,391,1082
GARISSA,ALL,63,619,410,1029
GARISSA,ALL,64,443,280,723
GARISSA,ALL,60-64,5633,3787,9420
GARISSA,ALL,65,1041,767,1808
GARISSA,ALL,66,393,294,687
GARISSA,ALL,67,378,314,692
GARISSA,ALL,68,463,277,740
GARISSA,ALL,69,505,365,870
GARISSA,ALL,65-69,2780,2017,4797
GARISSA,ALL,70,1598,1175,2773
GARISSA,ALL,71,290,334,624
GARISSA,ALL,72,290,181,471
GARISSA,ALL,73,232,123,355
GARISSA,ALL,74,225,151,376
GARISSA,ALL,70-74,2635,1964,4599
GARISSA,ALL,75,358,261,619
GARISSA,ALL,76,170,100,270
GARISSA,ALL,77,113,86,199
GARISSA,ALL,78,189,113,302
GARISSA,ALL,79,203,115,318
GARISSA,ALL,75-79,1033,675,1708
GARISSA,ALL,80,654,606,1260
GARISSA,ALL,81,114,156,270
GARISSA,ALL,82,87,76,163
GARISSA,ALL,83,69,47,116
GARISSA,ALL,84,105,66,171
GARISSA,ALL,80-84,1029,951,1980
GARISSA,ALL,85,119,99,218
GARISSA,ALL,86,55,39,94
GARISSA,ALL,87,50,47,97
GARISSA,ALL,88,31,35,66
GARISSA,ALL,89,65,44,109
GARISSA,ALL,85-89,320,264,584
GARISSA,ALL,90,154,188,342
GARISSA,ALL,91,23,37,60
GARISSA,ALL,92,15,12,27
GARISSA,ALL,93,13,6,19
GARISSA,ALL,94,9,13,22
GARISSA,ALL,90-94,214,256,470
GARISSA,ALL,95,30,30,60
GARISSA,ALL,96,14,19,33
GARISSA,ALL,97,4,2,6
GARISSA,ALL,98,16,9,25
GARISSA,ALL,99,18,12,30
GARISSA,ALL,95-99,82,72,154
GARISSA,ALL,100+,37,53,90
GARISSA,ALL,Not Stated,4,1,5
GARISSA,BALAMBALA,Total,20277,11979,32256
GARISSA,BALAMBALA,0,52,47,99
GARISSA,BALAMBALA,1,144,141,285
GARISSA,BALAMBALA,2,306,244,550
GARISSA,BALAMBALA,3,272,243,515
GARISSA,BALAMBALA,4,429,289,718
GARISSA,BALAMBALA,0 - 4,1203,964,2167
GARISSA,BALAMBALA,5,377,282,659
GARISSA,BALAMBALA,6,514,400,914
GARISSA,BALAMBALA,7,366,287,653
GARISSA,BALAMBALA,8,634,480,1114
GARISSA,BALAMBALA,9,408,364,772
GARISSA,BALAMBALA,05-Sep,2299,1813,4112
GARISSA,BALAMBALA,10,979,581,1560
GARISSA,BALAMBALA,11,410,392,802
GARISSA,BALAMBALA,12,800,396,1196
GARISSA,BALAMBALA,13,552,269,821
GARISSA,BALAMBALA,14,782,340,1122
GARISSA,BALAMBALA,Oct-14,3523,1978,5501
GARISSA,BALAMBALA,15,795,328,1123
GARISSA,BALAMBALA,16,821,314,1135
GARISSA,BALAMBALA,17,536,231,767
GARISSA,BALAMBALA,18,989,430,1419
GARISSA,BALAMBALA,19,450,217,667
GARISSA,BALAMBALA,15-19,3591,1520,5111
GARISSA,BALAMBALA,20,1139,444,1583
GARISSA,BALAMBALA,21,484,162,646
GARISSA,BALAMBALA,22,585,240,825
GARISSA,BALAMBALA,23,484,206,690
GARISSA,BALAMBALA,24,467,178,645
GARISSA,BALAMBALA,20-24,3159,1230,4389
GARISSA,BALAMBALA,25,646,271,917
GARISSA,BALAMBALA,26,340,169,509
GARISSA,BALAMBALA,27,329,117,446
GARISSA,BALAMBALA,28,438,201,639
GARISSA,BALAMBALA,29,224,146,370
GARISSA,BALAMBALA,25-29,1977,904,2881
GARISSA,BALAMBALA,30,516,338,854
GARISSA,BALAMBALA,31,126,80,206
GARISSA,BALAMBALA,32,163,136,299
GARISSA,BALAMBALA,33,115,89,204
GARISSA,BALAMBALA,34,117,91,208
GARISSA,BALAMBALA,30-34,1037,734,1771
GARISSA,BALAMBALA,35,243,256,499
GARISSA,BALAMBALA,36,105,125,230
GARISSA,BALAMBALA,37,88,85,173
GARISSA,BALAMBALA,38,134,192,326
GARISSA,BALAMBALA,39,114,120,234
GARISSA,BALAMBALA,35-39,684,778,1462
GARISSA,BALAMBALA,40,401,411,812
GARISSA,BALAMBALA,41,63,68,131
GARISSA,BALAMBALA,42,153,118,271
GARISSA,BALAMBALA,43,67,83,150
GARISSA,BALAMBALA,44,57,42,99
GARISSA,BALAMBALA,40-44,741,722,1463
GARISSA,BALAMBALA,45,236,244,480
GARISSA,BALAMBALA,46,60,67,127
GARISSA,BALAMBALA,47,73,55,128
GARISSA,BALAMBALA,48,120,86,206
GARISSA,BALAMBALA,49,61,66,127
GARISSA,BALAMBALA,45-49,550,518,1068
GARISSA,BALAMBALA,50,361,209,570
GARISSA,BALAMBALA,51,32,21,53
GARISSA,BALAMBALA,52,87,45,132
GARISSA,BALAMBALA,53,32,26,58
GARISSA,BALAMBALA,54,66,33,99
GARISSA,BALAMBALA,50-54,578,334,912
GARISSA,BALAMBALA,55,72,72,144
GARISSA,BALAMBALA,56,39,21,60
GARISSA,BALAMBALA,57,54,18,72
GARISSA,BALAMBALA,58,52,38,90
GARISSA,BALAMBALA,59,34,26,60
GARISSA,BALAMBALA,55-59,251,175,426
GARISSA,BALAMBALA,60,199,103,302
GARISSA,BALAMBALA,61,22,8,30
GARISSA,BALAMBALA,62,29,14,43
GARISSA,BALAMBALA,63,22,9,31
GARISSA,BALAMBALA,64,18,13,31
GARISSA,BALAMBALA,60-64,290,147,437
GARISSA,BALAMBALA,65,64,30,94
GARISSA,BALAMBALA,66,29,9,38
GARISSA,BALAMBALA,67,19,9,28
GARISSA,BALAMBALA,68,23,13,36
GARISSA,BALAMBALA,69,27,11,38
GARISSA,BALAMBALA,65-69,162,72,234
GARISSA,BALAMBALA,70,100,23,123
GARISSA,BALAMBALA,71,11,4,15
GARISSA,BALAMBALA,72,16,6,22
GARISSA,BALAMBALA,73,6,3,9
GARISSA,BALAMBALA,74,5,3,8
GARISSA,BALAMBALA,70-74,138,39,177
GARISSA,BALAMBALA,75,14,3,17
GARISSA,BALAMBALA,76,8,3,11
GARISSA,BALAMBALA,77,8,3,11
GARISSA,BALAMBALA,78,10,8,18
GARISSA,BALAMBALA,79,8,1,9
GARISSA,BALAMBALA,75-79,48,18,66
GARISSA,BALAMBALA,80,30,20,50
GARISSA,BALAMBALA,81,1,2,3
GARISSA,BALAMBALA,82,2,5,7
GARISSA,BALAMBALA,83,-,-,-
GARISSA,BALAMBALA,84,4,-,4
GARISSA,BALAMBALA,80-84,37,27,64
GARISSA,BALAMBALA,85,-,3,3
GARISSA,BALAMBALA,86,-,1,1
GARISSA,BALAMBALA,87,-,1,1
GARISSA,BALAMBALA,88,2,-,2
GARISSA,BALAMBALA,89,-,-,-
GARISSA,BALAMBALA,85-89,2,5,7
GARISSA,BALAMBALA,90,6,1,7
GARISSA,BALAMBALA,91,-,-,-
GARISSA,BALAMBALA,92,-,-,-
GARISSA,BALAMBALA,93,-,-,-
GARISSA,BALAMBALA,94,-,-,-
GARISSA,BALAMBALA,90-94,6,1,7
GARISSA,BALAMBALA,95,-,-,-
GARISSA,BALAMBALA,96,-,-,-
GARISSA,BALAMBALA,97,-,-,-
GARISSA,BALAMBALA,98,-,-,-
GARISSA,BALAMBALA,99,-,-,-
GARISSA,BALAMBALA,95-99,-,-,-
GARISSA,BALAMBALA,100+,1,-,1
GARISSA,BALAMBALA,Not Stated,-,-,-
GARISSA,DADAAB,Total,99059,86185,185244
GARISSA,DADAAB,0,1212,1112,2324
GARISSA,DADAAB,1,1813,1659,3472
GARISSA,DADAAB,2,3112,2983,6095
GARISSA,DADAAB,3,2673,2555,5228
GARISSA,DADAAB,4,3258,2989,6247
GARISSA,DADAAB,0 - 4,12068,11298,23366
GARISSA,DADAAB,5,2809,2610,5419
GARISSA,DADAAB,6,3181,3079,6260
GARISSA,DADAAB,7,2260,2223,4483
GARISSA,DADAAB,8,3385,3228,6613
GARISSA,DADAAB,9,2281,2168,4449
GARISSA,DADAAB,05-Sep,13916,13308,27224
GARISSA,DADAAB,10,4404,3673,8077
GARISSA,DADAAB,11,1962,2044,4006
GARISSA,DADAAB,12,3577,2579,6156
GARISSA,DADAAB,13,2388,1841,4229
GARISSA,DADAAB,14,2981,2044,5025
GARISSA,DADAAB,Oct-14,15312,12181,27493
GARISSA,DADAAB,15,3603,2406,6009
GARISSA,DADAAB,16,2884,2055,4939
GARISSA,DADAAB,17,2274,1666,3940
GARISSA,DADAAB,18,3185,2451,5636
GARISSA,DADAAB,19,2111,1852,3963
GARISSA,DADAAB,15-19,14057,10430,24487
GARISSA,DADAAB,20,4303,3825,8128
GARISSA,DADAAB,21,1658,1374,3032
GARISSA,DADAAB,22,1823,1747,3570
GARISSA,DADAAB,23,1701,1395,3096
GARISSA,DADAAB,24,1343,1374,2717
GARISSA,DADAAB,20-24,10828,9715,20543
GARISSA,DADAAB,25,2625,2692,5317
GARISSA,DADAAB,26,1191,1143,2334
GARISSA,DADAAB,27,1068,929,1997
GARISSA,DADAAB,28,1478,1541,3019
GARISSA,DADAAB,29,1176,1107,2283
GARISSA,DADAAB,25-29,7538,7412,14950
GARISSA,DADAAB,30,3298,3021,6319
GARISSA,DADAAB,31,742,663,1405
GARISSA,DADAAB,32,1114,1068,2182
GARISSA,DADAAB,33,758,736,1494
GARISSA,DADAAB,34,604,674,1278
GARISSA,DADAAB,30-34,6516,6162,12678
GARISSA,DADAAB,35,1829,2034,3863
GARISSA,DADAAB,36,709,783,1492
GARISSA,DADAAB,37,511,568,1079
GARISSA,DADAAB,38,857,961,1818
GARISSA,DADAAB,39,566,616,1182
GARISSA,DADAAB,35-39,4472,4962,9434
GARISSA,DADAAB,40,2578,2023,4601
GARISSA,DADAAB,41,497,472,969
GARISSA,DADAAB,42,665,543,1208
GARISSA,DADAAB,43,468,375,843
GARISSA,DADAAB,44,262,279,541
GARISSA,DADAAB,40-44,4470,3692,8162
GARISSA,DADAAB,45,1372,947,2319
GARISSA,DADAAB,46,347,277,624
GARISSA,DADAAB,47,325,261,586
GARISSA,DADAAB,48,427,340,767
GARISSA,DADAAB,49,335,339,674
GARISSA,DADAAB,45-49,2806,2164,4970
GARISSA,DADAAB,50,1463,952,2415
GARISSA,DADAAB,51,212,166,378
GARISSA,DADAAB,52,406,283,689
GARISSA,DADAAB,53,223,128,351
GARISSA,DADAAB,54,253,188,441
GARISSA,DADAAB,50-54,2557,1717,4274
GARISSA,DADAAB,55,358,264,622
GARISSA,DADAAB,56,259,189,448
GARISSA,DADAAB,57,167,113,280
GARISSA,DADAAB,58,232,138,370
GARISSA,DADAAB,59,193,157,350
GARISSA,DADAAB,55-59,1209,861,2070
GARISSA,DADAAB,60,775,514,1289
GARISSA,DADAAB,61,117,88,205
GARISSA,DADAAB,62,180,107,287
GARISSA,DADAAB,63,136,97,233
GARISSA,DADAAB,64,108,85,193
GARISSA,DADAAB,60-64,1316,891,2207
GARISSA,DADAAB,65,251,153,404
GARISSA,DADAAB,66,81,49,130
GARISSA,DADAAB,67,86,52,138
GARISSA,DADAAB,68,102,61,163
GARISSA,DADAAB,69,99,77,176
GARISSA,DADAAB,65-69,619,392,1011
GARISSA,DADAAB,70,430,276,706
GARISSA,DADAAB,71,63,47,110
GARISSA,DADAAB,72,84,45,129
GARISSA,DADAAB,73,53,28,81
GARISSA,DADAAB,74,67,33,100
GARISSA,DADAAB,70-74,697,429,1126
GARISSA,DADAAB,75,108,67,175
GARISSA,DADAAB,76,39,30,69
GARISSA,DADAAB,77,16,20,36
GARISSA,DADAAB,78,49,27,76
GARISSA,DADAAB,79,44,22,66
GARISSA,DADAAB,75-79,256,166,422
GARISSA,DADAAB,80,178,162,340
GARISSA,DADAAB,81,27,20,47
GARISSA,DADAAB,82,24,10,34
GARISSA,DADAAB,83,17,9,26
GARISSA,DADAAB,84,24,18,42
GARISSA,DADAAB,80-84,270,219,489
GARISSA,DADAAB,85,27,31,58
GARISSA,DADAAB,86,14,7,21
GARISSA,DADAAB,87,7,12,19
GARISSA,DADAAB,88,7,11,18
GARISSA,DADAAB,89,6,9,15
GARISSA,DADAAB,85-89,61,70,131
GARISSA,DADAAB,90,42,60,102
GARISSA,DADAAB,91,7,8,15
GARISSA,DADAAB,92,4,4,8
GARISSA,DADAAB,93,3,2,5
GARISSA,DADAAB,94,-,6,6
GARISSA,DADAAB,90-94,56,80,136
GARISSA,DADAAB,95,9,11,20
GARISSA,DADAAB,96,6,6,12
GARISSA,DADAAB,97,1,1,2
GARISSA,DADAAB,98,3,2,5
GARISSA,DADAAB,99,5,2,7
GARISSA,DADAAB,95-99,24,22,46
GARISSA,DADAAB,100+,11,14,25
GARISSA,DADAAB,Not Stated,-,-,-
GARISSA,FAFI,Total,72617,61413,134030
GARISSA,FAFI,0,1113,1137,2250
GARISSA,FAFI,1,1459,1299,2758
GARISSA,FAFI,2,2329,2091,4420
GARISSA,FAFI,3,2104,1905,4009
GARISSA,FAFI,4,2425,2157,4582
GARISSA,FAFI,0 - 4,9430,8589,18019
GARISSA,FAFI,5,2186,2012,4198
GARISSA,FAFI,6,2315,2113,4428
GARISSA,FAFI,7,1782,1596,3378
GARISSA,FAFI,8,2734,2355,5089
GARISSA,FAFI,9,1899,1579,3478
GARISSA,FAFI,05-Sep,10916,9655,20571
GARISSA,FAFI,10,3408,2905,6313
GARISSA,FAFI,11,1461,1316,2777
GARISSA,FAFI,12,2647,1949,4596
GARISSA,FAFI,13,1884,1531,3415
GARISSA,FAFI,14,2367,1632,3999
GARISSA,FAFI,Oct-14,11767,9333,21100
GARISSA,FAFI,15,2866,2094,4960
GARISSA,FAFI,16,2145,1525,3670
GARISSA,FAFI,17,2065,1473,3538
GARISSA,FAFI,18,2689,1952,4641
GARISSA,FAFI,19,1618,1308,2926
GARISSA,FAFI,15-19,11383,8352,19735
GARISSA,FAFI,20,3303,2749,6052
GARISSA,FAFI,21,1123,858,1981
GARISSA,FAFI,22,1240,1039,2279
GARISSA,FAFI,23,1014,845,1859
GARISSA,FAFI,24,852,714,1566
GARISSA,FAFI,20-24,7532,6205,13737
GARISSA,FAFI,25,2059,1881,3940
GARISSA,FAFI,26,828,716,1544
GARISSA,FAFI,27,675,562,1237
GARISSA,FAFI,28,970,1027,1997
GARISSA,FAFI,29,659,629,1288
GARISSA,FAFI,25-29,5191,4815,10006
GARISSA,FAFI,30,2163,2277,4440
GARISSA,FAFI,31,371,357,728
GARISSA,FAFI,32,743,815,1558
GARISSA,FAFI,33,354,404,758
GARISSA,FAFI,34,370,354,724
GARISSA,FAFI,30-34,4001,4207,8208
GARISSA,FAFI,35,1163,1295,2458
GARISSA,FAFI,36,413,456,869
GARISSA,FAFI,37,324,362,686
GARISSA,FAFI,38,538,666,1204
GARISSA,FAFI,39,301,327,628
GARISSA,FAFI,35-39,2739,3106,5845
GARISSA,FAFI,40,1909,1518,3427
GARISSA,FAFI,41,311,222,533
GARISSA,FAFI,42,460,352,812
GARISSA,FAFI,43,241,252,493
GARISSA,FAFI,44,172,118,290
GARISSA,FAFI,40-44,3093,2462,5555
GARISSA,FAFI,45,934,647,1581
GARISSA,FAFI,46,186,159,345
GARISSA,FAFI,47,164,144,308
GARISSA,FAFI,48,276,236,512
GARISSA,FAFI,49,167,141,308
GARISSA,FAFI,45-49,1727,1327,3054
GARISSA,FAFI,50,1145,771,1916
GARISSA,FAFI,51,139,88,227
GARISSA,FAFI,52,275,167,442
GARISSA,FAFI,53,125,97,222
GARISSA,FAFI,54,160,120,280
GARISSA,FAFI,50-54,1844,1243,3087
GARISSA,FAFI,55,268,220,488
GARISSA,FAFI,56,157,125,282
GARISSA,FAFI,57,110,75,185
GARISSA,FAFI,58,164,110,274
GARISSA,FAFI,59,109,77,186
GARISSA,FAFI,55-59,808,607,1415
GARISSA,FAFI,60,621,416,1037
GARISSA,FAFI,61,90,53,143
GARISSA,FAFI,62,105,55,160
GARISSA,FAFI,63,81,55,136
GARISSA,FAFI,64,71,30,101
GARISSA,FAFI,60-64,968,609,1577
GARISSA,FAFI,65,168,138,306
GARISSA,FAFI,66,54,31,85
GARISSA,FAFI,67,70,48,118
GARISSA,FAFI,68,62,42,104
GARISSA,FAFI,69,54,24,78
GARISSA,FAFI,65-69,408,283,691
GARISSA,FAFI,70,260,209,469
GARISSA,FAFI,71,27,25,52
GARISSA,FAFI,72,35,23,58
GARISSA,FAFI,73,40,20,60
GARISSA,FAFI,74,25,22,47
GARISSA,FAFI,70-74,387,299,686
GARISSA,FAFI,75,58,53,111
GARISSA,FAFI,76,22,11,33
GARISSA,FAFI,77,15,10,25
GARISSA,FAFI,78,28,15,43
GARISSA,FAFI,79,24,8,32
GARISSA,FAFI,75-79,147,97,244
GARISSA,FAFI,80,106,88,194
GARISSA,FAFI,81,17,8,25
GARISSA,FAFI,82,16,10,26
GARISSA,FAFI,83,9,11,20
GARISSA,FAFI,84,15,9,24
GARISSA,FAFI,80-84,163,126,289
GARISSA,FAFI,85,22,22,44
GARISSA,FAFI,86,8,8,16
GARISSA,FAFI,87,4,6,10
GARISSA,FAFI,88,4,3,7
GARISSA,FAFI,89,12,5,17
GARISSA,FAFI,85-89,50,44,94
GARISSA,FAFI,90,31,28,59
GARISSA,FAFI,91,1,2,3
GARISSA,FAFI,92,2,3,5
GARISSA,FAFI,93,3,2,5
GARISSA,FAFI,94,1,1,2
GARISSA,FAFI,90-94,38,36,74
GARISSA,FAFI,95,6,4,10
GARISSA,FAFI,96,2,1,3
GARISSA,FAFI,97,2,1,3
GARISSA,FAFI,98,3,2,5
GARISSA,FAFI,99,3,1,4
GARISSA,FAFI,95-99,16,9,25
GARISSA,FAFI,100+,9,9,18
GARISSA,FAFI,Not Stated,-,-,-
GARISSA,GARISSA,Total,83460,80449,163909
GARISSA,GARISSA,0,1799,1742,3541
GARISSA,GARISSA,1,2073,2019,4092
GARISSA,GARISSA,2,2744,2688,5432
GARISSA,GARISSA,3,2547,2455,5002
GARISSA,GARISSA,4,2657,2471,5128
GARISSA,GARISSA,0 - 4,11820,11375,23195
GARISSA,GARISSA,5,2532,2487,5019
GARISSA,GARISSA,6,2661,2570,5231
GARISSA,GARISSA,7,2344,2201,4545
GARISSA,GARISSA,8,2835,2645,5480
GARISSA,GARISSA,9,2230,2228,4458
GARISSA,GARISSA,05-Sep,12602,12131,24733
GARISSA,GARISSA,10,3229,2847,6076
GARISSA,GARISSA,11,2007,1880,3887
GARISSA,GARISSA,12,2803,2303,5106
GARISSA,GARISSA,13,2419,2055,4474
GARISSA,GARISSA,14,2486,2132,4618
GARISSA,GARISSA,Oct-14,12944,11217,24161
GARISSA,GARISSA,15,2722,2256,4978
GARISSA,GARISSA,16,2373,1936,4309
GARISSA,GARISSA,17,2405,2043,4448
GARISSA,GARISSA,18,2083,1943,4026
GARISSA,GARISSA,19,1676,1698,3374
GARISSA,GARISSA,15-19,11259,9876,21135
GARISSA,GARISSA,20,2356,2393,4749
GARISSA,GARISSA,21,1326,1462,2788
GARISSA,GARISSA,22,1604,1835,3439
GARISSA,GARISSA,23,1380,1496,2876
GARISSA,GARISSA,24,1201,1325,2526
GARISSA,GARISSA,20-24,7867,8511,16378
GARISSA,GARISSA,25,2149,2378,4527
GARISSA,GARISSA,26,1169,1256,2425
GARISSA,GARISSA,27,1055,1196,2251
GARISSA,GARISSA,28,1116,1349,2465
GARISSA,GARISSA,29,839,864,1703
GARISSA,GARISSA,25-29,6328,7043,13371
GARISSA,GARISSA,30,2263,2386,4649
GARISSA,GARISSA,31,711,882,1593
GARISSA,GARISSA,32,1077,1127,2204
GARISSA,GARISSA,33,758,765,1523
GARISSA,GARISSA,34,651,696,1347
GARISSA,GARISSA,30-34,5460,5856,11316
GARISSA,GARISSA,35,1394,1358,2752
GARISSA,GARISSA,36,594,672,1266
GARISSA,GARISSA,37,558,568,1126
GARISSA,GARISSA,38,618,583,1201
GARISSA,GARISSA,39,432,399,831
GARISSA,GARISSA,35-39,3596,3580,7176
GARISSA,GARISSA,40,1517,1154,2671
GARISSA,GARISSA,41,552,702,1254
GARISSA,GARISSA,42,534,499,1033
GARISSA,GARISSA,43,479,489,968
GARISSA,GARISSA,44,271,228,499
GARISSA,GARISSA,40-44,3353,3072,6425
GARISSA,GARISSA,45,947,852,1799
GARISSA,GARISSA,46,319,268,587
GARISSA,GARISSA,47,330,333,663
GARISSA,GARISSA,48,270,238,508
GARISSA,GARISSA,49,232,210,442
GARISSA,GARISSA,45-49,2098,1901,3999
GARISSA,GARISSA,50,875,745,1620
GARISSA,GARISSA,51,218,200,418
GARISSA,GARISSA,52,292,257,549
GARISSA,GARISSA,53,188,173,361
GARISSA,GARISSA,54,236,173,409
GARISSA,GARISSA,50-54,1809,1548,3357
GARISSA,GARISSA,55,381,292,673
GARISSA,GARISSA,56,248,226,474
GARISSA,GARISSA,57,214,209,423
GARISSA,GARISSA,58,236,190,426
GARISSA,GARISSA,59,232,223,455
GARISSA,GARISSA,55-59,1311,1140,2451
GARISSA,GARISSA,60,550,552,1102
GARISSA,GARISSA,61,185,163,348
GARISSA,GARISSA,62,163,110,273
GARISSA,GARISSA,63,151,128,279
GARISSA,GARISSA,64,122,72,194
GARISSA,GARISSA,60-64,1171,1025,2196
GARISSA,GARISSA,65,231,215,446
GARISSA,GARISSA,66,101,123,224
GARISSA,GARISSA,67,101,113,214
GARISSA,GARISSA,68,94,74,168
GARISSA,GARISSA,69,118,110,228
GARISSA,GARISSA,65-69,645,635,1280
GARISSA,GARISSA,70,318,401,719
GARISSA,GARISSA,71,69,130,199
GARISSA,GARISSA,72,57,63,120
GARISSA,GARISSA,73,56,45,101
GARISSA,GARISSA,74,55,56,111
GARISSA,GARISSA,70-74,555,695,1250
GARISSA,GARISSA,75,73,93,166
GARISSA,GARISSA,76,43,31,74
GARISSA,GARISSA,77,39,30,69
GARISSA,GARISSA,78,40,32,72
GARISSA,GARISSA,79,42,45,87
GARISSA,GARISSA,75-79,237,231,468
GARISSA,GARISSA,80,136,227,363
GARISSA,GARISSA,81,22,71,93
GARISSA,GARISSA,82,19,30,49
GARISSA,GARISSA,83,13,16,29
GARISSA,GARISSA,84,23,26,49
GARISSA,GARISSA,80-84,213,370,583
GARISSA,GARISSA,85,32,31,63
GARISSA,GARISSA,86,15,14,29
GARISSA,GARISSA,87,17,19,36
GARISSA,GARISSA,88,9,12,21
GARISSA,GARISSA,89,19,17,36
GARISSA,GARISSA,85-89,92,93,185
GARISSA,GARISSA,90,43,73,116
GARISSA,GARISSA,91,3,15,18
GARISSA,GARISSA,92,7,3,10
GARISSA,GARISSA,93,4,1,5
GARISSA,GARISSA,94,6,5,11
GARISSA,GARISSA,90-94,63,97,160
GARISSA,GARISSA,95,10,13,23
GARISSA,GARISSA,96,3,9,12
GARISSA,GARISSA,97,1,-,1
GARISSA,GARISSA,98,5,2,7
GARISSA,GARISSA,99,5,6,11
GARISSA,GARISSA,95-99,24,30,54
GARISSA,GARISSA,100+,10,23,33
GARISSA,GARISSA,Not Stated,3,-,3
GARISSA,HULUGHO,Total,78081,55898,133979
GARISSA,HULUGHO,0,798,851,1649
GARISSA,HULUGHO,1,1150,1231,2381
GARISSA,HULUGHO,2,2520,2249,4769
GARISSA,HULUGHO,3,2158,1997,4155
GARISSA,HULUGHO,4,2780,2344,5124
GARISSA,HULUGHO,0 - 4,9406,8672,18078
GARISSA,HULUGHO,5,2631,2106,4737
GARISSA,HULUGHO,6,3097,2420,5517
GARISSA,HULUGHO,7,2157,1635,3792
GARISSA,HULUGHO,8,3644,2752,6396
GARISSA,HULUGHO,9,2252,1718,3970
GARISSA,HULUGHO,05-Sep,13781,10631,24412
GARISSA,HULUGHO,10,4575,3078,7653
GARISSA,HULUGHO,11,1748,1437,3185
GARISSA,HULUGHO,12,3417,1564,4981
GARISSA,HULUGHO,13,2371,1177,3548
GARISSA,HULUGHO,14,2806,1290,4096
GARISSA,HULUGHO,Oct-14,14917,8546,23463
GARISSA,HULUGHO,15,3773,1790,5563
GARISSA,HULUGHO,16,2597,1254,3851
GARISSA,HULUGHO,17,2557,1375,3932
GARISSA,HULUGHO,18,2522,1482,4004
GARISSA,HULUGHO,19,1241,855,2096
GARISSA,HULUGHO,15-19,12690,6756,19446
GARISSA,HULUGHO,20,3069,2110,5179
GARISSA,HULUGHO,21,958,755,1713
GARISSA,HULUGHO,22,1128,877,2005
GARISSA,HULUGHO,23,976,819,1795
GARISSA,HULUGHO,24,929,782,1711
GARISSA,HULUGHO,20-24,7060,5343,12403
GARISSA,HULUGHO,25,1802,1451,3253
GARISSA,HULUGHO,26,831,675,1506
GARISSA,HULUGHO,27,567,521,1088
GARISSA,HULUGHO,28,1009,1013,2022
GARISSA,HULUGHO,29,687,683,1370
GARISSA,HULUGHO,25-29,4896,4343,9239
GARISSA,HULUGHO,30,2279,1981,4260
GARISSA,HULUGHO,31,588,462,1050
GARISSA,HULUGHO,32,681,622,1303
GARISSA,HULUGHO,33,435,422,857
GARISSA,HULUGHO,34,454,389,843
GARISSA,HULUGHO,30-34,4437,3876,8313
GARISSA,HULUGHO,35,1056,942,1998
GARISSA,HULUGHO,36,465,455,920
GARISSA,HULUGHO,37,373,369,742
GARISSA,HULUGHO,38,602,507,1109
GARISSA,HULUGHO,39,383,386,769
GARISSA,HULUGHO,35-39,2879,2659,5538
GARISSA,HULUGHO,40,1485,974,2459
GARISSA,HULUGHO,41,334,314,648
GARISSA,HULUGHO,42,326,223,549
GARISSA,HULUGHO,43,268,235,503
GARISSA,HULUGHO,44,156,86,242
GARISSA,HULUGHO,40-44,2569,1832,4401
GARISSA,HULUGHO,45,681,408,1089
GARISSA,HULUGHO,46,186,138,324
GARISSA,HULUGHO,47,164,91,255
GARISSA,HULUGHO,48,232,161,393
GARISSA,HULUGHO,49,187,109,296
GARISSA,HULUGHO,45-49,1450,907,2357
GARISSA,HULUGHO,50,859,532,1391
GARISSA,HULUGHO,51,135,88,223
GARISSA,HULUGHO,52,221,167,388
GARISSA,HULUGHO,53,96,44,140
GARISSA,HULUGHO,54,179,76,255
GARISSA,HULUGHO,50-54,1490,907,2397
GARISSA,HULUGHO,55,178,85,263
GARISSA,HULUGHO,56,109,82,191
GARISSA,HULUGHO,57,82,76,158
GARISSA,HULUGHO,58,128,94,222
GARISSA,HULUGHO,59,127,97,224
GARISSA,HULUGHO,55-59,624,434,1058
GARISSA,HULUGHO,60,573,336,909
GARISSA,HULUGHO,61,98,37,135
GARISSA,HULUGHO,62,84,38,122
GARISSA,HULUGHO,63,87,57,144
GARISSA,HULUGHO,64,32,29,61
GARISSA,HULUGHO,60-64,874,497,1371
GARISSA,HULUGHO,65,128,64,192
GARISSA,HULUGHO,66,50,27,77
GARISSA,HULUGHO,67,38,28,66
GARISSA,HULUGHO,68,84,34,118
GARISSA,HULUGHO,69,69,52,121
GARISSA,HULUGHO,65-69,369,205,574
GARISSA,HULUGHO,70,212,98,310
GARISSA,HULUGHO,71,42,43,85
GARISSA,HULUGHO,72,34,14,48
GARISSA,HULUGHO,73,36,8,44
GARISSA,HULUGHO,74,24,11,35
GARISSA,HULUGHO,70-74,348,174,522
GARISSA,HULUGHO,75,35,9,44
GARISSA,HULUGHO,76,20,6,26
GARISSA,HULUGHO,77,15,1,16
GARISSA,HULUGHO,78,23,12,35
GARISSA,HULUGHO,79,35,11,46
GARISSA,HULUGHO,75-79,128,39,167
GARISSA,HULUGHO,80,87,25,112
GARISSA,HULUGHO,81,11,10,21
GARISSA,HULUGHO,82,8,4,12
GARISSA,HULUGHO,83,6,3,9
GARISSA,HULUGHO,84,6,5,11
GARISSA,HULUGHO,80-84,118,47,165
GARISSA,HULUGHO,85,9,4,13
GARISSA,HULUGHO,86,3,1,4
GARISSA,HULUGHO,87,5,2,7
GARISSA,HULUGHO,88,3,2,5
GARISSA,HULUGHO,89,9,2,11
GARISSA,HULUGHO,85-89,29,11,40
GARISSA,HULUGHO,90,4,5,9
GARISSA,HULUGHO,91,3,5,8
GARISSA,HULUGHO,92,-,2,2
GARISSA,HULUGHO,93,3,1,4
GARISSA,HULUGHO,94,1,-,1
GARISSA,HULUGHO,90-94,11,13,24
GARISSA,HULUGHO,95,2,-,2
GARISSA,HULUGHO,96,2,2,4
GARISSA,HULUGHO,97,-,-,-
GARISSA,HULUGHO,98,-,-,-
GARISSA,HULUGHO,99,-,1,1
GARISSA,HULUGHO,95-99,4,3,7
GARISSA,HULUGHO,100+,1,3,4
GARISSA,HULUGHO,Not Stated,-,-,-
GARISSA,IJARA,Total,80458,61129,141587
GARISSA,IJARA,0,1007,1042,2049
GARISSA,IJARA,1,1378,1427,2805
GARISSA,IJARA,2,2485,2513,4998
GARISSA,IJARA,3,2264,2082,4346
GARISSA,IJARA,4,2834,2569,5403
GARISSA,IJARA,0 - 4,9968,9633,19601
GARISSA,IJARA,5,2642,2397,5039
GARISSA,IJARA,6,2975,2715,5690
GARISSA,IJARA,7,2209,1864,4073
GARISSA,IJARA,8,3430,2969,6399
GARISSA,IJARA,9,2223,1993,4216
GARISSA,IJARA,05-Sep,13479,11938,25417
GARISSA,IJARA,10,4478,3622,8100
GARISSA,IJARA,11,1933,1899,3832
GARISSA,IJARA,12,3890,2127,6017
GARISSA,IJARA,13,2643,1465,4108
GARISSA,IJARA,14,3261,1647,4908
GARISSA,IJARA,Oct-14,16205,10760,26965
GARISSA,IJARA,15,3976,2062,6038
GARISSA,IJARA,16,3116,1593,4709
GARISSA,IJARA,17,3315,1807,5122
GARISSA,IJARA,18,2654,1551,4205
GARISSA,IJARA,19,1468,947,2415
GARISSA,IJARA,15-19,14529,7960,22489
GARISSA,IJARA,20,3085,2220,5305
GARISSA,IJARA,21,1100,867,1967
GARISSA,IJARA,22,1359,1036,2395
GARISSA,IJARA,23,1160,882,2042
GARISSA,IJARA,24,949,672,1621
GARISSA,IJARA,20-24,7653,5677,13330
GARISSA,IJARA,25,1889,1408,3297
GARISSA,IJARA,26,797,570,1367
GARISSA,IJARA,27,806,557,1363
GARISSA,IJARA,28,961,700,1661
GARISSA,IJARA,29,645,534,1179
GARISSA,IJARA,25-29,5098,3769,8867
GARISSA,IJARA,30,1785,1556,3341
GARISSA,IJARA,31,432,456,888
GARISSA,IJARA,32,581,551,1132
GARISSA,IJARA,33,447,411,858
GARISSA,IJARA,34,374,314,688
GARISSA,IJARA,30-34,3619,3288,6907
GARISSA,IJARA,35,886,747,1633
GARISSA,IJARA,36,385,344,729
GARISSA,IJARA,37,335,394,729
GARISSA,IJARA,38,404,372,776
GARISSA,IJARA,39,353,294,647
GARISSA,IJARA,35-39,2363,2151,4514
GARISSA,IJARA,40,1147,837,1984
GARISSA,IJARA,41,297,331,628
GARISSA,IJARA,42,317,271,588
GARISSA,IJARA,43,316,296,612
GARISSA,IJARA,44,142,97,239
GARISSA,IJARA,40-44,2219,1832,4051
GARISSA,IJARA,45,635,553,1188
GARISSA,IJARA,46,216,170,386
GARISSA,IJARA,47,175,108,283
GARISSA,IJARA,48,195,151,346
GARISSA,IJARA,49,152,143,295
GARISSA,IJARA,45-49,1373,1125,2498
GARISSA,IJARA,50,735,551,1286
GARISSA,IJARA,51,99,78,177
GARISSA,IJARA,52,240,189,429
GARISSA,IJARA,53,91,70,161
GARISSA,IJARA,54,151,152,303
GARISSA,IJARA,50-54,1316,1040,2356
GARISSA,IJARA,55,214,150,364
GARISSA,IJARA,56,139,110,249
GARISSA,IJARA,57,92,109,201
GARISSA,IJARA,58,110,108,218
GARISSA,IJARA,59,185,129,314
GARISSA,IJARA,55-59,740,606,1346
GARISSA,IJARA,60,311,262,573
GARISSA,IJARA,61,126,81,207
GARISSA,IJARA,62,87,50,137
GARISSA,IJARA,63,106,49,155
GARISSA,IJARA,64,66,41,107
GARISSA,IJARA,60-64,696,483,1179
GARISSA,IJARA,65,137,119,256
GARISSA,IJARA,66,65,45,110
GARISSA,IJARA,67,41,50,91
GARISSA,IJARA,68,64,37,101
GARISSA,IJARA,69,112,70,182
GARISSA,IJARA,65-69,419,321,740
GARISSA,IJARA,70,192,131,323
GARISSA,IJARA,71,63,66,129
GARISSA,IJARA,72,43,24,67
GARISSA,IJARA,73,30,16,46
GARISSA,IJARA,74,34,21,55
GARISSA,IJARA,70-74,362,258,620
GARISSA,IJARA,75,54,27,81
GARISSA,IJARA,76,27,16,43
GARISSA,IJARA,77,11,15,26
GARISSA,IJARA,78,15,13,28
GARISSA,IJARA,79,39,22,61
GARISSA,IJARA,75-79,146,93,239
GARISSA,IJARA,80,80,67,147
GARISSA,IJARA,81,27,37,64
GARISSA,IJARA,82,11,13,24
GARISSA,IJARA,83,21,7,28
GARISSA,IJARA,84,22,7,29
GARISSA,IJARA,80-84,161,131,292
GARISSA,IJARA,85,22,8,30
GARISSA,IJARA,86,12,6,18
GARISSA,IJARA,87,13,5,18
GARISSA,IJARA,88,1,4,5
GARISSA,IJARA,89,16,10,26
GARISSA,IJARA,85-89,64,33,97
GARISSA,IJARA,90,22,17,39
GARISSA,IJARA,91,9,3,12
GARISSA,IJARA,92,1,-,1
GARISSA,IJARA,93,-,-,-
GARISSA,IJARA,94,1,1,2
GARISSA,IJARA,90-94,33,21,54
GARISSA,IJARA,95,2,2,4
GARISSA,IJARA,96,-,1,1
GARISSA,IJARA,97,-,-,-
GARISSA,IJARA,98,4,2,6
GARISSA,IJARA,99,4,1,5
GARISSA,IJARA,95-99,10,6,16
GARISSA,IJARA,100+,4,4,8
GARISSA,IJARA,Not Stated,1,-,1
GARISSA,LAGDERA,Total,25023,25291,50314
GARISSA,LAGDERA,0,204,311,515
GARISSA,LAGDERA,1,489,547,1036
GARISSA,LAGDERA,2,855,1129,1984
GARISSA,LAGDERA,3,762,936,1698
GARISSA,LAGDERA,4,821,1136,1957
GARISSA,LAGDERA,0 - 4,3131,4059,7190
GARISSA,LAGDERA,5,843,983,1826
GARISSA,LAGDERA,6,933,1114,2047
GARISSA,LAGDERA,7,656,778,1434
GARISSA,LAGDERA,8,995,1143,2138
GARISSA,LAGDERA,9,607,695,1302
GARISSA,LAGDERA,05-Sep,4034,4713,8747
GARISSA,LAGDERA,10,1286,1296,2582
GARISSA,LAGDERA,11,504,602,1106
GARISSA,LAGDERA,12,1005,797,1802
GARISSA,LAGDERA,13,573,564,1137
GARISSA,LAGDERA,14,698,655,1353
GARISSA,LAGDERA,Oct-14,4066,3914,7980
GARISSA,LAGDERA,15,948,725,1673
GARISSA,LAGDERA,16,641,587,1228
GARISSA,LAGDERA,17,529,406,935
GARISSA,LAGDERA,18,673,595,1268
GARISSA,LAGDERA,19,275,313,588
GARISSA,LAGDERA,15-19,3066,2626,5692
GARISSA,LAGDERA,20,860,837,1697
GARISSA,LAGDERA,21,275,307,582
GARISSA,LAGDERA,22,351,419,770
GARISSA,LAGDERA,23,276,339,615
GARISSA,LAGDERA,24,310,319,629
GARISSA,LAGDERA,20-24,2072,2221,4293
GARISSA,LAGDERA,25,611,794,1405
GARISSA,LAGDERA,26,252,307,559
GARISSA,LAGDERA,27,240,292,532
GARISSA,LAGDERA,28,321,449,770
GARISSA,LAGDERA,29,324,364,688
GARISSA,LAGDERA,25-29,1748,2206,3954
GARISSA,LAGDERA,30,782,870,1652
GARISSA,LAGDERA,31,213,238,451
GARISSA,LAGDERA,32,271,270,541
GARISSA,LAGDERA,33,177,170,347
GARISSA,LAGDERA,34,165,160,325
GARISSA,LAGDERA,30-34,1608,1708,3316
GARISSA,LAGDERA,35,472,531,1003
GARISSA,LAGDERA,36,217,227,444
GARISSA,LAGDERA,37,153,142,295
GARISSA,LAGDERA,38,259,293,552
GARISSA,LAGDERA,39,218,201,419
GARISSA,LAGDERA,35-39,1319,1394,2713
GARISSA,LAGDERA,40,694,559,1253
GARISSA,LAGDERA,41,168,152,320
GARISSA,LAGDERA,42,184,158,342
GARISSA,LAGDERA,43,151,107,258
GARISSA,LAGDERA,44,83,60,143
GARISSA,LAGDERA,40-44,1280,1036,2316
GARISSA,LAGDERA,45,382,253,635
GARISSA,LAGDERA,46,86,62,148
GARISSA,LAGDERA,47,98,49,147
GARISSA,LAGDERA,48,148,80,228
GARISSA,LAGDERA,49,107,71,178
GARISSA,LAGDERA,45-49,821,515,1336
GARISSA,LAGDERA,50,400,174,574
GARISSA,LAGDERA,51,68,27,95
GARISSA,LAGDERA,52,98,48,146
GARISSA,LAGDERA,53,55,34,89
GARISSA,LAGDERA,54,65,40,105
GARISSA,LAGDERA,50-54,686,323,1009
GARISSA,LAGDERA,55,120,59,179
GARISSA,LAGDERA,56,85,36,121
GARISSA,LAGDERA,57,46,17,63
GARISSA,LAGDERA,58,66,40,106
GARISSA,LAGDERA,59,79,29,108
GARISSA,LAGDERA,55-59,396,181,577
GARISSA,LAGDERA,60,181,83,264
GARISSA,LAGDERA,61,32,10,42
GARISSA,LAGDERA,62,43,17,60
GARISSA,LAGDERA,63,36,15,51
GARISSA,LAGDERA,64,26,10,36
GARISSA,LAGDERA,60-64,318,135,453
GARISSA,LAGDERA,65,62,48,110
GARISSA,LAGDERA,66,13,10,23
GARISSA,LAGDERA,67,23,14,37
GARISSA,LAGDERA,68,34,16,50
GARISSA,LAGDERA,69,26,21,47
GARISSA,LAGDERA,65-69,158,109,267
GARISSA,LAGDERA,70,86,37,123
GARISSA,LAGDERA,71,15,19,34
GARISSA,LAGDERA,72,21,6,27
GARISSA,LAGDERA,73,11,3,14
GARISSA,LAGDERA,74,15,5,20
GARISSA,LAGDERA,70-74,148,70,218
GARISSA,LAGDERA,75,16,9,25
GARISSA,LAGDERA,76,11,3,14
GARISSA,LAGDERA,77,9,7,16
GARISSA,LAGDERA,78,24,6,30
GARISSA,LAGDERA,79,11,6,17
GARISSA,LAGDERA,75-79,71,31,102
GARISSA,LAGDERA,80,37,17,54
GARISSA,LAGDERA,81,9,8,17
GARISSA,LAGDERA,82,7,4,11
GARISSA,LAGDERA,83,3,1,4
GARISSA,LAGDERA,84,11,1,12
GARISSA,LAGDERA,80-84,67,31,98
GARISSA,LAGDERA,85,7,-,7
GARISSA,LAGDERA,86,3,2,5
GARISSA,LAGDERA,87,4,2,6
GARISSA,LAGDERA,88,5,3,8
GARISSA,LAGDERA,89,3,1,4
GARISSA,LAGDERA,85-89,22,8,30
GARISSA,LAGDERA,90,6,4,10
GARISSA,LAGDERA,91,-,4,4
GARISSA,LAGDERA,92,1,-,1
GARISSA,LAGDERA,93,-,-,-
GARISSA,LAGDERA,94,-,-,-
GARISSA,LAGDERA,90-94,7,8,15
GARISSA,LAGDERA,95,1,-,1
GARISSA,LAGDERA,96,1,-,1
GARISSA,LAGDERA,97,-,-,-
GARISSA,LAGDERA,98,1,1,2
GARISSA,LAGDERA,99,1,1,2
GARISSA,LAGDERA,95-99,4,2,6
GARISSA,LAGDERA,100+,1,-,1
GARISSA,LAGDERA,Not Stated,-,1,1
HOMA BAY,ALL,Total,539560,592367,1131927
HOMA BAY,ALL,0,14085,14047,28132
HOMA BAY,ALL,1,14925,14557,29482
HOMA BAY,ALL,2,15474,15426,30900
HOMA BAY,ALL,3,16673,16890,33563
HOMA BAY,ALL,4,16874,16743,33617
HOMA BAY,ALL,0 - 4,78031,77663,155694
HOMA BAY,ALL,5,16994,16660,33654
HOMA BAY,ALL,6,16780,17333,34113
HOMA BAY,ALL,7,16157,16481,32638
HOMA BAY,ALL,8,15649,15636,31285
HOMA BAY,ALL,9,17539,17732,35271
HOMA BAY,ALL,05-Sep,83119,83842,166961
HOMA BAY,ALL,10,19116,18779,37895
HOMA BAY,ALL,11,16812,17025,33837
HOMA BAY,ALL,12,19661,19160,38821
HOMA BAY,ALL,13,18569,18687,37256
HOMA BAY,ALL,14,16809,16716,33525
HOMA BAY,ALL,Oct-14,90967,90367,181334
HOMA BAY,ALL,15,16554,16566,33120
HOMA BAY,ALL,16,14702,14590,29292
HOMA BAY,ALL,17,14370,13595,27965
HOMA BAY,ALL,18,11410,10812,22222
HOMA BAY,ALL,19,11834,12354,24188
HOMA BAY,ALL,15-19,68870,67917,136787
HOMA BAY,ALL,20,10426,12272,22698
HOMA BAY,ALL,21,8973,10503,19476
HOMA BAY,ALL,22,7923,10045,17968
HOMA BAY,ALL,23,8516,10632,19148
HOMA BAY,ALL,24,7559,9143,16702
HOMA BAY,ALL,20-24,43397,52595,95992
HOMA BAY,ALL,25,8938,10465,19403
HOMA BAY,ALL,26,6752,8797,15549
HOMA BAY,ALL,27,7085,9403,16488
HOMA BAY,ALL,28,5057,6816,11873
HOMA BAY,ALL,29,5146,7045,12191
HOMA BAY,ALL,25-29,32978,42526,75504
HOMA BAY,ALL,30,7845,11232,19077
HOMA BAY,ALL,31,5414,7428,12842
HOMA BAY,ALL,32,6768,9505,16273
HOMA BAY,ALL,33,5910,8039,13949
HOMA BAY,ALL,34,5525,6637,12162
HOMA BAY,ALL,30-34,31462,42841,74303
HOMA BAY,ALL,35,7204,7687,14891
HOMA BAY,ALL,36,5185,4891,10076
HOMA BAY,ALL,37,5194,4654,9848
HOMA BAY,ALL,38,3564,3146,6710
HOMA BAY,ALL,39,4410,4006,8416
HOMA BAY,ALL,35-39,25557,24384,49941
HOMA BAY,ALL,40,5493,5683,11176
HOMA BAY,ALL,41,4665,4495,9160
HOMA BAY,ALL,42,4193,4405,8598
HOMA BAY,ALL,43,3951,4399,8350
HOMA BAY,ALL,44,3122,3593,6715
HOMA BAY,ALL,40-44,21424,22575,43999
HOMA BAY,ALL,45,4300,5193,9493
HOMA BAY,ALL,46,2995,3607,6602
HOMA BAY,ALL,47,3184,4148,7332
HOMA BAY,ALL,48,1842,2194,4036
HOMA BAY,ALL,49,2116,2573,4689
HOMA BAY,ALL,45-49,14437,17715,32152
HOMA BAY,ALL,50,2795,3980,6775
HOMA BAY,ALL,51,2155,2843,4998
HOMA BAY,ALL,52,1802,2300,4102
HOMA BAY,ALL,53,1563,1956,3519
HOMA BAY,ALL,54,1946,2236,4182
HOMA BAY,ALL,50-54,10261,13315,23576
HOMA BAY,ALL,55,2285,2643,4928
HOMA BAY,ALL,56,2260,3421,5681
HOMA BAY,ALL,57,2298,3821,6119
HOMA BAY,ALL,58,1369,1924,3293
HOMA BAY,ALL,59,1871,2608,4479
HOMA BAY,ALL,55-59,10083,14417,24500
HOMA BAY,ALL,60,2400,3780,6180
HOMA BAY,ALL,61,2102,2837,4939
HOMA BAY,ALL,62,1606,2030,3636
HOMA BAY,ALL,63,1652,2197,3849
HOMA BAY,ALL,64,1381,1810,3191
HOMA BAY,ALL,60-64,9141,12654,21795
HOMA BAY,ALL,65,1853,2654,4507
HOMA BAY,ALL,66,1268,1726,2994
HOMA BAY,ALL,67,1984,2885,4869
HOMA BAY,ALL,68,782,1047,1829
HOMA BAY,ALL,69,1304,1849,3153
HOMA BAY,ALL,65-69,7191,10161,17352
HOMA BAY,ALL,70,1882,3210,5092
HOMA BAY,ALL,71,1322,1554,2876
HOMA BAY,ALL,72,1044,1276,2320
HOMA BAY,ALL,73,847,1051,1898
HOMA BAY,ALL,74,799,1249,2048
HOMA BAY,ALL,70-74,5894,8340,14234
HOMA BAY,ALL,75,704,1112,1816
HOMA BAY,ALL,76,496,751,1247
HOMA BAY,ALL,77,779,1113,1892
HOMA BAY,ALL,78,343,537,880
HOMA BAY,ALL,79,489,1070,1559
HOMA BAY,ALL,75-79,2811,4583,7394
HOMA BAY,ALL,80,590,1275,1865
HOMA BAY,ALL,81,430,678,1108
HOMA BAY,ALL,82,351,407,758
HOMA BAY,ALL,83,422,529,951
HOMA BAY,ALL,84,312,562,874
HOMA BAY,ALL,80-84,2105,3451,5556
HOMA BAY,ALL,85,264,481,745
HOMA BAY,ALL,86,242,334,576
HOMA BAY,ALL,87,299,459,758
HOMA BAY,ALL,88,118,184,302
HOMA BAY,ALL,89,236,507,743
HOMA BAY,ALL,85-89,1159,1965,3124
HOMA BAY,ALL,90,142,278,420
HOMA BAY,ALL,91,110,133,243
HOMA BAY,ALL,92,67,74,141
HOMA BAY,ALL,93,48,81,129
HOMA BAY,ALL,94,46,70,116
HOMA BAY,ALL,90-94,413,636,1049
HOMA BAY,ALL,95,49,85,134
HOMA BAY,ALL,96,38,53,91
HOMA BAY,ALL,97,42,51,93
HOMA BAY,ALL,98,22,37,59
HOMA BAY,ALL,99,32,72,104
HOMA BAY,ALL,95-99,183,298,481
HOMA BAY,ALL,100+,74,116,190
HOMA BAY,ALL,Not Stated,3,6,9
HOMA BAY,HOMA BAY,Total,55756,61681,117437
HOMA BAY,HOMA BAY,0,1498,1527,3025
HOMA BAY,HOMA BAY,1,1508,1425,2933
HOMA BAY,HOMA BAY,2,1588,1571,3159
HOMA BAY,HOMA BAY,3,1738,1702,3440
HOMA BAY,HOMA BAY,4,1711,1664,3375
HOMA BAY,HOMA BAY,0 - 4,8043,7889,15932
HOMA BAY,HOMA BAY,5,1592,1599,3191
HOMA BAY,HOMA BAY,6,1646,1658,3304
HOMA BAY,HOMA BAY,7,1557,1610,3167
HOMA BAY,HOMA BAY,8,1457,1500,2957
HOMA BAY,HOMA BAY,9,1623,1781,3404
HOMA BAY,HOMA BAY,05-Sep,7875,8148,16023
HOMA BAY,HOMA BAY,10,1710,1820,3530
HOMA BAY,HOMA BAY,11,1529,1663,3192
HOMA BAY,HOMA BAY,12,1838,1856,3694
HOMA BAY,HOMA BAY,13,1753,1805,3558
HOMA BAY,HOMA BAY,14,1568,1625,3193
HOMA BAY,HOMA BAY,Oct-14,8398,8769,17167
HOMA BAY,HOMA BAY,15,1501,1669,3170
HOMA BAY,HOMA BAY,16,1375,1538,2913
HOMA BAY,HOMA BAY,17,1463,1438,2901
HOMA BAY,HOMA BAY,18,1134,1147,2281
HOMA BAY,HOMA BAY,19,1310,1426,2736
HOMA BAY,HOMA BAY,15-19,6783,7218,14001
HOMA BAY,HOMA BAY,20,1120,1419,2539
HOMA BAY,HOMA BAY,21,1040,1264,2304
HOMA BAY,HOMA BAY,22,1008,1292,2300
HOMA BAY,HOMA BAY,23,1065,1421,2486
HOMA BAY,HOMA BAY,24,976,1242,2218
HOMA BAY,HOMA BAY,20-24,5209,6638,11847
HOMA BAY,HOMA BAY,25,1171,1356,2527
HOMA BAY,HOMA BAY,26,839,1158,1997
HOMA BAY,HOMA BAY,27,863,1125,1988
HOMA BAY,HOMA BAY,28,690,852,1542
HOMA BAY,HOMA BAY,29,686,837,1523
HOMA BAY,HOMA BAY,25-29,4249,5328,9577
HOMA BAY,HOMA BAY,30,947,1370,2317
HOMA BAY,HOMA BAY,31,654,899,1553
HOMA BAY,HOMA BAY,32,882,1248,2130
HOMA BAY,HOMA BAY,33,692,995,1687
HOMA BAY,HOMA BAY,34,684,755,1439
HOMA BAY,HOMA BAY,30-34,3859,5267,9126
HOMA BAY,HOMA BAY,35,870,771,1641
HOMA BAY,HOMA BAY,36,606,527,1133
HOMA BAY,HOMA BAY,37,599,473,1072
HOMA BAY,HOMA BAY,38,438,374,812
HOMA BAY,HOMA BAY,39,505,394,899
HOMA BAY,HOMA BAY,35-39,3018,2539,5557
HOMA BAY,HOMA BAY,40,672,614,1286
HOMA BAY,HOMA BAY,41,504,463,967
HOMA BAY,HOMA BAY,42,444,459,903
HOMA BAY,HOMA BAY,43,416,393,809
HOMA BAY,HOMA BAY,44,318,366,684
HOMA BAY,HOMA BAY,40-44,2354,2295,4649
HOMA BAY,HOMA BAY,45,481,523,1004
HOMA BAY,HOMA BAY,46,282,306,588
HOMA BAY,HOMA BAY,47,320,362,682
HOMA BAY,HOMA BAY,48,211,215,426
HOMA BAY,HOMA BAY,49,239,250,489
HOMA BAY,HOMA BAY,45-49,1533,1656,3189
HOMA BAY,HOMA BAY,50,288,417,705
HOMA BAY,HOMA BAY,51,229,285,514
HOMA BAY,HOMA BAY,52,199,206,405
HOMA BAY,HOMA BAY,53,146,195,341
HOMA BAY,HOMA BAY,54,198,242,440
HOMA BAY,HOMA BAY,50-54,1060,1345,2405
HOMA BAY,HOMA BAY,55,245,256,501
HOMA BAY,HOMA BAY,56,205,291,496
HOMA BAY,HOMA BAY,57,221,353,574
HOMA BAY,HOMA BAY,58,145,195,340
HOMA BAY,HOMA BAY,59,174,242,416
HOMA BAY,HOMA BAY,55-59,990,1337,2327
HOMA BAY,HOMA BAY,60,213,325,538
HOMA BAY,HOMA BAY,61,202,222,424
HOMA BAY,HOMA BAY,62,143,170,313
HOMA BAY,HOMA BAY,63,147,166,313
HOMA BAY,HOMA BAY,64,128,146,274
HOMA BAY,HOMA BAY,60-64,833,1029,1862
HOMA BAY,HOMA BAY,65,179,215,394
HOMA BAY,HOMA BAY,66,104,138,242
HOMA BAY,HOMA BAY,67,136,201,337
HOMA BAY,HOMA BAY,68,61,73,134
HOMA BAY,HOMA BAY,69,96,126,222
HOMA BAY,HOMA BAY,65-69,576,753,1329
HOMA BAY,HOMA BAY,70,160,281,441
HOMA BAY,HOMA BAY,71,96,98,194
HOMA BAY,HOMA BAY,72,81,94,175
HOMA BAY,HOMA BAY,73,73,75,148
HOMA BAY,HOMA BAY,74,79,93,172
HOMA BAY,HOMA BAY,70-74,489,641,1130
HOMA BAY,HOMA BAY,75,55,99,154
HOMA BAY,HOMA BAY,76,37,51,88
HOMA BAY,HOMA BAY,77,63,77,140
HOMA BAY,HOMA BAY,78,23,39,62
HOMA BAY,HOMA BAY,79,39,78,117
HOMA BAY,HOMA BAY,75-79,217,344,561
HOMA BAY,HOMA BAY,80,50,114,164
HOMA BAY,HOMA BAY,81,25,44,69
HOMA BAY,HOMA BAY,82,22,26,48
HOMA BAY,HOMA BAY,83,31,36,67
HOMA BAY,HOMA BAY,84,17,33,50
HOMA BAY,HOMA BAY,80-84,145,253,398
HOMA BAY,HOMA BAY,85,24,45,69
HOMA BAY,HOMA BAY,86,10,24,34
HOMA BAY,HOMA BAY,87,20,31,51
HOMA BAY,HOMA BAY,88,16,23,39
HOMA BAY,HOMA BAY,89,12,35,47
HOMA BAY,HOMA BAY,85-89,82,158,240
HOMA BAY,HOMA BAY,90,7,19,26
HOMA BAY,HOMA BAY,91,3,7,10
HOMA BAY,HOMA BAY,92,9,5,14
HOMA BAY,HOMA BAY,93,1,3,4
HOMA BAY,HOMA BAY,94,4,5,9
HOMA BAY,HOMA BAY,90-94,24,39,63
HOMA BAY,HOMA BAY,95,5,9,14
HOMA BAY,HOMA BAY,96,3,7,10
HOMA BAY,HOMA BAY,97,3,5,8
HOMA BAY,HOMA BAY,98,-,1,1
HOMA BAY,HOMA BAY,99,3,4,7
HOMA BAY,HOMA BAY,95-99,14,26,40
HOMA BAY,HOMA BAY,100+,4,9,13
HOMA BAY,HOMA BAY,Not Stated,1,-,1
HOMA BAY,NDHIWA,Total,103706,114422,218128
HOMA BAY,NDHIWA,0,2983,3104,6087
HOMA BAY,NDHIWA,1,3241,3138,6379
HOMA BAY,NDHIWA,2,3374,3312,6686
HOMA BAY,NDHIWA,3,3571,3596,7167
HOMA BAY,NDHIWA,4,3624,3648,7272
HOMA BAY,NDHIWA,0 - 4,16793,16798,33591
HOMA BAY,NDHIWA,5,3580,3498,7078
HOMA BAY,NDHIWA,6,3525,3635,7160
HOMA BAY,NDHIWA,7,3274,3481,6755
HOMA BAY,NDHIWA,8,3268,3209,6477
HOMA BAY,NDHIWA,9,3579,3589,7168
HOMA BAY,NDHIWA,05-Sep,17226,17412,34638
HOMA BAY,NDHIWA,10,3866,3839,7705
HOMA BAY,NDHIWA,11,3275,3390,6665
HOMA BAY,NDHIWA,12,3872,3703,7575
HOMA BAY,NDHIWA,13,3528,3536,7064
HOMA BAY,NDHIWA,14,3296,3247,6543
HOMA BAY,NDHIWA,Oct-14,17837,17715,35552
HOMA BAY,NDHIWA,15,3282,3163,6445
HOMA BAY,NDHIWA,16,2769,2723,5492
HOMA BAY,NDHIWA,17,2650,2440,5090
HOMA BAY,NDHIWA,18,2113,2007,4120
HOMA BAY,NDHIWA,19,2165,2309,4474
HOMA BAY,NDHIWA,15-19,12979,12642,25621
HOMA BAY,NDHIWA,20,1949,2439,4388
HOMA BAY,NDHIWA,21,1652,2011,3663
HOMA BAY,NDHIWA,22,1532,1860,3392
HOMA BAY,NDHIWA,23,1571,1962,3533
HOMA BAY,NDHIWA,24,1412,1676,3088
HOMA BAY,NDHIWA,20-24,8116,9948,18064
HOMA BAY,NDHIWA,25,1532,1983,3515
HOMA BAY,NDHIWA,26,1248,1682,2930
HOMA BAY,NDHIWA,27,1345,1861,3206
HOMA BAY,NDHIWA,28,892,1203,2095
HOMA BAY,NDHIWA,29,963,1329,2292
HOMA BAY,NDHIWA,25-29,5980,8058,14038
HOMA BAY,NDHIWA,30,1421,2139,3560
HOMA BAY,NDHIWA,31,1055,1581,2636
HOMA BAY,NDHIWA,32,1184,1761,2945
HOMA BAY,NDHIWA,33,994,1419,2413
HOMA BAY,NDHIWA,34,934,1083,2017
HOMA BAY,NDHIWA,30-34,5588,7983,13571
HOMA BAY,NDHIWA,35,1215,1236,2451
HOMA BAY,NDHIWA,36,828,748,1576
HOMA BAY,NDHIWA,37,924,752,1676
HOMA BAY,NDHIWA,38,557,518,1075
HOMA BAY,NDHIWA,39,748,691,1439
HOMA BAY,NDHIWA,35-39,4272,3945,8217
HOMA BAY,NDHIWA,40,920,1022,1942
HOMA BAY,NDHIWA,41,829,870,1699
HOMA BAY,NDHIWA,42,802,888,1690
HOMA BAY,NDHIWA,43,720,880,1600
HOMA BAY,NDHIWA,44,560,662,1222
HOMA BAY,NDHIWA,40-44,3831,4322,8153
HOMA BAY,NDHIWA,45,702,888,1590
HOMA BAY,NDHIWA,46,594,701,1295
HOMA BAY,NDHIWA,47,587,717,1304
HOMA BAY,NDHIWA,48,283,376,659
HOMA BAY,NDHIWA,49,340,450,790
HOMA BAY,NDHIWA,45-49,2506,3132,5638
HOMA BAY,NDHIWA,50,465,736,1201
HOMA BAY,NDHIWA,51,395,455,850
HOMA BAY,NDHIWA,52,322,403,725
HOMA BAY,NDHIWA,53,271,376,647
HOMA BAY,NDHIWA,54,345,376,721
HOMA BAY,NDHIWA,50-54,1798,2346,4144
HOMA BAY,NDHIWA,55,411,464,875
HOMA BAY,NDHIWA,56,342,640,982
HOMA BAY,NDHIWA,57,430,667,1097
HOMA BAY,NDHIWA,58,222,305,527
HOMA BAY,NDHIWA,59,302,439,741
HOMA BAY,NDHIWA,55-59,1707,2515,4222
HOMA BAY,NDHIWA,60,413,643,1056
HOMA BAY,NDHIWA,61,347,506,853
HOMA BAY,NDHIWA,62,302,351,653
HOMA BAY,NDHIWA,63,284,400,684
HOMA BAY,NDHIWA,64,231,352,583
HOMA BAY,NDHIWA,60-64,1577,2252,3829
HOMA BAY,NDHIWA,65,318,486,804
HOMA BAY,NDHIWA,66,229,323,552
HOMA BAY,NDHIWA,67,343,532,875
HOMA BAY,NDHIWA,68,141,201,342
HOMA BAY,NDHIWA,69,225,347,572
HOMA BAY,NDHIWA,65-69,1256,1889,3145
HOMA BAY,NDHIWA,70,344,588,932
HOMA BAY,NDHIWA,71,226,254,480
HOMA BAY,NDHIWA,72,184,237,421
HOMA BAY,NDHIWA,73,156,202,358
HOMA BAY,NDHIWA,74,134,234,368
HOMA BAY,NDHIWA,70-74,1044,1515,2559
HOMA BAY,NDHIWA,75,108,200,308
HOMA BAY,NDHIWA,76,82,148,230
HOMA BAY,NDHIWA,77,143,202,345
HOMA BAY,NDHIWA,78,60,93,153
HOMA BAY,NDHIWA,79,80,183,263
HOMA BAY,NDHIWA,75-79,473,826,1299
HOMA BAY,NDHIWA,80,111,217,328
HOMA BAY,NDHIWA,81,69,118,187
HOMA BAY,NDHIWA,82,63,83,146
HOMA BAY,NDHIWA,83,70,102,172
HOMA BAY,NDHIWA,84,60,97,157
HOMA BAY,NDHIWA,80-84,373,617,990
HOMA BAY,NDHIWA,85,46,87,133
HOMA BAY,NDHIWA,86,43,57,100
HOMA BAY,NDHIWA,87,60,89,149
HOMA BAY,NDHIWA,88,16,27,43
HOMA BAY,NDHIWA,89,53,86,139
HOMA BAY,NDHIWA,85-89,218,346,564
HOMA BAY,NDHIWA,90,31,39,70
HOMA BAY,NDHIWA,91,21,22,43
HOMA BAY,NDHIWA,92,11,7,18
HOMA BAY,NDHIWA,93,14,18,32
HOMA BAY,NDHIWA,94,6,12,18
HOMA BAY,NDHIWA,90-94,83,98,181
HOMA BAY,NDHIWA,95,10,14,24
HOMA BAY,NDHIWA,96,5,7,12
HOMA BAY,NDHIWA,97,8,5,13
HOMA BAY,NDHIWA,98,5,7,12
HOMA BAY,NDHIWA,99,4,10,14
HOMA BAY,NDHIWA,95-99,32,43,75
HOMA BAY,NDHIWA,100+,17,18,35
HOMA BAY,NDHIWA,Not Stated,-,2,2
HOMA BAY,RACHUONYO NORTH,Total,85409,93273,178682
HOMA BAY,RACHUONYO NORTH,0,1975,2033,4008
HOMA BAY,RACHUONYO NORTH,1,2243,2127,4370
HOMA BAY,RACHUONYO NORTH,2,2306,2223,4529
HOMA BAY,RACHUONYO NORTH,3,2424,2614,5038
HOMA BAY,RACHUONYO NORTH,4,2495,2461,4956
HOMA BAY,RACHUONYO NORTH,0 - 4,11443,11458,22901
HOMA BAY,RACHUONYO NORTH,5,2577,2472,5049
HOMA BAY,RACHUONYO NORTH,6,2516,2584,5100
HOMA BAY,RACHUONYO NORTH,7,2490,2473,4963
HOMA BAY,RACHUONYO NORTH,8,2336,2355,4691
HOMA BAY,RACHUONYO NORTH,9,2736,2770,5506
HOMA BAY,RACHUONYO NORTH,05-Sep,12655,12654,25309
HOMA BAY,RACHUONYO NORTH,10,2970,2827,5797
HOMA BAY,RACHUONYO NORTH,11,2653,2638,5291
HOMA BAY,RACHUONYO NORTH,12,3112,3004,6116
HOMA BAY,RACHUONYO NORTH,13,2869,2953,5822
HOMA BAY,RACHUONYO NORTH,14,2652,2627,5279
HOMA BAY,RACHUONYO NORTH,Oct-14,14256,14049,28305
HOMA BAY,RACHUONYO NORTH,15,2652,2557,5209
HOMA BAY,RACHUONYO NORTH,16,2349,2318,4667
HOMA BAY,RACHUONYO NORTH,17,2454,2191,4645
HOMA BAY,RACHUONYO NORTH,18,1857,1776,3633
HOMA BAY,RACHUONYO NORTH,19,1919,1936,3855
HOMA BAY,RACHUONYO NORTH,15-19,11231,10778,22009
HOMA BAY,RACHUONYO NORTH,20,1671,1913,3584
HOMA BAY,RACHUONYO NORTH,21,1572,1615,3187
HOMA BAY,RACHUONYO NORTH,22,1268,1496,2764
HOMA BAY,RACHUONYO NORTH,23,1344,1584,2928
HOMA BAY,RACHUONYO NORTH,24,1128,1381,2509
HOMA BAY,RACHUONYO NORTH,20-24,6983,7989,14972
HOMA BAY,RACHUONYO NORTH,25,1374,1469,2843
HOMA BAY,RACHUONYO NORTH,26,1014,1268,2282
HOMA BAY,RACHUONYO NORTH,27,1119,1387,2506
HOMA BAY,RACHUONYO NORTH,28,774,1026,1800
HOMA BAY,RACHUONYO NORTH,29,759,1077,1836
HOMA BAY,RACHUONYO NORTH,25-29,5040,6227,11267
HOMA BAY,RACHUONYO NORTH,30,1237,1724,2961
HOMA BAY,RACHUONYO NORTH,31,727,980,1707
HOMA BAY,RACHUONYO NORTH,32,1003,1275,2278
HOMA BAY,RACHUONYO NORTH,33,887,1169,2056
HOMA BAY,RACHUONYO NORTH,34,871,1062,1933
HOMA BAY,RACHUONYO NORTH,30-34,4725,6210,10935
HOMA BAY,RACHUONYO NORTH,35,1029,1198,2227
HOMA BAY,RACHUONYO NORTH,36,764,824,1588
HOMA BAY,RACHUONYO NORTH,37,844,840,1684
HOMA BAY,RACHUONYO NORTH,38,572,524,1096
HOMA BAY,RACHUONYO NORTH,39,759,715,1474
HOMA BAY,RACHUONYO NORTH,35-39,3968,4101,8069
HOMA BAY,RACHUONYO NORTH,40,878,915,1793
HOMA BAY,RACHUONYO NORTH,41,705,736,1441
HOMA BAY,RACHUONYO NORTH,42,676,650,1326
HOMA BAY,RACHUONYO NORTH,43,657,659,1316
HOMA BAY,RACHUONYO NORTH,44,494,592,1086
HOMA BAY,RACHUONYO NORTH,40-44,3410,3552,6962
HOMA BAY,RACHUONYO NORTH,45,707,846,1553
HOMA BAY,RACHUONYO NORTH,46,514,611,1125
HOMA BAY,RACHUONYO NORTH,47,465,667,1132
HOMA BAY,RACHUONYO NORTH,48,311,376,687
HOMA BAY,RACHUONYO NORTH,49,351,464,815
HOMA BAY,RACHUONYO NORTH,45-49,2348,2964,5312
HOMA BAY,RACHUONYO NORTH,50,496,639,1135
HOMA BAY,RACHUONYO NORTH,51,384,544,928
HOMA BAY,RACHUONYO NORTH,52,310,414,724
HOMA BAY,RACHUONYO NORTH,53,273,344,617
HOMA BAY,RACHUONYO NORTH,54,348,376,724
HOMA BAY,RACHUONYO NORTH,50-54,1811,2317,4128
HOMA BAY,RACHUONYO NORTH,55,405,508,913
HOMA BAY,RACHUONYO NORTH,56,413,640,1053
HOMA BAY,RACHUONYO NORTH,57,403,680,1083
HOMA BAY,RACHUONYO NORTH,58,255,346,601
HOMA BAY,RACHUONYO NORTH,59,355,478,833
HOMA BAY,RACHUONYO NORTH,55-59,1831,2652,4483
HOMA BAY,RACHUONYO NORTH,60,471,699,1170
HOMA BAY,RACHUONYO NORTH,61,395,534,929
HOMA BAY,RACHUONYO NORTH,62,298,422,720
HOMA BAY,RACHUONYO NORTH,63,350,423,773
HOMA BAY,RACHUONYO NORTH,64,271,324,595
HOMA BAY,RACHUONYO NORTH,60-64,1785,2402,4187
HOMA BAY,RACHUONYO NORTH,65,359,518,877
HOMA BAY,RACHUONYO NORTH,66,256,356,612
HOMA BAY,RACHUONYO NORTH,67,416,577,993
HOMA BAY,RACHUONYO NORTH,68,151,192,343
HOMA BAY,RACHUONYO NORTH,69,266,352,618
HOMA BAY,RACHUONYO NORTH,65-69,1448,1995,3443
HOMA BAY,RACHUONYO NORTH,70,360,658,1018
HOMA BAY,RACHUONYO NORTH,71,271,308,579
HOMA BAY,RACHUONYO NORTH,72,200,255,455
HOMA BAY,RACHUONYO NORTH,73,160,218,378
HOMA BAY,RACHUONYO NORTH,74,164,236,400
HOMA BAY,RACHUONYO NORTH,70-74,1155,1675,2830
HOMA BAY,RACHUONYO NORTH,75,146,194,340
HOMA BAY,RACHUONYO NORTH,76,85,139,224
HOMA BAY,RACHUONYO NORTH,77,166,224,390
HOMA BAY,RACHUONYO NORTH,78,74,99,173
HOMA BAY,RACHUONYO NORTH,79,124,196,320
HOMA BAY,RACHUONYO NORTH,75-79,595,852,1447
HOMA BAY,RACHUONYO NORTH,80,108,283,391
HOMA BAY,RACHUONYO NORTH,81,94,153,247
HOMA BAY,RACHUONYO NORTH,82,67,86,153
HOMA BAY,RACHUONYO NORTH,83,66,126,192
HOMA BAY,RACHUONYO NORTH,84,66,128,194
HOMA BAY,RACHUONYO NORTH,80-84,401,776,1177
HOMA BAY,RACHUONYO NORTH,85,41,86,127
HOMA BAY,RACHUONYO NORTH,86,45,61,106
HOMA BAY,RACHUONYO NORTH,87,57,98,155
HOMA BAY,RACHUONYO NORTH,88,25,45,70
HOMA BAY,RACHUONYO NORTH,89,47,115,162
HOMA BAY,RACHUONYO NORTH,85-89,215,405,620
HOMA BAY,RACHUONYO NORTH,90,20,59,79
HOMA BAY,RACHUONYO NORTH,91,17,17,34
HOMA BAY,RACHUONYO NORTH,92,15,15,30
HOMA BAY,RACHUONYO NORTH,93,10,17,27
HOMA BAY,RACHUONYO NORTH,94,12,16,28
HOMA BAY,RACHUONYO NORTH,90-94,74,124,198
HOMA BAY,RACHUONYO NORTH,95,2,20,22
HOMA BAY,RACHUONYO NORTH,96,4,14,18
HOMA BAY,RACHUONYO NORTH,97,8,7,15
HOMA BAY,RACHUONYO NORTH,98,5,13,18
HOMA BAY,RACHUONYO NORTH,99,5,13,18
HOMA BAY,RACHUONYO NORTH,95-99,24,67,91
HOMA BAY,RACHUONYO NORTH,100+,10,24,34
HOMA BAY,RACHUONYO NORTH,Not Stated,1,2,3
HOMA BAY,RACHUONYO EAST,Total,57709,64111,121820
HOMA BAY,RACHUONYO EAST,0,1455,1401,2856
HOMA BAY,RACHUONYO EAST,1,1489,1473,2962
HOMA BAY,RACHUONYO EAST,2,1552,1600,3152
HOMA BAY,RACHUONYO EAST,3,1637,1730,3367
HOMA BAY,RACHUONYO EAST,4,1684,1704,3388
HOMA BAY,RACHUONYO EAST,0 - 4,7817,7908,15725
HOMA BAY,RACHUONYO EAST,5,1744,1709,3453
HOMA BAY,RACHUONYO EAST,6,1794,1891,3685
HOMA BAY,RACHUONYO EAST,7,1773,1712,3485
HOMA BAY,RACHUONYO EAST,8,1727,1685,3412
HOMA BAY,RACHUONYO EAST,9,1931,1942,3873
HOMA BAY,RACHUONYO EAST,05-Sep,8969,8939,17908
HOMA BAY,RACHUONYO EAST,10,2213,2069,4282
HOMA BAY,RACHUONYO EAST,11,1993,1954,3947
HOMA BAY,RACHUONYO EAST,12,2270,2201,4471
HOMA BAY,RACHUONYO EAST,13,2210,2204,4414
HOMA BAY,RACHUONYO EAST,14,1966,1968,3934
HOMA BAY,RACHUONYO EAST,Oct-14,10652,10396,21048
HOMA BAY,RACHUONYO EAST,15,1980,1869,3849
HOMA BAY,RACHUONYO EAST,16,1728,1679,3407
HOMA BAY,RACHUONYO EAST,17,1698,1582,3280
HOMA BAY,RACHUONYO EAST,18,1302,1183,2485
HOMA BAY,RACHUONYO EAST,19,1251,1302,2553
HOMA BAY,RACHUONYO EAST,15-19,7959,7615,15574
HOMA BAY,RACHUONYO EAST,20,1097,1198,2295
HOMA BAY,RACHUONYO EAST,21,890,977,1867
HOMA BAY,RACHUONYO EAST,22,774,1004,1778
HOMA BAY,RACHUONYO EAST,23,775,1042,1817
HOMA BAY,RACHUONYO EAST,24,660,858,1518
HOMA BAY,RACHUONYO EAST,20-24,4196,5079,9275
HOMA BAY,RACHUONYO EAST,25,829,1073,1902
HOMA BAY,RACHUONYO EAST,26,611,848,1459
HOMA BAY,RACHUONYO EAST,27,682,945,1627
HOMA BAY,RACHUONYO EAST,28,481,669,1150
HOMA BAY,RACHUONYO EAST,29,507,684,1191
HOMA BAY,RACHUONYO EAST,25-29,3110,4219,7329
HOMA BAY,RACHUONYO EAST,30,773,1172,1945
HOMA BAY,RACHUONYO EAST,31,524,708,1232
HOMA BAY,RACHUONYO EAST,32,580,862,1442
HOMA BAY,RACHUONYO EAST,33,500,823,1323
HOMA BAY,RACHUONYO EAST,34,520,708,1228
HOMA BAY,RACHUONYO EAST,30-34,2897,4273,7170
HOMA BAY,RACHUONYO EAST,35,683,782,1465
HOMA BAY,RACHUONYO EAST,36,487,542,1029
HOMA BAY,RACHUONYO EAST,37,479,540,1019
HOMA BAY,RACHUONYO EAST,38,308,367,675
HOMA BAY,RACHUONYO EAST,39,440,431,871
HOMA BAY,RACHUONYO EAST,35-39,2397,2662,5059
HOMA BAY,RACHUONYO EAST,40,523,613,1136
HOMA BAY,RACHUONYO EAST,41,545,519,1064
HOMA BAY,RACHUONYO EAST,42,396,437,833
HOMA BAY,RACHUONYO EAST,43,409,533,942
HOMA BAY,RACHUONYO EAST,44,310,395,705
HOMA BAY,RACHUONYO EAST,40-44,2183,2497,4680
HOMA BAY,RACHUONYO EAST,45,485,637,1122
HOMA BAY,RACHUONYO EAST,46,308,439,747
HOMA BAY,RACHUONYO EAST,47,336,594,930
HOMA BAY,RACHUONYO EAST,48,190,300,490
HOMA BAY,RACHUONYO EAST,49,218,316,534
HOMA BAY,RACHUONYO EAST,45-49,1537,2286,3823
HOMA BAY,RACHUONYO EAST,50,275,418,693
HOMA BAY,RACHUONYO EAST,51,234,296,530
HOMA BAY,RACHUONYO EAST,52,180,249,429
HOMA BAY,RACHUONYO EAST,53,170,213,383
HOMA BAY,RACHUONYO EAST,54,248,297,545
HOMA BAY,RACHUONYO EAST,50-54,1107,1473,2580
HOMA BAY,RACHUONYO EAST,55,256,311,567
HOMA BAY,RACHUONYO EAST,56,268,388,656
HOMA BAY,RACHUONYO EAST,57,273,494,767
HOMA BAY,RACHUONYO EAST,58,175,242,417
HOMA BAY,RACHUONYO EAST,59,240,330,570
HOMA BAY,RACHUONYO EAST,55-59,1212,1765,2977
HOMA BAY,RACHUONYO EAST,60,316,489,805
HOMA BAY,RACHUONYO EAST,61,275,353,628
HOMA BAY,RACHUONYO EAST,62,199,240,439
HOMA BAY,RACHUONYO EAST,63,202,251,453
HOMA BAY,RACHUONYO EAST,64,181,216,397
HOMA BAY,RACHUONYO EAST,60-64,1173,1549,2722
HOMA BAY,RACHUONYO EAST,65,209,320,529
HOMA BAY,RACHUONYO EAST,66,155,195,350
HOMA BAY,RACHUONYO EAST,67,255,350,605
HOMA BAY,RACHUONYO EAST,68,108,118,226
HOMA BAY,RACHUONYO EAST,69,161,230,391
HOMA BAY,RACHUONYO EAST,65-69,888,1213,2101
HOMA BAY,RACHUONYO EAST,70,215,356,571
HOMA BAY,RACHUONYO EAST,71,172,171,343
HOMA BAY,RACHUONYO EAST,72,139,142,281
HOMA BAY,RACHUONYO EAST,73,116,118,234
HOMA BAY,RACHUONYO EAST,74,96,147,243
HOMA BAY,RACHUONYO EAST,70-74,738,934,1672
HOMA BAY,RACHUONYO EAST,75,93,135,228
HOMA BAY,RACHUONYO EAST,76,68,75,143
HOMA BAY,RACHUONYO EAST,77,91,111,202
HOMA BAY,RACHUONYO EAST,78,43,68,111
HOMA BAY,RACHUONYO EAST,79,54,137,191
HOMA BAY,RACHUONYO EAST,75-79,349,526,875
HOMA BAY,RACHUONYO EAST,80,72,140,212
HOMA BAY,RACHUONYO EAST,81,72,89,161
HOMA BAY,RACHUONYO EAST,82,37,46,83
HOMA BAY,RACHUONYO EAST,83,51,68,119
HOMA BAY,RACHUONYO EAST,84,44,75,119
HOMA BAY,RACHUONYO EAST,80-84,276,418,694
HOMA BAY,RACHUONYO EAST,85,42,44,86
HOMA BAY,RACHUONYO EAST,86,28,32,60
HOMA BAY,RACHUONYO EAST,87,42,45,87
HOMA BAY,RACHUONYO EAST,88,12,26,38
HOMA BAY,RACHUONYO EAST,89,30,63,93
HOMA BAY,RACHUONYO EAST,85-89,154,210,364
HOMA BAY,RACHUONYO EAST,90,18,30,48
HOMA BAY,RACHUONYO EAST,91,20,28,48
HOMA BAY,RACHUONYO EAST,92,6,9,15
HOMA BAY,RACHUONYO EAST,93,5,13,18
HOMA BAY,RACHUONYO EAST,94,4,8,12
HOMA BAY,RACHUONYO EAST,90-94,53,88,141
HOMA BAY,RACHUONYO EAST,95,9,13,22
HOMA BAY,RACHUONYO EAST,96,6,6,12
HOMA BAY,RACHUONYO EAST,97,4,8,12
HOMA BAY,RACHUONYO EAST,98,8,8,16
HOMA BAY,RACHUONYO EAST,99,4,12,16
HOMA BAY,RACHUONYO EAST,95-99,31,47,78
HOMA BAY,RACHUONYO EAST,100+,11,13,24
HOMA BAY,RACHUONYO EAST,Not Stated,-,1,1
HOMA BAY,RACHUONYO SOUTH,Total,61663,69151,130814
HOMA BAY,RACHUONYO SOUTH,0,1588,1556,3144
HOMA BAY,RACHUONYO SOUTH,1,1688,1663,3351
HOMA BAY,RACHUONYO SOUTH,2,1696,1707,3403
HOMA BAY,RACHUONYO SOUTH,3,1902,1777,3679
HOMA BAY,RACHUONYO SOUTH,4,1858,1822,3680
HOMA BAY,RACHUONYO SOUTH,0 - 4,8732,8525,17257
HOMA BAY,RACHUONYO SOUTH,5,1856,1809,3665
HOMA BAY,RACHUONYO SOUTH,6,1795,1960,3755
HOMA BAY,RACHUONYO SOUTH,7,1825,1917,3742
HOMA BAY,RACHUONYO SOUTH,8,1691,1823,3514
HOMA BAY,RACHUONYO SOUTH,9,1980,1986,3966
HOMA BAY,RACHUONYO SOUTH,05-Sep,9147,9495,18642
HOMA BAY,RACHUONYO SOUTH,10,2268,2219,4487
HOMA BAY,RACHUONYO SOUTH,11,1957,1869,3826
HOMA BAY,RACHUONYO SOUTH,12,2256,2223,4479
HOMA BAY,RACHUONYO SOUTH,13,2188,2222,4410
HOMA BAY,RACHUONYO SOUTH,14,1938,1952,3890
HOMA BAY,RACHUONYO SOUTH,Oct-14,10607,10485,21092
HOMA BAY,RACHUONYO SOUTH,15,1851,2022,3873
HOMA BAY,RACHUONYO SOUTH,16,1747,1776,3523
HOMA BAY,RACHUONYO SOUTH,17,1668,1599,3267
HOMA BAY,RACHUONYO SOUTH,18,1339,1362,2701
HOMA BAY,RACHUONYO SOUTH,19,1406,1468,2874
HOMA BAY,RACHUONYO SOUTH,15-19,8011,8227,16238
HOMA BAY,RACHUONYO SOUTH,20,1199,1428,2627
HOMA BAY,RACHUONYO SOUTH,21,1021,1230,2251
HOMA BAY,RACHUONYO SOUTH,22,892,1172,2064
HOMA BAY,RACHUONYO SOUTH,23,941,1237,2178
HOMA BAY,RACHUONYO SOUTH,24,847,1021,1868
HOMA BAY,RACHUONYO SOUTH,20-24,4900,6088,10988
HOMA BAY,RACHUONYO SOUTH,25,1019,1232,2251
HOMA BAY,RACHUONYO SOUTH,26,779,1030,1809
HOMA BAY,RACHUONYO SOUTH,27,847,1134,1981
HOMA BAY,RACHUONYO SOUTH,28,631,862,1493
HOMA BAY,RACHUONYO SOUTH,29,575,850,1425
HOMA BAY,RACHUONYO SOUTH,25-29,3851,5108,8959
HOMA BAY,RACHUONYO SOUTH,30,886,1262,2148
HOMA BAY,RACHUONYO SOUTH,31,573,827,1400
HOMA BAY,RACHUONYO SOUTH,32,710,1070,1780
HOMA BAY,RACHUONYO SOUTH,33,695,926,1621
HOMA BAY,RACHUONYO SOUTH,34,585,796,1381
HOMA BAY,RACHUONYO SOUTH,30-34,3449,4881,8330
HOMA BAY,RACHUONYO SOUTH,35,769,928,1697
HOMA BAY,RACHUONYO SOUTH,36,568,582,1150
HOMA BAY,RACHUONYO SOUTH,37,609,557,1166
HOMA BAY,RACHUONYO SOUTH,38,447,424,871
HOMA BAY,RACHUONYO SOUTH,39,488,509,997
HOMA BAY,RACHUONYO SOUTH,35-39,2881,3000,5881
HOMA BAY,RACHUONYO SOUTH,40,661,690,1351
HOMA BAY,RACHUONYO SOUTH,41,569,581,1150
HOMA BAY,RACHUONYO SOUTH,42,463,551,1014
HOMA BAY,RACHUONYO SOUTH,43,451,569,1020
HOMA BAY,RACHUONYO SOUTH,44,364,407,771
HOMA BAY,RACHUONYO SOUTH,40-44,2508,2798,5306
HOMA BAY,RACHUONYO SOUTH,45,497,616,1113
HOMA BAY,RACHUONYO SOUTH,46,312,448,760
HOMA BAY,RACHUONYO SOUTH,47,381,515,896
HOMA BAY,RACHUONYO SOUTH,48,205,265,470
HOMA BAY,RACHUONYO SOUTH,49,247,275,522
HOMA BAY,RACHUONYO SOUTH,45-49,1642,2119,3761
HOMA BAY,RACHUONYO SOUTH,50,338,516,854
HOMA BAY,RACHUONYO SOUTH,51,230,336,566
HOMA BAY,RACHUONYO SOUTH,52,218,294,512
HOMA BAY,RACHUONYO SOUTH,53,177,238,415
HOMA BAY,RACHUONYO SOUTH,54,241,293,534
HOMA BAY,RACHUONYO SOUTH,50-54,1204,1677,2881
HOMA BAY,RACHUONYO SOUTH,55,287,345,632
HOMA BAY,RACHUONYO SOUTH,56,312,384,696
HOMA BAY,RACHUONYO SOUTH,57,272,465,737
HOMA BAY,RACHUONYO SOUTH,58,169,270,439
HOMA BAY,RACHUONYO SOUTH,59,232,312,544
HOMA BAY,RACHUONYO SOUTH,55-59,1272,1776,3048
HOMA BAY,RACHUONYO SOUTH,60,261,489,750
HOMA BAY,RACHUONYO SOUTH,61,244,384,628
HOMA BAY,RACHUONYO SOUTH,62,186,243,429
HOMA BAY,RACHUONYO SOUTH,63,179,284,463
HOMA BAY,RACHUONYO SOUTH,64,164,183,347
HOMA BAY,RACHUONYO SOUTH,60-64,1034,1583,2617
HOMA BAY,RACHUONYO SOUTH,65,219,332,551
HOMA BAY,RACHUONYO SOUTH,66,159,197,356
HOMA BAY,RACHUONYO SOUTH,67,253,313,566
HOMA BAY,RACHUONYO SOUTH,68,93,127,220
HOMA BAY,RACHUONYO SOUTH,69,146,194,340
HOMA BAY,RACHUONYO SOUTH,65-69,870,1163,2033
HOMA BAY,RACHUONYO SOUTH,70,244,388,632
HOMA BAY,RACHUONYO SOUTH,71,171,184,355
HOMA BAY,RACHUONYO SOUTH,72,117,157,274
HOMA BAY,RACHUONYO SOUTH,73,108,121,229
HOMA BAY,RACHUONYO SOUTH,74,92,125,217
HOMA BAY,RACHUONYO SOUTH,70-74,732,975,1707
HOMA BAY,RACHUONYO SOUTH,75,106,128,234
HOMA BAY,RACHUONYO SOUTH,76,63,83,146
HOMA BAY,RACHUONYO SOUTH,77,88,132,220
HOMA BAY,RACHUONYO SOUTH,78,48,63,111
HOMA BAY,RACHUONYO SOUTH,79,55,105,160
HOMA BAY,RACHUONYO SOUTH,75-79,360,511,871
HOMA BAY,RACHUONYO SOUTH,80,72,148,220
HOMA BAY,RACHUONYO SOUTH,81,36,69,105
HOMA BAY,RACHUONYO SOUTH,82,41,48,89
HOMA BAY,RACHUONYO SOUTH,83,60,69,129
HOMA BAY,RACHUONYO SOUTH,84,37,50,87
HOMA BAY,RACHUONYO SOUTH,80-84,246,384,630
HOMA BAY,RACHUONYO SOUTH,85,37,64,101
HOMA BAY,RACHUONYO SOUTH,86,33,51,84
HOMA BAY,RACHUONYO SOUTH,87,38,43,81
HOMA BAY,RACHUONYO SOUTH,88,15,17,32
HOMA BAY,RACHUONYO SOUTH,89,27,56,83
HOMA BAY,RACHUONYO SOUTH,85-89,150,231,381
HOMA BAY,RACHUONYO SOUTH,90,12,41,53
HOMA BAY,RACHUONYO SOUTH,91,12,13,25
HOMA BAY,RACHUONYO SOUTH,92,7,11,18
HOMA BAY,RACHUONYO SOUTH,93,7,4,11
HOMA BAY,RACHUONYO SOUTH,94,4,10,14
HOMA BAY,RACHUONYO SOUTH,90-94,42,79,121
HOMA BAY,RACHUONYO SOUTH,95,5,7,12
HOMA BAY,RACHUONYO SOUTH,96,6,4,10
HOMA BAY,RACHUONYO SOUTH,97,6,6,12
HOMA BAY,RACHUONYO SOUTH,98,-,1,1
HOMA BAY,RACHUONYO SOUTH,99,1,9,10
HOMA BAY,RACHUONYO SOUTH,95-99,18,27,45
HOMA BAY,RACHUONYO SOUTH,100+,7,19,26
HOMA BAY,RACHUONYO SOUTH,Not Stated,-,-,-
HOMA BAY,RANGWE,Total,55404,62325,117729
HOMA BAY,RANGWE,0,1306,1283,2589
HOMA BAY,RANGWE,1,1546,1500,3046
HOMA BAY,RANGWE,2,1614,1547,3161
HOMA BAY,RANGWE,3,1711,1704,3415
HOMA BAY,RANGWE,4,1845,1768,3613
HOMA BAY,RANGWE,0 - 4,8022,7802,15824
HOMA BAY,RANGWE,5,1863,1742,3605
HOMA BAY,RANGWE,6,1778,1793,3571
HOMA BAY,RANGWE,7,1811,1787,3598
HOMA BAY,RANGWE,8,1736,1633,3369
HOMA BAY,RANGWE,9,1894,1893,3787
HOMA BAY,RANGWE,05-Sep,9082,8848,17930
HOMA BAY,RANGWE,10,2111,2042,4153
HOMA BAY,RANGWE,11,1827,1862,3689
HOMA BAY,RANGWE,12,2135,2070,4205
HOMA BAY,RANGWE,13,2054,2041,4095
HOMA BAY,RANGWE,14,1817,1897,3714
HOMA BAY,RANGWE,Oct-14,9944,9912,19856
HOMA BAY,RANGWE,15,1768,1794,3562
HOMA BAY,RANGWE,16,1581,1514,3095
HOMA BAY,RANGWE,17,1497,1472,2969
HOMA BAY,RANGWE,18,1286,1097,2383
HOMA BAY,RANGWE,19,1252,1263,2515
HOMA BAY,RANGWE,15-19,7384,7140,14524
HOMA BAY,RANGWE,20,1039,1169,2208
HOMA BAY,RANGWE,21,897,1031,1928
HOMA BAY,RANGWE,22,740,953,1693
HOMA BAY,RANGWE,23,778,1018,1796
HOMA BAY,RANGWE,24,716,870,1586
HOMA BAY,RANGWE,20-24,4170,5041,9211
HOMA BAY,RANGWE,25,748,881,1629
HOMA BAY,RANGWE,26,634,796,1430
HOMA BAY,RANGWE,27,597,844,1441
HOMA BAY,RANGWE,28,431,694,1125
HOMA BAY,RANGWE,29,425,697,1122
HOMA BAY,RANGWE,25-29,2835,3912,6747
HOMA BAY,RANGWE,30,624,1106,1730
HOMA BAY,RANGWE,31,479,770,1249
HOMA BAY,RANGWE,32,627,1119,1746
HOMA BAY,RANGWE,33,548,941,1489
HOMA BAY,RANGWE,34,497,749,1246
HOMA BAY,RANGWE,30-34,2775,4685,7460
HOMA BAY,RANGWE,35,689,885,1574
HOMA BAY,RANGWE,36,487,445,932
HOMA BAY,RANGWE,37,448,431,879
HOMA BAY,RANGWE,38,346,290,636
HOMA BAY,RANGWE,39,409,430,839
HOMA BAY,RANGWE,35-39,2379,2481,4860
HOMA BAY,RANGWE,40,489,594,1083
HOMA BAY,RANGWE,41,434,436,870
HOMA BAY,RANGWE,42,394,439,833
HOMA BAY,RANGWE,43,372,437,809
HOMA BAY,RANGWE,44,259,376,635
HOMA BAY,RANGWE,40-44,1948,2282,4230
HOMA BAY,RANGWE,45,398,600,998
HOMA BAY,RANGWE,46,280,360,640
HOMA BAY,RANGWE,47,275,407,682
HOMA BAY,RANGWE,48,172,219,391
HOMA BAY,RANGWE,49,201,315,516
HOMA BAY,RANGWE,45-49,1326,1901,3227
HOMA BAY,RANGWE,50,315,522,837
HOMA BAY,RANGWE,51,225,381,606
HOMA BAY,RANGWE,52,191,288,479
HOMA BAY,RANGWE,53,146,197,343
HOMA BAY,RANGWE,54,190,250,440
HOMA BAY,RANGWE,50-54,1067,1638,2705
HOMA BAY,RANGWE,55,253,284,537
HOMA BAY,RANGWE,56,257,415,672
HOMA BAY,RANGWE,57,248,438,686
HOMA BAY,RANGWE,58,146,208,354
HOMA BAY,RANGWE,59,196,303,499
HOMA BAY,RANGWE,55-59,1100,1648,2748
HOMA BAY,RANGWE,60,285,459,744
HOMA BAY,RANGWE,61,251,310,561
HOMA BAY,RANGWE,62,188,248,436
HOMA BAY,RANGWE,63,204,234,438
HOMA BAY,RANGWE,64,145,233,378
HOMA BAY,RANGWE,60-64,1073,1484,2557
HOMA BAY,RANGWE,65,217,331,548
HOMA BAY,RANGWE,66,145,196,341
HOMA BAY,RANGWE,67,220,346,566
HOMA BAY,RANGWE,68,92,135,227
HOMA BAY,RANGWE,69,153,223,376
HOMA BAY,RANGWE,65-69,827,1231,2058
HOMA BAY,RANGWE,70,252,345,597
HOMA BAY,RANGWE,71,163,204,367
HOMA BAY,RANGWE,72,128,155,283
HOMA BAY,RANGWE,73,90,103,193
HOMA BAY,RANGWE,74,76,161,237
HOMA BAY,RANGWE,70-74,709,968,1677
HOMA BAY,RANGWE,75,78,131,209
HOMA BAY,RANGWE,76,66,89,155
HOMA BAY,RANGWE,77,87,141,228
HOMA BAY,RANGWE,78,34,76,110
HOMA BAY,RANGWE,79,47,158,205
HOMA BAY,RANGWE,75-79,312,595,907
HOMA BAY,RANGWE,80,59,152,211
HOMA BAY,RANGWE,81,47,80,127
HOMA BAY,RANGWE,82,42,45,87
HOMA BAY,RANGWE,83,55,45,100
HOMA BAY,RANGWE,84,30,71,101
HOMA BAY,RANGWE,80-84,233,393,626
HOMA BAY,RANGWE,85,27,55,82
HOMA BAY,RANGWE,86,37,49,86
HOMA BAY,RANGWE,87,26,65,91
HOMA BAY,RANGWE,88,17,16,33
HOMA BAY,RANGWE,89,27,51,78
HOMA BAY,RANGWE,85-89,134,236,370
HOMA BAY,RANGWE,90,18,40,58
HOMA BAY,RANGWE,91,13,14,27
HOMA BAY,RANGWE,92,7,13,20
HOMA BAY,RANGWE,93,6,6,12
HOMA BAY,RANGWE,94,6,6,12
HOMA BAY,RANGWE,90-94,50,79,129
HOMA BAY,RANGWE,95,8,9,17
HOMA BAY,RANGWE,96,5,4,9
HOMA BAY,RANGWE,97,4,8,12
HOMA BAY,RANGWE,98,1,3,4
HOMA BAY,RANGWE,99,6,10,16
HOMA BAY,RANGWE,95-99,24,34,58
HOMA BAY,RANGWE,100+,10,15,25
HOMA BAY,RANGWE,Not Stated,-,-,-
HOMA BAY,SUBA NORTH,Total,60530,64406,124936
HOMA BAY,SUBA NORTH,0,1582,1507,3089
HOMA BAY,SUBA NORTH,1,1520,1538,3058
HOMA BAY,SUBA NORTH,2,1616,1707,3323
HOMA BAY,SUBA NORTH,3,1742,1839,3581
HOMA BAY,SUBA NORTH,4,1837,1852,3689
HOMA BAY,SUBA NORTH,0 - 4,8297,8443,16740
HOMA BAY,SUBA NORTH,5,1778,1872,3650
HOMA BAY,SUBA NORTH,6,1803,1884,3687
HOMA BAY,SUBA NORTH,7,1730,1784,3514
HOMA BAY,SUBA NORTH,8,1672,1654,3326
HOMA BAY,SUBA NORTH,9,1874,1862,3736
HOMA BAY,SUBA NORTH,05-Sep,8857,9056,17913
HOMA BAY,SUBA NORTH,10,1933,1957,3890
HOMA BAY,SUBA NORTH,11,1757,1870,3627
HOMA BAY,SUBA NORTH,12,2065,1970,4035
HOMA BAY,SUBA NORTH,13,2032,1956,3988
HOMA BAY,SUBA NORTH,14,1804,1719,3523
HOMA BAY,SUBA NORTH,Oct-14,9591,9472,19063
HOMA BAY,SUBA NORTH,15,1741,1746,3487
HOMA BAY,SUBA NORTH,16,1611,1553,3164
HOMA BAY,SUBA NORTH,17,1486,1465,2951
HOMA BAY,SUBA NORTH,18,1146,1121,2267
HOMA BAY,SUBA NORTH,19,1290,1292,2582
HOMA BAY,SUBA NORTH,15-19,7274,7177,14451
HOMA BAY,SUBA NORTH,20,1194,1338,2532
HOMA BAY,SUBA NORTH,21,937,1170,2107
HOMA BAY,SUBA NORTH,22,859,1183,2042
HOMA BAY,SUBA NORTH,23,1042,1219,2261
HOMA BAY,SUBA NORTH,24,925,1050,1975
HOMA BAY,SUBA NORTH,20-24,4957,5960,10917
HOMA BAY,SUBA NORTH,25,1147,1319,2466
HOMA BAY,SUBA NORTH,26,838,1074,1912
HOMA BAY,SUBA NORTH,27,817,1077,1894
HOMA BAY,SUBA NORTH,28,651,794,1445
HOMA BAY,SUBA NORTH,29,659,793,1452
HOMA BAY,SUBA NORTH,25-29,4112,5057,9169
HOMA BAY,SUBA NORTH,30,1010,1283,2293
HOMA BAY,SUBA NORTH,31,717,811,1528
HOMA BAY,SUBA NORTH,32,984,1139,2123
HOMA BAY,SUBA NORTH,33,896,969,1865
HOMA BAY,SUBA NORTH,34,789,836,1625
HOMA BAY,SUBA NORTH,30-34,4396,5038,9434
HOMA BAY,SUBA NORTH,35,1043,1024,2067
HOMA BAY,SUBA NORTH,36,830,687,1517
HOMA BAY,SUBA NORTH,37,694,552,1246
HOMA BAY,SUBA NORTH,38,512,366,878
HOMA BAY,SUBA NORTH,39,592,460,1052
HOMA BAY,SUBA NORTH,35-39,3671,3089,6760
HOMA BAY,SUBA NORTH,40,764,654,1418
HOMA BAY,SUBA NORTH,41,588,473,1061
HOMA BAY,SUBA NORTH,42,558,490,1048
HOMA BAY,SUBA NORTH,43,503,508,1011
HOMA BAY,SUBA NORTH,44,449,401,850
HOMA BAY,SUBA NORTH,40-44,2862,2526,5388
HOMA BAY,SUBA NORTH,45,511,516,1027
HOMA BAY,SUBA NORTH,46,353,343,696
HOMA BAY,SUBA NORTH,47,405,407,812
HOMA BAY,SUBA NORTH,48,235,227,462
HOMA BAY,SUBA NORTH,49,251,234,485
HOMA BAY,SUBA NORTH,45-49,1755,1727,3482
HOMA BAY,SUBA NORTH,50,315,353,668
HOMA BAY,SUBA NORTH,51,229,280,509
HOMA BAY,SUBA NORTH,52,192,226,418
HOMA BAY,SUBA NORTH,53,197,213,410
HOMA BAY,SUBA NORTH,54,201,235,436
HOMA BAY,SUBA NORTH,50-54,1134,1307,2441
HOMA BAY,SUBA NORTH,55,234,255,489
HOMA BAY,SUBA NORTH,56,248,355,603
HOMA BAY,SUBA NORTH,57,222,376,598
HOMA BAY,SUBA NORTH,58,137,198,335
HOMA BAY,SUBA NORTH,59,174,242,416
HOMA BAY,SUBA NORTH,55-59,1015,1426,2441
HOMA BAY,SUBA NORTH,60,240,356,596
HOMA BAY,SUBA NORTH,61,187,280,467
HOMA BAY,SUBA NORTH,62,151,194,345
HOMA BAY,SUBA NORTH,63,153,244,397
HOMA BAY,SUBA NORTH,64,129,182,311
HOMA BAY,SUBA NORTH,60-64,860,1256,2116
HOMA BAY,SUBA NORTH,65,179,243,422
HOMA BAY,SUBA NORTH,66,110,163,273
HOMA BAY,SUBA NORTH,67,187,299,486
HOMA BAY,SUBA NORTH,68,63,105,168
HOMA BAY,SUBA NORTH,69,110,176,286
HOMA BAY,SUBA NORTH,65-69,649,986,1635
HOMA BAY,SUBA NORTH,70,162,303,465
HOMA BAY,SUBA NORTH,71,108,159,267
HOMA BAY,SUBA NORTH,72,89,118,207
HOMA BAY,SUBA NORTH,73,70,114,184
HOMA BAY,SUBA NORTH,74,76,113,189
HOMA BAY,SUBA NORTH,70-74,505,807,1312
HOMA BAY,SUBA NORTH,75,61,114,175
HOMA BAY,SUBA NORTH,76,49,83,132
HOMA BAY,SUBA NORTH,77,66,111,177
HOMA BAY,SUBA NORTH,78,33,55,88
HOMA BAY,SUBA NORTH,79,39,108,147
HOMA BAY,SUBA NORTH,75-79,248,471,719
HOMA BAY,SUBA NORTH,80,44,89,133
HOMA BAY,SUBA NORTH,81,41,71,112
HOMA BAY,SUBA NORTH,82,40,38,78
HOMA BAY,SUBA NORTH,83,39,38,77
HOMA BAY,SUBA NORTH,84,29,52,81
HOMA BAY,SUBA NORTH,80-84,193,288,481
HOMA BAY,SUBA NORTH,85,23,57,80
HOMA BAY,SUBA NORTH,86,19,34,53
HOMA BAY,SUBA NORTH,87,25,50,75
HOMA BAY,SUBA NORTH,88,11,15,26
HOMA BAY,SUBA NORTH,89,10,54,64
HOMA BAY,SUBA NORTH,85-89,88,210,298
HOMA BAY,SUBA NORTH,90,22,26,48
HOMA BAY,SUBA NORTH,91,9,17,26
HOMA BAY,SUBA NORTH,92,5,8,13
HOMA BAY,SUBA NORTH,93,3,10,13
HOMA BAY,SUBA NORTH,94,4,11,15
HOMA BAY,SUBA NORTH,90-94,43,72,115
HOMA BAY,SUBA NORTH,95,6,7,13
HOMA BAY,SUBA NORTH,96,2,8,10
HOMA BAY,SUBA NORTH,97,4,4,8
HOMA BAY,SUBA NORTH,98,1,2,3
HOMA BAY,SUBA NORTH,99,3,5,8
HOMA BAY,SUBA NORTH,95-99,16,26,42
HOMA BAY,SUBA NORTH,100+,7,12,19
HOMA BAY,SUBA NORTH,Not Stated,-,-,-
HOMA BAY,SUBA SOUTH,Total,59383,62998,122381
HOMA BAY,SUBA SOUTH,0,1698,1636,3334
HOMA BAY,SUBA SOUTH,1,1690,1693,3383
HOMA BAY,SUBA SOUTH,2,1728,1759,3487
HOMA BAY,SUBA SOUTH,3,1948,1928,3876
HOMA BAY,SUBA SOUTH,4,1820,1824,3644
HOMA BAY,SUBA SOUTH,0 - 4,8884,8840,17724
HOMA BAY,SUBA SOUTH,5,2004,1959,3963
HOMA BAY,SUBA SOUTH,6,1923,1928,3851
HOMA BAY,SUBA SOUTH,7,1697,1717,3414
HOMA BAY,SUBA SOUTH,8,1762,1777,3539
HOMA BAY,SUBA SOUTH,9,1922,1909,3831
HOMA BAY,SUBA SOUTH,05-Sep,9308,9290,18598
HOMA BAY,SUBA SOUTH,10,2045,2006,4051
HOMA BAY,SUBA SOUTH,11,1821,1779,3600
HOMA BAY,SUBA SOUTH,12,2113,2133,4246
HOMA BAY,SUBA SOUTH,13,1935,1970,3905
HOMA BAY,SUBA SOUTH,14,1768,1681,3449
HOMA BAY,SUBA SOUTH,Oct-14,9682,9569,19251
HOMA BAY,SUBA SOUTH,15,1779,1746,3525
HOMA BAY,SUBA SOUTH,16,1542,1489,3031
HOMA BAY,SUBA SOUTH,17,1454,1408,2862
HOMA BAY,SUBA SOUTH,18,1233,1119,2352
HOMA BAY,SUBA SOUTH,19,1241,1358,2599
HOMA BAY,SUBA SOUTH,15-19,7249,7120,14369
HOMA BAY,SUBA SOUTH,20,1157,1368,2525
HOMA BAY,SUBA SOUTH,21,964,1205,2169
HOMA BAY,SUBA SOUTH,22,850,1085,1935
HOMA BAY,SUBA SOUTH,23,1000,1149,2149
HOMA BAY,SUBA SOUTH,24,895,1045,1940
HOMA BAY,SUBA SOUTH,20-24,4866,5852,10718
HOMA BAY,SUBA SOUTH,25,1118,1152,2270
HOMA BAY,SUBA SOUTH,26,789,941,1730
HOMA BAY,SUBA SOUTH,27,815,1030,1845
HOMA BAY,SUBA SOUTH,28,507,716,1223
HOMA BAY,SUBA SOUTH,29,572,778,1350
HOMA BAY,SUBA SOUTH,25-29,3801,4617,8418
HOMA BAY,SUBA SOUTH,30,947,1176,2123
HOMA BAY,SUBA SOUTH,31,685,852,1537
HOMA BAY,SUBA SOUTH,32,798,1031,1829
HOMA BAY,SUBA SOUTH,33,698,797,1495
HOMA BAY,SUBA SOUTH,34,645,648,1293
HOMA BAY,SUBA SOUTH,30-34,3773,4504,8277
HOMA BAY,SUBA SOUTH,35,906,863,1769
HOMA BAY,SUBA SOUTH,36,615,536,1151
HOMA BAY,SUBA SOUTH,37,597,509,1106
HOMA BAY,SUBA SOUTH,38,384,283,667
HOMA BAY,SUBA SOUTH,39,469,376,845
HOMA BAY,SUBA SOUTH,35-39,2971,2567,5538
HOMA BAY,SUBA SOUTH,40,586,581,1167
HOMA BAY,SUBA SOUTH,41,491,417,908
HOMA BAY,SUBA SOUTH,42,460,491,951
HOMA BAY,SUBA SOUTH,43,423,420,843
HOMA BAY,SUBA SOUTH,44,368,394,762
HOMA BAY,SUBA SOUTH,40-44,2328,2303,4631
HOMA BAY,SUBA SOUTH,45,519,567,1086
HOMA BAY,SUBA SOUTH,46,352,399,751
HOMA BAY,SUBA SOUTH,47,415,479,894
HOMA BAY,SUBA SOUTH,48,235,216,451
HOMA BAY,SUBA SOUTH,49,269,269,538
HOMA BAY,SUBA SOUTH,45-49,1790,1930,3720
HOMA BAY,SUBA SOUTH,50,303,379,682
HOMA BAY,SUBA SOUTH,51,229,266,495
HOMA BAY,SUBA SOUTH,52,190,220,410
HOMA BAY,SUBA SOUTH,53,183,180,363
HOMA BAY,SUBA SOUTH,54,175,167,342
HOMA BAY,SUBA SOUTH,50-54,1080,1212,2292
HOMA BAY,SUBA SOUTH,55,194,220,414
HOMA BAY,SUBA SOUTH,56,215,308,523
HOMA BAY,SUBA SOUTH,57,229,348,577
HOMA BAY,SUBA SOUTH,58,120,160,280
HOMA BAY,SUBA SOUTH,59,198,262,460
HOMA BAY,SUBA SOUTH,55-59,956,1298,2254
HOMA BAY,SUBA SOUTH,60,201,320,521
HOMA BAY,SUBA SOUTH,61,201,248,449
HOMA BAY,SUBA SOUTH,62,139,162,301
HOMA BAY,SUBA SOUTH,63,133,195,328
HOMA BAY,SUBA SOUTH,64,132,174,306
HOMA BAY,SUBA SOUTH,60-64,806,1099,1905
HOMA BAY,SUBA SOUTH,65,173,209,382
HOMA BAY,SUBA SOUTH,66,110,158,268
HOMA BAY,SUBA SOUTH,67,174,267,441
HOMA BAY,SUBA SOUTH,68,73,96,169
HOMA BAY,SUBA SOUTH,69,147,201,348
HOMA BAY,SUBA SOUTH,65-69,677,931,1608
HOMA BAY,SUBA SOUTH,70,145,291,436
HOMA BAY,SUBA SOUTH,71,115,176,291
HOMA BAY,SUBA SOUTH,72,106,118,224
HOMA BAY,SUBA SOUTH,73,74,100,174
HOMA BAY,SUBA SOUTH,74,82,140,222
HOMA BAY,SUBA SOUTH,70-74,522,825,1347
HOMA BAY,SUBA SOUTH,75,57,111,168
HOMA BAY,SUBA SOUTH,76,46,83,129
HOMA BAY,SUBA SOUTH,77,75,115,190
HOMA BAY,SUBA SOUTH,78,28,44,72
HOMA BAY,SUBA SOUTH,79,51,105,156
HOMA BAY,SUBA SOUTH,75-79,257,458,715
HOMA BAY,SUBA SOUTH,80,74,132,206
HOMA BAY,SUBA SOUTH,81,46,54,100
HOMA BAY,SUBA SOUTH,82,39,35,74
HOMA BAY,SUBA SOUTH,83,50,45,95
HOMA BAY,SUBA SOUTH,84,29,56,85
HOMA BAY,SUBA SOUTH,80-84,238,322,560
HOMA BAY,SUBA SOUTH,85,24,43,67
HOMA BAY,SUBA SOUTH,86,27,26,53
HOMA BAY,SUBA SOUTH,87,31,38,69
HOMA BAY,SUBA SOUTH,88,6,15,21
HOMA BAY,SUBA SOUTH,89,30,47,77
HOMA BAY,SUBA SOUTH,85-89,118,169,287
HOMA BAY,SUBA SOUTH,90,14,24,38
HOMA BAY,SUBA SOUTH,91,15,15,30
HOMA BAY,SUBA SOUTH,92,7,6,13
HOMA BAY,SUBA SOUTH,93,2,10,12
HOMA BAY,SUBA SOUTH,94,6,2,8
HOMA BAY,SUBA SOUTH,90-94,44,57,101
HOMA BAY,SUBA SOUTH,95,4,6,10
HOMA BAY,SUBA SOUTH,96,7,3,10
HOMA BAY,SUBA SOUTH,97,5,8,13
HOMA BAY,SUBA SOUTH,98,2,2,4
HOMA BAY,SUBA SOUTH,99,6,9,15
HOMA BAY,SUBA SOUTH,95-99,24,28,52
HOMA BAY,SUBA SOUTH,100+,8,6,14
HOMA BAY,SUBA SOUTH,Not Stated,1,1,2
ISIOLO,ALL,Total,139510,128483,267993
ISIOLO,ALL,0,3277,3254,6531
ISIOLO,ALL,1,3401,3385,6786
ISIOLO,ALL,2,4691,4527,9218
ISIOLO,ALL,3,4422,4357,8779
ISIOLO,ALL,4,4654,4649,9303
ISIOLO,ALL,0 - 4,20445,20172,40617
ISIOLO,ALL,5,4515,4318,8833
ISIOLO,ALL,6,4576,4339,8915
ISIOLO,ALL,7,3983,3803,7786
ISIOLO,ALL,8,4459,4269,8728
ISIOLO,ALL,9,3536,3347,6883
ISIOLO,ALL,05-Sep,21069,20076,41145
ISIOLO,ALL,10,5462,4939,10401
ISIOLO,ALL,11,3070,3095,6165
ISIOLO,ALL,12,4618,3781,8399
ISIOLO,ALL,13,3582,3309,6891
ISIOLO,ALL,14,3757,3301,7058
ISIOLO,ALL,Oct-14,20489,18425,38914
ISIOLO,ALL,15,4471,3498,7969
ISIOLO,ALL,16,3444,2937,6381
ISIOLO,ALL,17,3784,2986,6770
ISIOLO,ALL,18,3175,2720,5895
ISIOLO,ALL,19,2134,2005,4139
ISIOLO,ALL,15-19,17008,14146,31154
ISIOLO,ALL,20,3728,3573,7301
ISIOLO,ALL,21,2048,2048,4096
ISIOLO,ALL,22,2358,2425,4783
ISIOLO,ALL,23,2212,2254,4466
ISIOLO,ALL,24,2096,1981,4077
ISIOLO,ALL,20-24,12442,12281,24723
ISIOLO,ALL,25,3177,2942,6119
ISIOLO,ALL,26,1913,2018,3931
ISIOLO,ALL,27,1925,1808,3733
ISIOLO,ALL,28,1960,1847,3807
ISIOLO,ALL,29,1461,1425,2886
ISIOLO,ALL,25-29,10436,10040,20476
ISIOLO,ALL,30,3507,3095,6602
ISIOLO,ALL,31,1474,1471,2945
ISIOLO,ALL,32,1894,1882,3776
ISIOLO,ALL,33,1327,1327,2654
ISIOLO,ALL,34,1304,1269,2573
ISIOLO,ALL,30-34,9506,9044,18550
ISIOLO,ALL,35,2500,2243,4743
ISIOLO,ALL,36,1287,1151,2438
ISIOLO,ALL,37,1133,937,2070
ISIOLO,ALL,38,1084,888,1972
ISIOLO,ALL,39,799,665,1464
ISIOLO,ALL,35-39,6803,5884,12687
ISIOLO,ALL,40,2362,1715,4077
ISIOLO,ALL,41,1129,1089,2218
ISIOLO,ALL,42,924,696,1620
ISIOLO,ALL,43,633,479,1112
ISIOLO,ALL,44,406,348,754
ISIOLO,ALL,40-44,5454,4327,9781
ISIOLO,ALL,45,1450,1285,2735
ISIOLO,ALL,46,720,651,1371
ISIOLO,ALL,47,595,543,1138
ISIOLO,ALL,48,567,427,994
ISIOLO,ALL,49,515,370,885
ISIOLO,ALL,45-49,3847,3276,7123
ISIOLO,ALL,50,1336,1106,2442
ISIOLO,ALL,51,363,307,670
ISIOLO,ALL,52,481,414,895
ISIOLO,ALL,53,379,264,643
ISIOLO,ALL,54,464,364,828
ISIOLO,ALL,50-54,3023,2455,5478
ISIOLO,ALL,55,605,492,1097
ISIOLO,ALL,56,567,470,1037
ISIOLO,ALL,57,389,497,886
ISIOLO,ALL,58,426,450,876
ISIOLO,ALL,59,448,486,934
ISIOLO,ALL,55-59,2435,2395,4830
ISIOLO,ALL,60,1041,843,1884
ISIOLO,ALL,61,377,396,773
ISIOLO,ALL,62,376,237,613
ISIOLO,ALL,63,371,287,658
ISIOLO,ALL,64,276,197,473
ISIOLO,ALL,60-64,2441,1960,4401
ISIOLO,ALL,65,428,424,852
ISIOLO,ALL,66,211,210,421
ISIOLO,ALL,67,279,226,505
ISIOLO,ALL,68,212,145,357
ISIOLO,ALL,69,269,207,476
ISIOLO,ALL,65-69,1399,1212,2611
ISIOLO,ALL,70,619,564,1183
ISIOLO,ALL,71,172,286,458
ISIOLO,ALL,72,155,126,281
ISIOLO,ALL,73,150,103,253
ISIOLO,ALL,74,141,106,247
ISIOLO,ALL,70-74,1237,1185,2422
ISIOLO,ALL,75,167,152,319
ISIOLO,ALL,76,97,120,217
ISIOLO,ALL,77,95,59,154
ISIOLO,ALL,78,107,71,178
ISIOLO,ALL,79,123,121,244
ISIOLO,ALL,75-79,589,523,1112
ISIOLO,ALL,80,218,250,468
ISIOLO,ALL,81,68,148,216
ISIOLO,ALL,82,64,46,110
ISIOLO,ALL,83,58,47,105
ISIOLO,ALL,84,49,64,113
ISIOLO,ALL,80-84,457,555,1012
ISIOLO,ALL,85,63,69,132
ISIOLO,ALL,86,41,30,71
ISIOLO,ALL,87,36,34,70
ISIOLO,ALL,88,30,32,62
ISIOLO,ALL,89,55,80,135
ISIOLO,ALL,85-89,225,245,470
ISIOLO,ALL,90,59,81,140
ISIOLO,ALL,91,24,44,68
ISIOLO,ALL,92,19,15,34
ISIOLO,ALL,93,15,12,27
ISIOLO,ALL,94,12,13,25
ISIOLO,ALL,90-94,129,165,294
ISIOLO,ALL,95,11,25,36
ISIOLO,ALL,96,8,12,20
ISIOLO,ALL,97,9,12,21
ISIOLO,ALL,98,7,10,17
ISIOLO,ALL,99,12,16,28
ISIOLO,ALL,95-99,47,75,122
ISIOLO,ALL,100+,28,42,70
ISIOLO,ALL,Not Stated,1,-,1
ISIOLO,GARBATULLA,Total,54661,45068,99729
ISIOLO,GARBATULLA,0,853,777,1630
ISIOLO,GARBATULLA,1,1136,1177,2313
ISIOLO,GARBATULLA,2,1864,1696,3560
ISIOLO,GARBATULLA,3,1705,1583,3288
ISIOLO,GARBATULLA,4,1886,1805,3691
ISIOLO,GARBATULLA,0 - 4,7444,7038,14482
ISIOLO,GARBATULLA,5,1811,1731,3542
ISIOLO,GARBATULLA,6,1948,1780,3728
ISIOLO,GARBATULLA,7,1436,1417,2853
ISIOLO,GARBATULLA,8,2012,1760,3772
ISIOLO,GARBATULLA,9,1344,1243,2587
ISIOLO,GARBATULLA,05-Sep,8551,7931,16482
ISIOLO,GARBATULLA,10,2537,2186,4723
ISIOLO,GARBATULLA,11,1088,1207,2295
ISIOLO,GARBATULLA,12,2106,1382,3488
ISIOLO,GARBATULLA,13,1435,1119,2554
ISIOLO,GARBATULLA,14,1692,1151,2843
ISIOLO,GARBATULLA,Oct-14,8858,7045,15903
ISIOLO,GARBATULLA,15,2113,1352,3465
ISIOLO,GARBATULLA,16,1606,1063,2669
ISIOLO,GARBATULLA,17,1758,987,2745
ISIOLO,GARBATULLA,18,1376,953,2329
ISIOLO,GARBATULLA,19,703,493,1196
ISIOLO,GARBATULLA,15-19,7556,4848,12404
ISIOLO,GARBATULLA,20,1722,1335,3057
ISIOLO,GARBATULLA,21,672,570,1242
ISIOLO,GARBATULLA,22,750,698,1448
ISIOLO,GARBATULLA,23,771,663,1434
ISIOLO,GARBATULLA,24,696,657,1353
ISIOLO,GARBATULLA,20-24,4611,3923,8534
ISIOLO,GARBATULLA,25,1320,1110,2430
ISIOLO,GARBATULLA,26,680,595,1275
ISIOLO,GARBATULLA,27,632,558,1190
ISIOLO,GARBATULLA,28,742,687,1429
ISIOLO,GARBATULLA,29,506,437,943
ISIOLO,GARBATULLA,25-29,3880,3387,7267
ISIOLO,GARBATULLA,30,1540,1177,2717
ISIOLO,GARBATULLA,31,434,396,830
ISIOLO,GARBATULLA,32,627,593,1220
ISIOLO,GARBATULLA,33,385,386,771
ISIOLO,GARBATULLA,34,413,399,812
ISIOLO,GARBATULLA,30-34,3399,2951,6350
ISIOLO,GARBATULLA,35,1006,878,1884
ISIOLO,GARBATULLA,36,520,442,962
ISIOLO,GARBATULLA,37,367,295,662
ISIOLO,GARBATULLA,38,434,359,793
ISIOLO,GARBATULLA,39,250,181,431
ISIOLO,GARBATULLA,35-39,2577,2155,4732
ISIOLO,GARBATULLA,40,1096,693,1789
ISIOLO,GARBATULLA,41,402,356,758
ISIOLO,GARBATULLA,42,324,204,528
ISIOLO,GARBATULLA,43,200,137,337
ISIOLO,GARBATULLA,44,94,68,162
ISIOLO,GARBATULLA,40-44,2116,1458,3574
ISIOLO,GARBATULLA,45,553,449,1002
ISIOLO,GARBATULLA,46,223,193,416
ISIOLO,GARBATULLA,47,165,153,318
ISIOLO,GARBATULLA,48,195,146,341
ISIOLO,GARBATULLA,49,162,86,248
ISIOLO,GARBATULLA,45-49,1298,1027,2325
ISIOLO,GARBATULLA,50,592,394,986
ISIOLO,GARBATULLA,51,90,64,154
ISIOLO,GARBATULLA,52,168,131,299
ISIOLO,GARBATULLA,53,123,69,192
ISIOLO,GARBATULLA,54,173,136,309
ISIOLO,GARBATULLA,50-54,1146,794,1940
ISIOLO,GARBATULLA,55,225,149,374
ISIOLO,GARBATULLA,56,185,138,323
ISIOLO,GARBATULLA,57,140,143,283
ISIOLO,GARBATULLA,58,151,156,307
ISIOLO,GARBATULLA,59,126,144,270
ISIOLO,GARBATULLA,55-59,827,730,1557
ISIOLO,GARBATULLA,60,442,277,719
ISIOLO,GARBATULLA,61,136,139,275
ISIOLO,GARBATULLA,62,157,77,234
ISIOLO,GARBATULLA,63,139,102,241
ISIOLO,GARBATULLA,64,101,58,159
ISIOLO,GARBATULLA,60-64,975,653,1628
ISIOLO,GARBATULLA,65,135,123,258
ISIOLO,GARBATULLA,66,79,57,136
ISIOLO,GARBATULLA,67,99,72,171
ISIOLO,GARBATULLA,68,70,45,115
ISIOLO,GARBATULLA,69,107,62,169
ISIOLO,GARBATULLA,65-69,490,359,849
ISIOLO,GARBATULLA,70,231,164,395
ISIOLO,GARBATULLA,71,54,79,133
ISIOLO,GARBATULLA,72,56,37,93
ISIOLO,GARBATULLA,73,50,30,80
ISIOLO,GARBATULLA,74,51,32,83
ISIOLO,GARBATULLA,70-74,442,342,784
ISIOLO,GARBATULLA,75,51,29,80
ISIOLO,GARBATULLA,76,41,26,67
ISIOLO,GARBATULLA,77,30,23,53
ISIOLO,GARBATULLA,78,47,16,63
ISIOLO,GARBATULLA,79,44,29,73
ISIOLO,GARBATULLA,75-79,213,123,336
ISIOLO,GARBATULLA,80,76,64,140
ISIOLO,GARBATULLA,81,24,53,77
ISIOLO,GARBATULLA,82,12,11,23
ISIOLO,GARBATULLA,83,11,14,25
ISIOLO,GARBATULLA,84,18,12,30
ISIOLO,GARBATULLA,80-84,141,154,295
ISIOLO,GARBATULLA,85,14,21,35
ISIOLO,GARBATULLA,86,9,9,18
ISIOLO,GARBATULLA,87,14,12,26
ISIOLO,GARBATULLA,88,10,8,18
ISIOLO,GARBATULLA,89,22,17,39
ISIOLO,GARBATULLA,85-89,69,67,136
ISIOLO,GARBATULLA,90,15,23,38
ISIOLO,GARBATULLA,91,11,15,26
ISIOLO,GARBATULLA,92,6,5,11
ISIOLO,GARBATULLA,93,3,2,5
ISIOLO,GARBATULLA,94,5,3,8
ISIOLO,GARBATULLA,90-94,40,48,88
ISIOLO,GARBATULLA,95,4,5,9
ISIOLO,GARBATULLA,96,4,6,10
ISIOLO,GARBATULLA,97,5,3,8
ISIOLO,GARBATULLA,98,2,3,5
ISIOLO,GARBATULLA,99,4,8,12
ISIOLO,GARBATULLA,95-99,19,25,44
ISIOLO,GARBATULLA,100+,9,10,19
ISIOLO,GARBATULLA,Not Stated,-,-,-
ISIOLO,ISIOLO,Total,60414,60647,121061
ISIOLO,ISIOLO,0,1723,1729,3452
ISIOLO,ISIOLO,1,1664,1602,3266
ISIOLO,ISIOLO,2,1879,1833,3712
ISIOLO,ISIOLO,3,1893,1870,3763
ISIOLO,ISIOLO,4,1850,1829,3679
ISIOLO,ISIOLO,0 - 4,9009,8863,17872
ISIOLO,ISIOLO,5,1861,1755,3616
ISIOLO,ISIOLO,6,1761,1678,3439
ISIOLO,ISIOLO,7,1741,1662,3403
ISIOLO,ISIOLO,8,1580,1643,3223
ISIOLO,ISIOLO,9,1513,1477,2990
ISIOLO,ISIOLO,05-Sep,8456,8215,16671
ISIOLO,ISIOLO,10,1829,1781,3610
ISIOLO,ISIOLO,11,1411,1316,2727
ISIOLO,ISIOLO,12,1741,1688,3429
ISIOLO,ISIOLO,13,1515,1593,3108
ISIOLO,ISIOLO,14,1466,1546,3012
ISIOLO,ISIOLO,Oct-14,7962,7924,15886
ISIOLO,ISIOLO,15,1604,1467,3071
ISIOLO,ISIOLO,16,1302,1391,2693
ISIOLO,ISIOLO,17,1376,1340,2716
ISIOLO,ISIOLO,18,1199,1284,2483
ISIOLO,ISIOLO,19,1110,1230,2340
ISIOLO,ISIOLO,15-19,6591,6712,13303
ISIOLO,ISIOLO,20,1194,1562,2756
ISIOLO,ISIOLO,21,1056,1188,2244
ISIOLO,ISIOLO,22,1165,1392,2557
ISIOLO,ISIOLO,23,1105,1317,2422
ISIOLO,ISIOLO,24,1128,1083,2211
ISIOLO,ISIOLO,20-24,5648,6542,12190
ISIOLO,ISIOLO,25,1331,1394,2725
ISIOLO,ISIOLO,26,987,1172,2159
ISIOLO,ISIOLO,27,1015,1014,2029
ISIOLO,ISIOLO,28,916,897,1813
ISIOLO,ISIOLO,29,763,811,1574
ISIOLO,ISIOLO,25-29,5012,5288,10300
ISIOLO,ISIOLO,30,1282,1328,2610
ISIOLO,ISIOLO,31,814,813,1627
ISIOLO,ISIOLO,32,1005,1070,2075
ISIOLO,ISIOLO,33,750,757,1507
ISIOLO,ISIOLO,34,690,667,1357
ISIOLO,ISIOLO,30-34,4541,4635,9176
ISIOLO,ISIOLO,35,1144,1018,2162
ISIOLO,ISIOLO,36,625,568,1193
ISIOLO,ISIOLO,37,599,515,1114
ISIOLO,ISIOLO,38,514,409,923
ISIOLO,ISIOLO,39,457,396,853
ISIOLO,ISIOLO,35-39,3339,2906,6245
ISIOLO,ISIOLO,40,843,721,1564
ISIOLO,ISIOLO,41,556,569,1125
ISIOLO,ISIOLO,42,479,418,897
ISIOLO,ISIOLO,43,367,297,664
ISIOLO,ISIOLO,44,258,244,502
ISIOLO,ISIOLO,40-44,2503,2249,4752
ISIOLO,ISIOLO,45,652,645,1297
ISIOLO,ISIOLO,46,410,381,791
ISIOLO,ISIOLO,47,364,323,687
ISIOLO,ISIOLO,48,300,219,519
ISIOLO,ISIOLO,49,311,246,557
ISIOLO,ISIOLO,45-49,2037,1814,3851
ISIOLO,ISIOLO,50,496,455,951
ISIOLO,ISIOLO,51,215,203,418
ISIOLO,ISIOLO,52,238,202,440
ISIOLO,ISIOLO,53,196,150,346
ISIOLO,ISIOLO,54,219,158,377
ISIOLO,ISIOLO,50-54,1364,1168,2532
ISIOLO,ISIOLO,55,272,249,521
ISIOLO,ISIOLO,56,283,257,540
ISIOLO,ISIOLO,57,192,262,454
ISIOLO,ISIOLO,58,202,201,403
ISIOLO,ISIOLO,59,238,275,513
ISIOLO,ISIOLO,55-59,1187,1244,2431
ISIOLO,ISIOLO,60,356,405,761
ISIOLO,ISIOLO,61,167,171,338
ISIOLO,ISIOLO,62,155,120,275
ISIOLO,ISIOLO,63,154,153,307
ISIOLO,ISIOLO,64,87,91,178
ISIOLO,ISIOLO,60-64,919,940,1859
ISIOLO,ISIOLO,65,207,219,426
ISIOLO,ISIOLO,66,98,111,209
ISIOLO,ISIOLO,67,124,121,245
ISIOLO,ISIOLO,68,97,69,166
ISIOLO,ISIOLO,69,125,118,243
ISIOLO,ISIOLO,65-69,651,638,1289
ISIOLO,ISIOLO,70,226,285,511
ISIOLO,ISIOLO,71,85,156,241
ISIOLO,ISIOLO,72,72,71,143
ISIOLO,ISIOLO,73,68,57,125
ISIOLO,ISIOLO,74,73,57,130
ISIOLO,ISIOLO,70-74,524,626,1150
ISIOLO,ISIOLO,75,84,88,172
ISIOLO,ISIOLO,76,44,67,111
ISIOLO,ISIOLO,77,51,29,80
ISIOLO,ISIOLO,78,39,41,80
ISIOLO,ISIOLO,79,61,78,139
ISIOLO,ISIOLO,75-79,279,303,582
ISIOLO,ISIOLO,80,79,141,220
ISIOLO,ISIOLO,81,29,69,98
ISIOLO,ISIOLO,82,37,25,62
ISIOLO,ISIOLO,83,30,28,58
ISIOLO,ISIOLO,84,14,39,53
ISIOLO,ISIOLO,80-84,189,302,491
ISIOLO,ISIOLO,85,32,34,66
ISIOLO,ISIOLO,86,24,18,42
ISIOLO,ISIOLO,87,13,17,30
ISIOLO,ISIOLO,88,11,14,25
ISIOLO,ISIOLO,89,24,48,72
ISIOLO,ISIOLO,85-89,104,131,235
ISIOLO,ISIOLO,90,30,43,73
ISIOLO,ISIOLO,91,8,14,22
ISIOLO,ISIOLO,92,8,10,18
ISIOLO,ISIOLO,93,7,8,15
ISIOLO,ISIOLO,94,6,8,14
ISIOLO,ISIOLO,90-94,59,83,142
ISIOLO,ISIOLO,95,5,14,19
ISIOLO,ISIOLO,96,4,6,10
ISIOLO,ISIOLO,97,3,8,11
ISIOLO,ISIOLO,98,4,6,10
ISIOLO,ISIOLO,99,8,6,14
ISIOLO,ISIOLO,95-99,24,40,64
ISIOLO,ISIOLO,100+,15,24,39
ISIOLO,ISIOLO,Not Stated,1,-,1
ISIOLO,MERTI,Total,24435,22768,47203
ISIOLO,MERTI,0,701,748,1449
ISIOLO,MERTI,1,601,606,1207
ISIOLO,MERTI,2,948,998,1946
ISIOLO,MERTI,3,824,904,1728
ISIOLO,MERTI,4,918,1015,1933
ISIOLO,MERTI,0 - 4,3992,4271,8263
ISIOLO,MERTI,5,843,832,1675
ISIOLO,MERTI,6,867,881,1748
ISIOLO,MERTI,7,806,724,1530
ISIOLO,MERTI,8,867,866,1733
ISIOLO,MERTI,9,679,627,1306
ISIOLO,MERTI,05-Sep,4062,3930,7992
ISIOLO,MERTI,10,1096,972,2068
ISIOLO,MERTI,11,571,572,1143
ISIOLO,MERTI,12,771,711,1482
ISIOLO,MERTI,13,632,597,1229
ISIOLO,MERTI,14,599,604,1203
ISIOLO,MERTI,Oct-14,3669,3456,7125
ISIOLO,MERTI,15,754,679,1433
ISIOLO,MERTI,16,536,483,1019
ISIOLO,MERTI,17,650,659,1309
ISIOLO,MERTI,18,600,483,1083
ISIOLO,MERTI,19,321,282,603
ISIOLO,MERTI,15-19,2861,2586,5447
ISIOLO,MERTI,20,812,676,1488
ISIOLO,MERTI,21,320,290,610
ISIOLO,MERTI,22,443,335,778
ISIOLO,MERTI,23,336,274,610
ISIOLO,MERTI,24,272,241,513
ISIOLO,MERTI,20-24,2183,1816,3999
ISIOLO,MERTI,25,526,438,964
ISIOLO,MERTI,26,246,251,497
ISIOLO,MERTI,27,278,236,514
ISIOLO,MERTI,28,302,263,565
ISIOLO,MERTI,29,192,177,369
ISIOLO,MERTI,25-29,1544,1365,2909
ISIOLO,MERTI,30,685,590,1275
ISIOLO,MERTI,31,226,262,488
ISIOLO,MERTI,32,262,219,481
ISIOLO,MERTI,33,192,184,376
ISIOLO,MERTI,34,201,203,404
ISIOLO,MERTI,30-34,1566,1458,3024
ISIOLO,MERTI,35,350,347,697
ISIOLO,MERTI,36,142,141,283
ISIOLO,MERTI,37,167,127,294
ISIOLO,MERTI,38,136,120,256
ISIOLO,MERTI,39,92,88,180
ISIOLO,MERTI,35-39,887,823,1710
ISIOLO,MERTI,40,423,301,724
ISIOLO,MERTI,41,171,164,335
ISIOLO,MERTI,42,121,74,195
ISIOLO,MERTI,43,66,45,111
ISIOLO,MERTI,44,54,36,90
ISIOLO,MERTI,40-44,835,620,1455
ISIOLO,MERTI,45,245,191,436
ISIOLO,MERTI,46,87,77,164
ISIOLO,MERTI,47,66,67,133
ISIOLO,MERTI,48,72,62,134
ISIOLO,MERTI,49,42,38,80
ISIOLO,MERTI,45-49,512,435,947
ISIOLO,MERTI,50,248,257,505
ISIOLO,MERTI,51,58,40,98
ISIOLO,MERTI,52,75,81,156
ISIOLO,MERTI,53,60,45,105
ISIOLO,MERTI,54,72,70,142
ISIOLO,MERTI,50-54,513,493,1006
ISIOLO,MERTI,55,108,94,202
ISIOLO,MERTI,56,99,75,174
ISIOLO,MERTI,57,57,92,149
ISIOLO,MERTI,58,73,93,166
ISIOLO,MERTI,59,84,67,151
ISIOLO,MERTI,55-59,421,421,842
ISIOLO,MERTI,60,243,161,404
ISIOLO,MERTI,61,74,86,160
ISIOLO,MERTI,62,64,40,104
ISIOLO,MERTI,63,78,32,110
ISIOLO,MERTI,64,88,48,136
ISIOLO,MERTI,60-64,547,367,914
ISIOLO,MERTI,65,86,82,168
ISIOLO,MERTI,66,34,42,76
ISIOLO,MERTI,67,56,33,89
ISIOLO,MERTI,68,45,31,76
ISIOLO,MERTI,69,37,27,64
ISIOLO,MERTI,65-69,258,215,473
ISIOLO,MERTI,70,162,115,277
ISIOLO,MERTI,71,33,51,84
ISIOLO,MERTI,72,27,18,45
ISIOLO,MERTI,73,32,16,48
ISIOLO,MERTI,74,17,17,34
ISIOLO,MERTI,70-74,271,217,488
ISIOLO,MERTI,75,32,35,67
ISIOLO,MERTI,76,12,27,39
ISIOLO,MERTI,77,14,7,21
ISIOLO,MERTI,78,21,14,35
ISIOLO,MERTI,79,18,14,32
ISIOLO,MERTI,75-79,97,97,194
ISIOLO,MERTI,80,63,45,108
ISIOLO,MERTI,81,15,26,41
ISIOLO,MERTI,82,15,10,25
ISIOLO,MERTI,83,17,5,22
ISIOLO,MERTI,84,17,13,30
ISIOLO,MERTI,80-84,127,99,226
ISIOLO,MERTI,85,17,14,31
ISIOLO,MERTI,86,8,3,11
ISIOLO,MERTI,87,9,5,14
ISIOLO,MERTI,88,9,10,19
ISIOLO,MERTI,89,9,15,24
ISIOLO,MERTI,85-89,52,47,99
ISIOLO,MERTI,90,14,15,29
ISIOLO,MERTI,91,5,15,20
ISIOLO,MERTI,92,5,-,5
ISIOLO,MERTI,93,5,2,7
ISIOLO,MERTI,94,1,2,3
ISIOLO,MERTI,90-94,30,34,64
ISIOLO,MERTI,95,2,6,8
ISIOLO,MERTI,96,-,-,-
ISIOLO,MERTI,97,1,1,2
ISIOLO,MERTI,98,1,1,2
ISIOLO,MERTI,99,-,2,2
ISIOLO,MERTI,95-99,4,10,14
ISIOLO,MERTI,100+,4,8,12
ISIOLO,MERTI,Not Stated,-,-,-
KAJIADO,ALL,Total,557098,560704,1117802
KAJIADO,ALL,0,14080,13727,27807
KAJIADO,ALL,1,16314,15934,32248
KAJIADO,ALL,2,15913,15629,31542
KAJIADO,ALL,3,16572,16368,32940
KAJIADO,ALL,4,16064,15727,31791
KAJIADO,ALL,0 - 4,78943,77385,156328
KAJIADO,ALL,5,15763,15387,31150
KAJIADO,ALL,6,15309,15455,30764
KAJIADO,ALL,7,14310,14419,28729
KAJIADO,ALL,8,14210,13893,28103
KAJIADO,ALL,9,13653,13196,26849
KAJIADO,ALL,05-Sep,73245,72350,145595
KAJIADO,ALL,10,15034,14889,29923
KAJIADO,ALL,11,11437,11906,23343
KAJIADO,ALL,12,13558,13600,27158
KAJIADO,ALL,13,12628,13211,25839
KAJIADO,ALL,14,11316,12053,23369
KAJIADO,ALL,Oct-14,63973,65659,129632
KAJIADO,ALL,15,11315,11185,22500
KAJIADO,ALL,16,9949,10219,20168
KAJIADO,ALL,17,10079,9847,19926
KAJIADO,ALL,18,8441,9370,17811
KAJIADO,ALL,19,9863,11100,20963
KAJIADO,ALL,15-19,49647,51721,101368
KAJIADO,ALL,20,10432,12966,23398
KAJIADO,ALL,21,10188,12066,22254
KAJIADO,ALL,22,10486,12608,23094
KAJIADO,ALL,23,11563,13956,25519
KAJIADO,ALL,24,11474,13080,24554
KAJIADO,ALL,20-24,54143,64676,118819
KAJIADO,ALL,25,13275,14287,27562
KAJIADO,ALL,26,10918,11990,22908
KAJIADO,ALL,27,11443,11928,23371
KAJIADO,ALL,28,9734,10648,20382
KAJIADO,ALL,29,10294,10636,20930
KAJIADO,ALL,25-29,55664,59489,115153
KAJIADO,ALL,30,13324,13948,27272
KAJIADO,ALL,31,8549,8861,17410
KAJIADO,ALL,32,11093,11242,22335
KAJIADO,ALL,33,8609,8592,17201
KAJIADO,ALL,34,7974,7641,15615
KAJIADO,ALL,30-34,49549,50284,99833
KAJIADO,ALL,35,10999,10090,21089
KAJIADO,ALL,36,7171,6586,13757
KAJIADO,ALL,37,7089,6125,13214
KAJIADO,ALL,38,6095,5300,11395
KAJIADO,ALL,39,5936,5183,11119
KAJIADO,ALL,35-39,37290,33284,70574
KAJIADO,ALL,40,8001,6887,14888
KAJIADO,ALL,41,6058,5483,11541
KAJIADO,ALL,42,5868,5466,11334
KAJIADO,ALL,43,4672,4197,8869
KAJIADO,ALL,44,3559,3142,6701
KAJIADO,ALL,40-44,28158,25175,53333
KAJIADO,ALL,45,6923,5838,12761
KAJIADO,ALL,46,4400,3889,8289
KAJIADO,ALL,47,4406,3617,8023
KAJIADO,ALL,48,3198,2618,5816
KAJIADO,ALL,49,3378,2772,6150
KAJIADO,ALL,45-49,22305,18734,41039
KAJIADO,ALL,50,4618,3954,8572
KAJIADO,ALL,51,3281,2851,6132
KAJIADO,ALL,52,2956,2460,5416
KAJIADO,ALL,53,2088,1725,3813
KAJIADO,ALL,54,2612,2279,4891
KAJIADO,ALL,50-54,15555,13269,28824
KAJIADO,ALL,55,2654,2249,4903
KAJIADO,ALL,56,2380,2049,4429
KAJIADO,ALL,57,1859,1770,3629
KAJIADO,ALL,58,1601,1412,3013
KAJIADO,ALL,59,1795,1853,3648
KAJIADO,ALL,55-59,10289,9333,19622
KAJIADO,ALL,60,2358,2359,4717
KAJIADO,ALL,61,1362,1419,2781
KAJIADO,ALL,62,1223,1189,2412
KAJIADO,ALL,63,1182,1179,2361
KAJIADO,ALL,64,906,750,1656
KAJIADO,ALL,60-64,7031,6896,13927
KAJIADO,ALL,65,1416,1366,2782
KAJIADO,ALL,66,675,657,1332
KAJIADO,ALL,67,1044,912,1956
KAJIADO,ALL,68,582,512,1094
KAJIADO,ALL,69,724,833,1557
KAJIADO,ALL,65-69,4441,4280,8721
KAJIADO,ALL,70,1260,1337,2597
KAJIADO,ALL,71,607,722,1329
KAJIADO,ALL,72,561,504,1065
KAJIADO,ALL,73,430,422,852
KAJIADO,ALL,74,444,505,949
KAJIADO,ALL,70-74,3302,3490,6792
KAJIADO,ALL,75,444,516,960
KAJIADO,ALL,76,337,354,691
KAJIADO,ALL,77,296,318,614
KAJIADO,ALL,78,212,202,414
KAJIADO,ALL,79,307,412,719
KAJIADO,ALL,75-79,1596,1802,3398
KAJIADO,ALL,80,410,602,1012
KAJIADO,ALL,81,173,231,404
KAJIADO,ALL,82,141,135,276
KAJIADO,ALL,83,129,174,303
KAJIADO,ALL,84,111,198,309
KAJIADO,ALL,80-84,964,1340,2304
KAJIADO,ALL,85,169,200,369
KAJIADO,ALL,86,102,126,228
KAJIADO,ALL,87,85,116,201
KAJIADO,ALL,88,48,65,113
KAJIADO,ALL,89,130,197,327
KAJIADO,ALL,85-89,534,704,1238
KAJIADO,ALL,90,114,196,310
KAJIADO,ALL,91,46,66,112
KAJIADO,ALL,92,30,59,89
KAJIADO,ALL,93,26,41,67
KAJIADO,ALL,94,28,32,60
KAJIADO,ALL,90-94,244,394,638
KAJIADO,ALL,95,57,83,140
KAJIADO,ALL,96,19,44,63
KAJIADO,ALL,97,20,39,59
KAJIADO,ALL,98,15,36,51
KAJIADO,ALL,99,26,43,69
KAJIADO,ALL,95-99,137,245,382
KAJIADO,ALL,100+,75,186,261
KAJIADO,ALL,Not Stated,13,8,21
KAJIADO,ISINYA,Total,105607,104860,210467
KAJIADO,ISINYA,0,2338,2341,4679
KAJIADO,ISINYA,1,3277,3223,6500
KAJIADO,ISINYA,2,2654,2715,5369
KAJIADO,ISINYA,3,2650,2662,5312
KAJIADO,ISINYA,4,2405,2421,4826
KAJIADO,ISINYA,0 - 4,13324,13362,26686
KAJIADO,ISINYA,5,2380,2289,4669
KAJIADO,ISINYA,6,2114,2085,4199
KAJIADO,ISINYA,7,2207,2173,4380
KAJIADO,ISINYA,8,2063,1999,4062
KAJIADO,ISINYA,9,2118,2053,4171
KAJIADO,ISINYA,05-Sep,10882,10599,21481
KAJIADO,ISINYA,10,1898,1950,3848
KAJIADO,ISINYA,11,1721,1792,3513
KAJIADO,ISINYA,12,1751,1849,3600
KAJIADO,ISINYA,13,1678,1857,3535
KAJIADO,ISINYA,14,1517,1616,3133
KAJIADO,ISINYA,Oct-14,8565,9064,17629
KAJIADO,ISINYA,15,1366,1501,2867
KAJIADO,ISINYA,16,1375,1537,2912
KAJIADO,ISINYA,17,1369,1567,2936
KAJIADO,ISINYA,18,1203,1554,2757
KAJIADO,ISINYA,19,1651,2088,3739
KAJIADO,ISINYA,15-19,6964,8247,15211
KAJIADO,ISINYA,20,1850,2616,4466
KAJIADO,ISINYA,21,2206,2931,5137
KAJIADO,ISINYA,22,2270,2957,5227
KAJIADO,ISINYA,23,2762,3522,6284
KAJIADO,ISINYA,24,2792,3466,6258
KAJIADO,ISINYA,20-24,11880,15492,27372
KAJIADO,ISINYA,25,3203,3673,6876
KAJIADO,ISINYA,26,2909,3132,6041
KAJIADO,ISINYA,27,3051,3048,6099
KAJIADO,ISINYA,28,2545,2860,5405
KAJIADO,ISINYA,29,2855,2779,5634
KAJIADO,ISINYA,25-29,14563,15492,30055
KAJIADO,ISINYA,30,3341,3432,6773
KAJIADO,ISINYA,31,2299,2089,4388
KAJIADO,ISINYA,32,2921,2650,5571
KAJIADO,ISINYA,33,2207,2020,4227
KAJIADO,ISINYA,34,2016,1908,3924
KAJIADO,ISINYA,30-34,12784,12099,24883
KAJIADO,ISINYA,35,2525,2198,4723
KAJIADO,ISINYA,36,1848,1612,3460
KAJIADO,ISINYA,37,1804,1486,3290
KAJIADO,ISINYA,38,1553,1296,2849
KAJIADO,ISINYA,39,1611,1303,2914
KAJIADO,ISINYA,35-39,9341,7895,17236
KAJIADO,ISINYA,40,1886,1321,3207
KAJIADO,ISINYA,41,1419,1038,2457
KAJIADO,ISINYA,42,1339,1039,2378
KAJIADO,ISINYA,43,1110,835,1945
KAJIADO,ISINYA,44,810,680,1490
KAJIADO,ISINYA,40-44,6564,4913,11477
KAJIADO,ISINYA,45,1287,845,2132
KAJIADO,ISINYA,46,938,632,1570
KAJIADO,ISINYA,47,850,573,1423
KAJIADO,ISINYA,48,613,445,1058
KAJIADO,ISINYA,49,708,460,1168
KAJIADO,ISINYA,45-49,4396,2955,7351
KAJIADO,ISINYA,50,788,502,1290
KAJIADO,ISINYA,51,565,330,895
KAJIADO,ISINYA,52,488,337,825
KAJIADO,ISINYA,53,395,266,661
KAJIADO,ISINYA,54,447,298,745
KAJIADO,ISINYA,50-54,2683,1733,4416
KAJIADO,ISINYA,55,414,273,687
KAJIADO,ISINYA,56,391,252,643
KAJIADO,ISINYA,57,332,240,572
KAJIADO,ISINYA,58,238,187,425
KAJIADO,ISINYA,59,293,199,492
KAJIADO,ISINYA,55-59,1668,1151,2819
KAJIADO,ISINYA,60,285,263,548
KAJIADO,ISINYA,61,221,166,387
KAJIADO,ISINYA,62,148,124,272
KAJIADO,ISINYA,63,161,129,290
KAJIADO,ISINYA,64,104,77,181
KAJIADO,ISINYA,60-64,919,759,1678
KAJIADO,ISINYA,65,160,111,271
KAJIADO,ISINYA,66,83,80,163
KAJIADO,ISINYA,67,129,96,225
KAJIADO,ISINYA,68,70,60,130
KAJIADO,ISINYA,69,78,84,162
KAJIADO,ISINYA,65-69,520,431,951
KAJIADO,ISINYA,70,101,104,205
KAJIADO,ISINYA,71,50,67,117
KAJIADO,ISINYA,72,67,50,117
KAJIADO,ISINYA,73,43,41,84
KAJIADO,ISINYA,74,44,49,93
KAJIADO,ISINYA,70-74,305,311,616
KAJIADO,ISINYA,75,29,37,66
KAJIADO,ISINYA,76,34,33,67
KAJIADO,ISINYA,77,27,37,64
KAJIADO,ISINYA,78,16,13,29
KAJIADO,ISINYA,79,27,32,59
KAJIADO,ISINYA,75-79,133,152,285
KAJIADO,ISINYA,80,24,34,58
KAJIADO,ISINYA,81,16,16,32
KAJIADO,ISINYA,82,8,14,22
KAJIADO,ISINYA,83,10,16,26
KAJIADO,ISINYA,84,7,11,18
KAJIADO,ISINYA,80-84,65,91,156
KAJIADO,ISINYA,85,7,14,21
KAJIADO,ISINYA,86,8,15,23
KAJIADO,ISINYA,87,3,9,12
KAJIADO,ISINYA,88,1,3,4
KAJIADO,ISINYA,89,7,16,23
KAJIADO,ISINYA,85-89,26,57,83
KAJIADO,ISINYA,90,2,8,10
KAJIADO,ISINYA,91,3,8,11
KAJIADO,ISINYA,92,3,2,5
KAJIADO,ISINYA,93,-,3,3
KAJIADO,ISINYA,94,2,2,4
KAJIADO,ISINYA,90-94,10,23,33
KAJIADO,ISINYA,95,2,8,10
KAJIADO,ISINYA,96,2,8,10
KAJIADO,ISINYA,97,1,1,2
KAJIADO,ISINYA,98,-,3,3
KAJIADO,ISINYA,99,1,2,3
KAJIADO,ISINYA,95-99,6,22,28
KAJIADO,ISINYA,100+,4,9,13
KAJIADO,ISINYA,Not Stated,5,3,8
KAJIADO,KAJIADO CENTRAL,Total,81514,80343,161857
KAJIADO,KAJIADO CENTRAL,0,2116,2034,4150
KAJIADO,KAJIADO CENTRAL,1,2518,2421,4939
KAJIADO,KAJIADO CENTRAL,2,2696,2593,5289
KAJIADO,KAJIADO CENTRAL,3,2981,2857,5838
KAJIADO,KAJIADO CENTRAL,4,2883,2818,5701
KAJIADO,KAJIADO CENTRAL,0 - 4,13194,12723,25917
KAJIADO,KAJIADO CENTRAL,5,2954,2932,5886
KAJIADO,KAJIADO CENTRAL,6,2929,2963,5892
KAJIADO,KAJIADO CENTRAL,7,2480,2621,5101
KAJIADO,KAJIADO CENTRAL,8,2645,2444,5089
KAJIADO,KAJIADO CENTRAL,9,2353,2133,4486
KAJIADO,KAJIADO CENTRAL,05-Sep,13361,13093,26454
KAJIADO,KAJIADO CENTRAL,10,2836,2739,5575
KAJIADO,KAJIADO CENTRAL,11,1926,1925,3851
KAJIADO,KAJIADO CENTRAL,12,2565,2429,4994
KAJIADO,KAJIADO CENTRAL,13,2181,2367,4548
KAJIADO,KAJIADO CENTRAL,14,1975,2007,3982
KAJIADO,KAJIADO CENTRAL,Oct-14,11483,11467,22950
KAJIADO,KAJIADO CENTRAL,15,2064,1862,3926
KAJIADO,KAJIADO CENTRAL,16,1595,1540,3135
KAJIADO,KAJIADO CENTRAL,17,1630,1450,3080
KAJIADO,KAJIADO CENTRAL,18,1381,1306,2687
KAJIADO,KAJIADO CENTRAL,19,1418,1395,2813
KAJIADO,KAJIADO CENTRAL,15-19,8088,7553,15641
KAJIADO,KAJIADO CENTRAL,20,1540,1766,3306
KAJIADO,KAJIADO CENTRAL,21,1288,1409,2697
KAJIADO,KAJIADO CENTRAL,22,1348,1503,2851
KAJIADO,KAJIADO CENTRAL,23,1351,1550,2901
KAJIADO,KAJIADO CENTRAL,24,1280,1419,2699
KAJIADO,KAJIADO CENTRAL,20-24,6807,7647,14454
KAJIADO,KAJIADO CENTRAL,25,1534,1725,3259
KAJIADO,KAJIADO CENTRAL,26,1190,1344,2534
KAJIADO,KAJIADO CENTRAL,27,1324,1407,2731
KAJIADO,KAJIADO CENTRAL,28,1174,1237,2411
KAJIADO,KAJIADO CENTRAL,29,1200,1073,2273
KAJIADO,KAJIADO CENTRAL,25-29,6422,6786,13208
KAJIADO,KAJIADO CENTRAL,30,1737,1602,3339
KAJIADO,KAJIADO CENTRAL,31,876,1035,1911
KAJIADO,KAJIADO CENTRAL,32,1333,1326,2659
KAJIADO,KAJIADO CENTRAL,33,919,874,1793
KAJIADO,KAJIADO CENTRAL,34,815,724,1539
KAJIADO,KAJIADO CENTRAL,30-34,5680,5561,11241
KAJIADO,KAJIADO CENTRAL,35,1377,1186,2563
KAJIADO,KAJIADO CENTRAL,36,837,770,1607
KAJIADO,KAJIADO CENTRAL,37,795,604,1399
KAJIADO,KAJIADO CENTRAL,38,703,514,1217
KAJIADO,KAJIADO CENTRAL,39,601,435,1036
KAJIADO,KAJIADO CENTRAL,35-39,4313,3509,7822
KAJIADO,KAJIADO CENTRAL,40,937,846,1783
KAJIADO,KAJIADO CENTRAL,41,651,651,1302
KAJIADO,KAJIADO CENTRAL,42,731,808,1539
KAJIADO,KAJIADO CENTRAL,43,451,480,931
KAJIADO,KAJIADO CENTRAL,44,334,283,617
KAJIADO,KAJIADO CENTRAL,40-44,3104,3068,6172
KAJIADO,KAJIADO CENTRAL,45,932,813,1745
KAJIADO,KAJIADO CENTRAL,46,523,579,1102
KAJIADO,KAJIADO CENTRAL,47,517,467,984
KAJIADO,KAJIADO CENTRAL,48,352,289,641
KAJIADO,KAJIADO CENTRAL,49,356,320,676
KAJIADO,KAJIADO CENTRAL,45-49,2680,2468,5148
KAJIADO,KAJIADO CENTRAL,50,704,601,1305
KAJIADO,KAJIADO CENTRAL,51,485,502,987
KAJIADO,KAJIADO CENTRAL,52,375,326,701
KAJIADO,KAJIADO CENTRAL,53,224,158,382
KAJIADO,KAJIADO CENTRAL,54,298,367,665
KAJIADO,KAJIADO CENTRAL,50-54,2086,1954,4040
KAJIADO,KAJIADO CENTRAL,55,331,357,688
KAJIADO,KAJIADO CENTRAL,56,335,312,647
KAJIADO,KAJIADO CENTRAL,57,215,229,444
KAJIADO,KAJIADO CENTRAL,58,190,191,381
KAJIADO,KAJIADO CENTRAL,59,261,320,581
KAJIADO,KAJIADO CENTRAL,55-59,1332,1409,2741
KAJIADO,KAJIADO CENTRAL,60,424,388,812
KAJIADO,KAJIADO CENTRAL,61,188,242,430
KAJIADO,KAJIADO CENTRAL,62,163,153,316
KAJIADO,KAJIADO CENTRAL,63,204,200,404
KAJIADO,KAJIADO CENTRAL,64,174,99,273
KAJIADO,KAJIADO CENTRAL,60-64,1153,1082,2235
KAJIADO,KAJIADO CENTRAL,65,233,211,444
KAJIADO,KAJIADO CENTRAL,66,83,76,159
KAJIADO,KAJIADO CENTRAL,67,126,131,257
KAJIADO,KAJIADO CENTRAL,68,85,92,177
KAJIADO,KAJIADO CENTRAL,69,120,152,272
KAJIADO,KAJIADO CENTRAL,65-69,647,662,1309
KAJIADO,KAJIADO CENTRAL,70,203,236,439
KAJIADO,KAJIADO CENTRAL,71,83,126,209
KAJIADO,KAJIADO CENTRAL,72,84,83,167
KAJIADO,KAJIADO CENTRAL,73,75,49,124
KAJIADO,KAJIADO CENTRAL,74,67,77,144
KAJIADO,KAJIADO CENTRAL,70-74,512,571,1083
KAJIADO,KAJIADO CENTRAL,75,73,82,155
KAJIADO,KAJIADO CENTRAL,76,48,44,92
KAJIADO,KAJIADO CENTRAL,77,44,49,93
KAJIADO,KAJIADO CENTRAL,78,43,41,84
KAJIADO,KAJIADO CENTRAL,79,58,73,131
KAJIADO,KAJIADO CENTRAL,75-79,266,289,555
KAJIADO,KAJIADO CENTRAL,80,90,134,224
KAJIADO,KAJIADO CENTRAL,81,30,47,77
KAJIADO,KAJIADO CENTRAL,82,35,22,57
KAJIADO,KAJIADO CENTRAL,83,22,26,48
KAJIADO,KAJIADO CENTRAL,84,17,37,54
KAJIADO,KAJIADO CENTRAL,80-84,194,266,460
KAJIADO,KAJIADO CENTRAL,85,33,44,77
KAJIADO,KAJIADO CENTRAL,86,18,11,29
KAJIADO,KAJIADO CENTRAL,87,15,17,32
KAJIADO,KAJIADO CENTRAL,88,11,10,21
KAJIADO,KAJIADO CENTRAL,89,24,31,55
KAJIADO,KAJIADO CENTRAL,85-89,101,113,214
KAJIADO,KAJIADO CENTRAL,90,36,35,71
KAJIADO,KAJIADO CENTRAL,91,13,10,23
KAJIADO,KAJIADO CENTRAL,92,2,10,12
KAJIADO,KAJIADO CENTRAL,93,7,6,13
KAJIADO,KAJIADO CENTRAL,94,6,7,13
KAJIADO,KAJIADO CENTRAL,90-94,64,68,132
KAJIADO,KAJIADO CENTRAL,95,5,9,14
KAJIADO,KAJIADO CENTRAL,96,2,2,4
KAJIADO,KAJIADO CENTRAL,97,4,6,10
KAJIADO,KAJIADO CENTRAL,98,2,4,6
KAJIADO,KAJIADO CENTRAL,99,6,6,12
KAJIADO,KAJIADO CENTRAL,95-99,19,27,46
KAJIADO,KAJIADO CENTRAL,100+,8,27,35
KAJIADO,KAJIADO CENTRAL,Not Stated,-,-,-
KAJIADO,KAJIADO NORTH,Total,150675,155908,306583
KAJIADO,KAJIADO NORTH,0,3871,3533,7404
KAJIADO,KAJIADO NORTH,1,3721,3669,7390
KAJIADO,KAJIADO NORTH,2,3585,3593,7178
KAJIADO,KAJIADO NORTH,3,3523,3625,7148
KAJIADO,KAJIADO NORTH,4,3462,3224,6686
KAJIADO,KAJIADO NORTH,0 - 4,18162,17644,35806
KAJIADO,KAJIADO NORTH,5,3103,3236,6339
KAJIADO,KAJIADO NORTH,6,3166,3240,6406
KAJIADO,KAJIADO NORTH,7,3093,3075,6168
KAJIADO,KAJIADO NORTH,8,3012,3054,6066
KAJIADO,KAJIADO NORTH,9,3148,3157,6305
KAJIADO,KAJIADO NORTH,05-Sep,15522,15762,31284
KAJIADO,KAJIADO NORTH,10,2923,3064,5987
KAJIADO,KAJIADO NORTH,11,2711,2802,5513
KAJIADO,KAJIADO NORTH,12,2786,2806,5592
KAJIADO,KAJIADO NORTH,13,2870,2939,5809
KAJIADO,KAJIADO NORTH,14,2514,2802,5316
KAJIADO,KAJIADO NORTH,Oct-14,13804,14413,28217
KAJIADO,KAJIADO NORTH,15,2393,2580,4973
KAJIADO,KAJIADO NORTH,16,2278,2603,4881
KAJIADO,KAJIADO NORTH,17,2505,2671,5176
KAJIADO,KAJIADO NORTH,18,2122,2603,4725
KAJIADO,KAJIADO NORTH,19,2733,3496,6229
KAJIADO,KAJIADO NORTH,15-19,12031,13953,25984
KAJIADO,KAJIADO NORTH,20,2855,3805,6660
KAJIADO,KAJIADO NORTH,21,3174,4018,7192
KAJIADO,KAJIADO NORTH,22,3305,4231,7536
KAJIADO,KAJIADO NORTH,23,3799,4789,8588
KAJIADO,KAJIADO NORTH,24,3835,4530,8365
KAJIADO,KAJIADO NORTH,20-24,16968,21373,38341
KAJIADO,KAJIADO NORTH,25,4195,4443,8638
KAJIADO,KAJIADO NORTH,26,3620,3966,7586
KAJIADO,KAJIADO NORTH,27,3712,3931,7643
KAJIADO,KAJIADO NORTH,28,3120,3514,6634
KAJIADO,KAJIADO NORTH,29,3405,3684,7089
KAJIADO,KAJIADO NORTH,25-29,18052,19538,37590
KAJIADO,KAJIADO NORTH,30,3874,4160,8034
KAJIADO,KAJIADO NORTH,31,2872,2936,5808
KAJIADO,KAJIADO NORTH,32,3527,3606,7133
KAJIADO,KAJIADO NORTH,33,2819,2936,5755
KAJIADO,KAJIADO NORTH,34,2648,2671,5319
KAJIADO,KAJIADO NORTH,30-34,15740,16309,32049
KAJIADO,KAJIADO NORTH,35,3133,2999,6132
KAJIADO,KAJIADO NORTH,36,2375,2348,4723
KAJIADO,KAJIADO NORTH,37,2328,2280,4608
KAJIADO,KAJIADO NORTH,38,2019,1997,4016
KAJIADO,KAJIADO NORTH,39,2061,1921,3982
KAJIADO,KAJIADO NORTH,35-39,11916,11545,23461
KAJIADO,KAJIADO NORTH,40,2459,2250,4709
KAJIADO,KAJIADO NORTH,41,1944,1769,3713
KAJIADO,KAJIADO NORTH,42,1827,1649,3476
KAJIADO,KAJIADO NORTH,43,1624,1495,3119
KAJIADO,KAJIADO NORTH,44,1290,1191,2481
KAJIADO,KAJIADO NORTH,40-44,9144,8354,17498
KAJIADO,KAJIADO NORTH,45,1938,1567,3505
KAJIADO,KAJIADO NORTH,46,1343,1143,2486
KAJIADO,KAJIADO NORTH,47,1420,1207,2627
KAJIADO,KAJIADO NORTH,48,1109,938,2047
KAJIADO,KAJIADO NORTH,49,1113,960,2073
KAJIADO,KAJIADO NORTH,45-49,6923,5815,12738
KAJIADO,KAJIADO NORTH,50,1327,1112,2439
KAJIADO,KAJIADO NORTH,51,953,747,1700
KAJIADO,KAJIADO NORTH,52,971,798,1769
KAJIADO,KAJIADO NORTH,53,702,643,1345
KAJIADO,KAJIADO NORTH,54,833,619,1452
KAJIADO,KAJIADO NORTH,50-54,4786,3919,8705
KAJIADO,KAJIADO NORTH,55,788,608,1396
KAJIADO,KAJIADO NORTH,56,765,588,1353
KAJIADO,KAJIADO NORTH,57,614,573,1187
KAJIADO,KAJIADO NORTH,58,537,442,979
KAJIADO,KAJIADO NORTH,59,513,463,976
KAJIADO,KAJIADO NORTH,55-59,3217,2674,5891
KAJIADO,KAJIADO NORTH,60,532,519,1051
KAJIADO,KAJIADO NORTH,61,392,377,769
KAJIADO,KAJIADO NORTH,62,350,328,678
KAJIADO,KAJIADO NORTH,63,318,272,590
KAJIADO,KAJIADO NORTH,64,232,242,474
KAJIADO,KAJIADO NORTH,60-64,1824,1738,3562
KAJIADO,KAJIADO NORTH,65,340,323,663
KAJIADO,KAJIADO NORTH,66,197,184,381
KAJIADO,KAJIADO NORTH,67,300,267,567
KAJIADO,KAJIADO NORTH,68,160,128,288
KAJIADO,KAJIADO NORTH,69,201,196,397
KAJIADO,KAJIADO NORTH,65-69,1198,1098,2296
KAJIADO,KAJIADO NORTH,70,233,229,462
KAJIADO,KAJIADO NORTH,71,141,177,318
KAJIADO,KAJIADO NORTH,72,170,139,309
KAJIADO,KAJIADO NORTH,73,128,115,243
KAJIADO,KAJIADO NORTH,74,110,133,243
KAJIADO,KAJIADO NORTH,70-74,782,793,1575
KAJIADO,KAJIADO NORTH,75,85,109,194
KAJIADO,KAJIADO NORTH,76,74,106,180
KAJIADO,KAJIADO NORTH,77,66,76,142
KAJIADO,KAJIADO NORTH,78,49,54,103
KAJIADO,KAJIADO NORTH,79,39,58,97
KAJIADO,KAJIADO NORTH,75-79,313,403,716
KAJIADO,KAJIADO NORTH,80,52,92,144
KAJIADO,KAJIADO NORTH,81,35,52,87
KAJIADO,KAJIADO NORTH,82,31,36,67
KAJIADO,KAJIADO NORTH,83,25,45,70
KAJIADO,KAJIADO NORTH,84,20,39,59
KAJIADO,KAJIADO NORTH,80-84,163,264,427
KAJIADO,KAJIADO NORTH,85,25,34,59
KAJIADO,KAJIADO NORTH,86,19,35,54
KAJIADO,KAJIADO NORTH,87,13,34,47
KAJIADO,KAJIADO NORTH,88,9,15,24
KAJIADO,KAJIADO NORTH,89,17,25,42
KAJIADO,KAJIADO NORTH,85-89,83,143,226
KAJIADO,KAJIADO NORTH,90,10,37,47
KAJIADO,KAJIADO NORTH,91,4,17,21
KAJIADO,KAJIADO NORTH,92,5,18,23
KAJIADO,KAJIADO NORTH,93,3,9,12
KAJIADO,KAJIADO NORTH,94,2,7,9
KAJIADO,KAJIADO NORTH,90-94,24,88,112
KAJIADO,KAJIADO NORTH,95,7,13,20
KAJIADO,KAJIADO NORTH,96,2,9,11
KAJIADO,KAJIADO NORTH,97,4,13,17
KAJIADO,KAJIADO NORTH,98,-,5,5
KAJIADO,KAJIADO NORTH,99,1,5,6
KAJIADO,KAJIADO NORTH,95-99,14,45,59
KAJIADO,KAJIADO NORTH,100+,4,33,37
KAJIADO,KAJIADO NORTH,Not Stated,5,4,9
KAJIADO,KAJIADO WEST,Total,91607,91237,182844
KAJIADO,KAJIADO WEST,0,2369,2426,4795
KAJIADO,KAJIADO WEST,1,2967,2747,5714
KAJIADO,KAJIADO WEST,2,3107,2973,6080
KAJIADO,KAJIADO WEST,3,3282,3166,6448
KAJIADO,KAJIADO WEST,4,3240,3257,6497
KAJIADO,KAJIADO WEST,0 - 4,14965,14569,29534
KAJIADO,KAJIADO WEST,5,3204,3072,6276
KAJIADO,KAJIADO WEST,6,3114,3207,6321
KAJIADO,KAJIADO WEST,7,2761,2792,5553
KAJIADO,KAJIADO WEST,8,2922,2743,5665
KAJIADO,KAJIADO WEST,9,2454,2291,4745
KAJIADO,KAJIADO WEST,05-Sep,14455,14105,28560
KAJIADO,KAJIADO WEST,10,3220,3068,6288
KAJIADO,KAJIADO WEST,11,1962,2172,4134
KAJIADO,KAJIADO WEST,12,2671,2640,5311
KAJIADO,KAJIADO WEST,13,2278,2355,4633
KAJIADO,KAJIADO WEST,14,2130,2144,4274
KAJIADO,KAJIADO WEST,Oct-14,12261,12379,24640
KAJIADO,KAJIADO WEST,15,2245,2068,4313
KAJIADO,KAJIADO WEST,16,1910,1742,3652
KAJIADO,KAJIADO WEST,17,1796,1575,3371
KAJIADO,KAJIADO WEST,18,1579,1771,3350
KAJIADO,KAJIADO WEST,19,1611,1687,3298
KAJIADO,KAJIADO WEST,15-19,9141,8843,17984
KAJIADO,KAJIADO WEST,20,1919,2272,4191
KAJIADO,KAJIADO WEST,21,1456,1530,2986
KAJIADO,KAJIADO WEST,22,1597,1726,3323
KAJIADO,KAJIADO WEST,23,1552,1736,3288
KAJIADO,KAJIADO WEST,24,1551,1515,3066
KAJIADO,KAJIADO WEST,20-24,8075,8779,16854
KAJIADO,KAJIADO WEST,25,1980,1960,3940
KAJIADO,KAJIADO WEST,26,1298,1479,2777
KAJIADO,KAJIADO WEST,27,1320,1344,2664
KAJIADO,KAJIADO WEST,28,1130,1162,2292
KAJIADO,KAJIADO WEST,29,1128,1182,2310
KAJIADO,KAJIADO WEST,25-29,6856,7127,13983
KAJIADO,KAJIADO WEST,30,1925,2055,3980
KAJIADO,KAJIADO WEST,31,1033,1056,2089
KAJIADO,KAJIADO WEST,32,1337,1504,2841
KAJIADO,KAJIADO WEST,33,989,1037,2026
KAJIADO,KAJIADO WEST,34,907,888,1795
KAJIADO,KAJIADO WEST,30-34,6191,6540,12731
KAJIADO,KAJIADO WEST,35,1585,1587,3172
KAJIADO,KAJIADO WEST,36,868,829,1697
KAJIADO,KAJIADO WEST,37,867,681,1548
KAJIADO,KAJIADO WEST,38,795,606,1401
KAJIADO,KAJIADO WEST,39,695,664,1359
KAJIADO,KAJIADO WEST,35-39,4810,4367,9177
KAJIADO,KAJIADO WEST,40,1178,1128,2306
KAJIADO,KAJIADO WEST,41,752,755,1507
KAJIADO,KAJIADO WEST,42,790,846,1636
KAJIADO,KAJIADO WEST,43,564,570,1134
KAJIADO,KAJIADO WEST,44,457,393,850
KAJIADO,KAJIADO WEST,40-44,3741,3692,7433
KAJIADO,KAJIADO WEST,45,1174,1037,2211
KAJIADO,KAJIADO WEST,46,690,596,1286
KAJIADO,KAJIADO WEST,47,664,532,1196
KAJIADO,KAJIADO WEST,48,480,376,856
KAJIADO,KAJIADO WEST,49,450,388,838
KAJIADO,KAJIADO WEST,45-49,3458,2929,6387
KAJIADO,KAJIADO WEST,50,739,740,1479
KAJIADO,KAJIADO WEST,51,571,590,1161
KAJIADO,KAJIADO WEST,52,497,449,946
KAJIADO,KAJIADO WEST,53,286,235,521
KAJIADO,KAJIADO WEST,54,377,364,741
KAJIADO,KAJIADO WEST,50-54,2470,2378,4848
KAJIADO,KAJIADO WEST,55,479,475,954
KAJIADO,KAJIADO WEST,56,334,331,665
KAJIADO,KAJIADO WEST,57,281,262,543
KAJIADO,KAJIADO WEST,58,287,221,508
KAJIADO,KAJIADO WEST,59,312,338,650
KAJIADO,KAJIADO WEST,55-59,1693,1627,3320
KAJIADO,KAJIADO WEST,60,509,496,1005
KAJIADO,KAJIADO WEST,61,184,227,411
KAJIADO,KAJIADO WEST,62,226,232,458
KAJIADO,KAJIADO WEST,63,183,234,417
KAJIADO,KAJIADO WEST,64,144,148,292
KAJIADO,KAJIADO WEST,60-64,1246,1337,2583
KAJIADO,KAJIADO WEST,65,272,285,557
KAJIADO,KAJIADO WEST,66,117,118,235
KAJIADO,KAJIADO WEST,67,161,127,288
KAJIADO,KAJIADO WEST,68,100,109,209
KAJIADO,KAJIADO WEST,69,111,134,245
KAJIADO,KAJIADO WEST,65-69,761,773,1534
KAJIADO,KAJIADO WEST,70,326,315,641
KAJIADO,KAJIADO WEST,71,125,168,293
KAJIADO,KAJIADO WEST,72,96,107,203
KAJIADO,KAJIADO WEST,73,81,91,172
KAJIADO,KAJIADO WEST,74,90,91,181
KAJIADO,KAJIADO WEST,70-74,718,772,1490
KAJIADO,KAJIADO WEST,75,116,123,239
KAJIADO,KAJIADO WEST,76,52,62,114
KAJIADO,KAJIADO WEST,77,51,60,111
KAJIADO,KAJIADO WEST,78,37,37,74
KAJIADO,KAJIADO WEST,79,80,99,179
KAJIADO,KAJIADO WEST,75-79,336,381,717
KAJIADO,KAJIADO WEST,80,100,159,259
KAJIADO,KAJIADO WEST,81,30,43,73
KAJIADO,KAJIADO WEST,82,14,16,30
KAJIADO,KAJIADO WEST,83,24,24,48
KAJIADO,KAJIADO WEST,84,30,45,75
KAJIADO,KAJIADO WEST,80-84,198,287,485
KAJIADO,KAJIADO WEST,85,43,35,78
KAJIADO,KAJIADO WEST,86,23,30,53
KAJIADO,KAJIADO WEST,87,12,15,27
KAJIADO,KAJIADO WEST,88,13,9,22
KAJIADO,KAJIADO WEST,89,25,55,80
KAJIADO,KAJIADO WEST,85-89,116,144,260
KAJIADO,KAJIADO WEST,90,32,55,87
KAJIADO,KAJIADO WEST,91,8,11,19
KAJIADO,KAJIADO WEST,92,9,9,18
KAJIADO,KAJIADO WEST,93,4,8,12
KAJIADO,KAJIADO WEST,94,5,5,10
KAJIADO,KAJIADO WEST,90-94,58,88,146
KAJIADO,KAJIADO WEST,95,19,24,43
KAJIADO,KAJIADO WEST,96,5,12,17
KAJIADO,KAJIADO WEST,97,3,5,8
KAJIADO,KAJIADO WEST,98,3,6,9
KAJIADO,KAJIADO WEST,99,7,10,17
KAJIADO,KAJIADO WEST,95-99,37,57,94
KAJIADO,KAJIADO WEST,100+,21,62,83
KAJIADO,KAJIADO WEST,Not Stated,-,1,1
KAJIADO,LOITOKITOK,Total,94613,97225,191838
KAJIADO,LOITOKITOK,0,2542,2636,5178
KAJIADO,LOITOKITOK,1,2912,3011,5923
KAJIADO,LOITOKITOK,2,3012,2955,5967
KAJIADO,LOITOKITOK,3,3158,3151,6309
KAJIADO,LOITOKITOK,4,3202,3124,6326
KAJIADO,LOITOKITOK,0 - 4,14826,14877,29703
KAJIADO,LOITOKITOK,5,3221,3010,6231
KAJIADO,LOITOKITOK,6,3210,3094,6304
KAJIADO,LOITOKITOK,7,2971,2979,5950
KAJIADO,LOITOKITOK,8,2787,2913,5700
KAJIADO,LOITOKITOK,9,2754,2724,5478
KAJIADO,LOITOKITOK,05-Sep,14943,14720,29663
KAJIADO,LOITOKITOK,10,3284,3219,6503
KAJIADO,LOITOKITOK,11,2371,2457,4828
KAJIADO,LOITOKITOK,12,2922,3041,5963
KAJIADO,LOITOKITOK,13,2712,2839,5551
KAJIADO,LOITOKITOK,14,2375,2677,5052
KAJIADO,LOITOKITOK,Oct-14,13664,14233,27897
KAJIADO,LOITOKITOK,15,2444,2368,4812
KAJIADO,LOITOKITOK,16,2070,2064,4134
KAJIADO,LOITOKITOK,17,2062,1913,3975
KAJIADO,LOITOKITOK,18,1557,1598,3155
KAJIADO,LOITOKITOK,19,1702,1781,3483
KAJIADO,LOITOKITOK,15-19,9835,9724,19559
KAJIADO,LOITOKITOK,20,1553,1843,3396
KAJIADO,LOITOKITOK,21,1404,1549,2953
KAJIADO,LOITOKITOK,22,1342,1566,2908
KAJIADO,LOITOKITOK,23,1434,1613,3047
KAJIADO,LOITOKITOK,24,1356,1489,2845
KAJIADO,LOITOKITOK,20-24,7089,8060,15149
KAJIADO,LOITOKITOK,25,1603,1794,3397
KAJIADO,LOITOKITOK,26,1278,1463,2741
KAJIADO,LOITOKITOK,27,1406,1593,2999
KAJIADO,LOITOKITOK,28,1276,1385,2661
KAJIADO,LOITOKITOK,29,1186,1407,2593
KAJIADO,LOITOKITOK,25-29,6749,7642,14391
KAJIADO,LOITOKITOK,30,1721,2048,3769
KAJIADO,LOITOKITOK,31,1083,1372,2455
KAJIADO,LOITOKITOK,32,1346,1594,2940
KAJIADO,LOITOKITOK,33,1181,1288,2469
KAJIADO,LOITOKITOK,34,1190,1126,2316
KAJIADO,LOITOKITOK,30-34,6521,7428,13949
KAJIADO,LOITOKITOK,35,1761,1632,3393
KAJIADO,LOITOKITOK,36,897,733,1630
KAJIADO,LOITOKITOK,37,901,747,1648
KAJIADO,LOITOKITOK,38,734,635,1369
KAJIADO,LOITOKITOK,39,700,616,1316
KAJIADO,LOITOKITOK,35-39,4993,4363,9356
KAJIADO,LOITOKITOK,40,1107,1017,2124
KAJIADO,LOITOKITOK,41,912,949,1861
KAJIADO,LOITOKITOK,42,868,856,1724
KAJIADO,LOITOKITOK,43,661,600,1261
KAJIADO,LOITOKITOK,44,465,429,894
KAJIADO,LOITOKITOK,40-44,4013,3851,7864
KAJIADO,LOITOKITOK,45,1024,1138,2162
KAJIADO,LOITOKITOK,46,689,733,1422
KAJIADO,LOITOKITOK,47,715,624,1339
KAJIADO,LOITOKITOK,48,477,414,891
KAJIADO,LOITOKITOK,49,573,482,1055
KAJIADO,LOITOKITOK,45-49,3478,3391,6869
KAJIADO,LOITOKITOK,50,845,794,1639
KAJIADO,LOITOKITOK,51,493,498,991
KAJIADO,LOITOKITOK,52,490,460,950
KAJIADO,LOITOKITOK,53,388,352,740
KAJIADO,LOITOKITOK,54,481,491,972
KAJIADO,LOITOKITOK,50-54,2697,2595,5292
KAJIADO,LOITOKITOK,55,457,390,847
KAJIADO,LOITOKITOK,56,412,396,808
KAJIADO,LOITOKITOK,57,306,365,671
KAJIADO,LOITOKITOK,58,263,297,560
KAJIADO,LOITOKITOK,59,313,417,730
KAJIADO,LOITOKITOK,55-59,1751,1865,3616
KAJIADO,LOITOKITOK,60,456,524,980
KAJIADO,LOITOKITOK,61,267,302,569
KAJIADO,LOITOKITOK,62,236,276,512
KAJIADO,LOITOKITOK,63,224,227,451
KAJIADO,LOITOKITOK,64,175,136,311
KAJIADO,LOITOKITOK,60-64,1358,1465,2823
KAJIADO,LOITOKITOK,65,303,343,646
KAJIADO,LOITOKITOK,66,147,146,293
KAJIADO,LOITOKITOK,67,243,202,445
KAJIADO,LOITOKITOK,68,130,94,224
KAJIADO,LOITOKITOK,69,178,212,390
KAJIADO,LOITOKITOK,65-69,1001,997,1998
KAJIADO,LOITOKITOK,70,298,355,653
KAJIADO,LOITOKITOK,71,147,142,289
KAJIADO,LOITOKITOK,72,109,96,205
KAJIADO,LOITOKITOK,73,74,99,173
KAJIADO,LOITOKITOK,74,95,114,209
KAJIADO,LOITOKITOK,70-74,723,806,1529
KAJIADO,LOITOKITOK,75,106,139,245
KAJIADO,LOITOKITOK,76,102,87,189
KAJIADO,LOITOKITOK,77,80,79,159
KAJIADO,LOITOKITOK,78,52,44,96
KAJIADO,LOITOKITOK,79,76,117,193
KAJIADO,LOITOKITOK,75-79,416,466,882
KAJIADO,LOITOKITOK,80,113,151,264
KAJIADO,LOITOKITOK,81,47,49,96
KAJIADO,LOITOKITOK,82,41,43,84
KAJIADO,LOITOKITOK,83,38,47,85
KAJIADO,LOITOKITOK,84,26,49,75
KAJIADO,LOITOKITOK,80-84,265,339,604
KAJIADO,LOITOKITOK,85,44,59,103
KAJIADO,LOITOKITOK,86,27,28,55
KAJIADO,LOITOKITOK,87,31,33,64
KAJIADO,LOITOKITOK,88,11,26,37
KAJIADO,LOITOKITOK,89,48,51,99
KAJIADO,LOITOKITOK,85-89,161,197,358
KAJIADO,LOITOKITOK,90,25,51,76
KAJIADO,LOITOKITOK,91,12,16,28
KAJIADO,LOITOKITOK,92,6,14,20
KAJIADO,LOITOKITOK,93,9,11,20
KAJIADO,LOITOKITOK,94,7,11,18
KAJIADO,LOITOKITOK,90-94,59,103,162
KAJIADO,LOITOKITOK,95,16,21,37
KAJIADO,LOITOKITOK,96,5,7,12
KAJIADO,LOITOKITOK,97,7,11,18
KAJIADO,LOITOKITOK,98,9,13,22
KAJIADO,LOITOKITOK,99,9,18,27
KAJIADO,LOITOKITOK,95-99,46,70,116
KAJIADO,LOITOKITOK,100+,22,33,55
KAJIADO,LOITOKITOK,Not Stated,3,-,3
KAJIADO,MASHUURU,Total,33082,31131,64213
KAJIADO,MASHUURU,0,844,757,1601
KAJIADO,MASHUURU,1,919,863,1782
KAJIADO,MASHUURU,2,859,800,1659
KAJIADO,MASHUURU,3,978,907,1885
KAJIADO,MASHUURU,4,872,883,1755
KAJIADO,MASHUURU,0 - 4,4472,4210,8682
KAJIADO,MASHUURU,5,901,848,1749
KAJIADO,MASHUURU,6,776,866,1642
KAJIADO,MASHUURU,7,798,779,1577
KAJIADO,MASHUURU,8,781,740,1521
KAJIADO,MASHUURU,9,826,838,1664
KAJIADO,MASHUURU,05-Sep,4082,4071,8153
KAJIADO,MASHUURU,10,873,849,1722
KAJIADO,MASHUURU,11,746,758,1504
KAJIADO,MASHUURU,12,863,835,1698
KAJIADO,MASHUURU,13,909,854,1763
KAJIADO,MASHUURU,14,805,807,1612
KAJIADO,MASHUURU,Oct-14,4196,4103,8299
KAJIADO,MASHUURU,15,803,806,1609
KAJIADO,MASHUURU,16,721,733,1454
KAJIADO,MASHUURU,17,717,671,1388
KAJIADO,MASHUURU,18,599,538,1137
KAJIADO,MASHUURU,19,748,653,1401
KAJIADO,MASHUURU,15-19,3588,3401,6989
KAJIADO,MASHUURU,20,715,664,1379
KAJIADO,MASHUURU,21,660,629,1289
KAJIADO,MASHUURU,22,624,625,1249
KAJIADO,MASHUURU,23,665,746,1411
KAJIADO,MASHUURU,24,660,661,1321
KAJIADO,MASHUURU,20-24,3324,3325,6649
KAJIADO,MASHUURU,25,760,692,1452
KAJIADO,MASHUURU,26,623,606,1229
KAJIADO,MASHUURU,27,630,605,1235
KAJIADO,MASHUURU,28,489,490,979
KAJIADO,MASHUURU,29,520,511,1031
KAJIADO,MASHUURU,25-29,3022,2904,5926
KAJIADO,MASHUURU,30,726,651,1377
KAJIADO,MASHUURU,31,386,373,759
KAJIADO,MASHUURU,32,629,562,1191
KAJIADO,MASHUURU,33,494,437,931
KAJIADO,MASHUURU,34,398,324,722
KAJIADO,MASHUURU,30-34,2633,2347,4980
KAJIADO,MASHUURU,35,618,488,1106
KAJIADO,MASHUURU,36,346,294,640
KAJIADO,MASHUURU,37,394,327,721
KAJIADO,MASHUURU,38,291,252,543
KAJIADO,MASHUURU,39,268,244,512
KAJIADO,MASHUURU,35-39,1917,1605,3522
KAJIADO,MASHUURU,40,434,325,759
KAJIADO,MASHUURU,41,380,321,701
KAJIADO,MASHUURU,42,313,268,581
KAJIADO,MASHUURU,43,262,217,479
KAJIADO,MASHUURU,44,203,166,369
KAJIADO,MASHUURU,40-44,1592,1297,2889
KAJIADO,MASHUURU,45,568,438,1006
KAJIADO,MASHUURU,46,217,206,423
KAJIADO,MASHUURU,47,240,214,454
KAJIADO,MASHUURU,48,167,156,323
KAJIADO,MASHUURU,49,178,162,340
KAJIADO,MASHUURU,45-49,1370,1176,2546
KAJIADO,MASHUURU,50,215,205,420
KAJIADO,MASHUURU,51,214,184,398
KAJIADO,MASHUURU,52,135,90,225
KAJIADO,MASHUURU,53,93,71,164
KAJIADO,MASHUURU,54,176,140,316
KAJIADO,MASHUURU,50-54,833,690,1523
KAJIADO,MASHUURU,55,185,146,331
KAJIADO,MASHUURU,56,143,170,313
KAJIADO,MASHUURU,57,111,101,212
KAJIADO,MASHUURU,58,86,74,160
KAJIADO,MASHUURU,59,103,116,219
KAJIADO,MASHUURU,55-59,628,607,1235
KAJIADO,MASHUURU,60,152,169,321
KAJIADO,MASHUURU,61,110,105,215
KAJIADO,MASHUURU,62,100,76,176
KAJIADO,MASHUURU,63,92,117,209
KAJIADO,MASHUURU,64,77,48,125
KAJIADO,MASHUURU,60-64,531,515,1046
KAJIADO,MASHUURU,65,108,93,201
KAJIADO,MASHUURU,66,48,53,101
KAJIADO,MASHUURU,67,85,89,174
KAJIADO,MASHUURU,68,37,29,66
KAJIADO,MASHUURU,69,36,55,91
KAJIADO,MASHUURU,65-69,314,319,633
KAJIADO,MASHUURU,70,99,98,197
KAJIADO,MASHUURU,71,61,42,103
KAJIADO,MASHUURU,72,35,29,64
KAJIADO,MASHUURU,73,29,27,56
KAJIADO,MASHUURU,74,38,41,79
KAJIADO,MASHUURU,70-74,262,237,499
KAJIADO,MASHUURU,75,35,26,61
KAJIADO,MASHUURU,76,27,22,49
KAJIADO,MASHUURU,77,28,17,45
KAJIADO,MASHUURU,78,15,13,28
KAJIADO,MASHUURU,79,27,33,60
KAJIADO,MASHUURU,75-79,132,111,243
KAJIADO,MASHUURU,80,31,32,63
KAJIADO,MASHUURU,81,15,24,39
KAJIADO,MASHUURU,82,12,4,16
KAJIADO,MASHUURU,83,10,16,26
KAJIADO,MASHUURU,84,11,17,28
KAJIADO,MASHUURU,80-84,79,93,172
KAJIADO,MASHUURU,85,17,14,31
KAJIADO,MASHUURU,86,7,7,14
KAJIADO,MASHUURU,87,11,8,19
KAJIADO,MASHUURU,88,3,2,5
KAJIADO,MASHUURU,89,9,19,28
KAJIADO,MASHUURU,85-89,47,50,97
KAJIADO,MASHUURU,90,9,10,19
KAJIADO,MASHUURU,91,6,4,10
KAJIADO,MASHUURU,92,5,6,11
KAJIADO,MASHUURU,93,3,4,7
KAJIADO,MASHUURU,94,6,-,6
KAJIADO,MASHUURU,90-94,29,24,53
KAJIADO,MASHUURU,95,8,8,16
KAJIADO,MASHUURU,96,3,6,9
KAJIADO,MASHUURU,97,1,3,4
KAJIADO,MASHUURU,98,1,5,6
KAJIADO,MASHUURU,99,2,2,4
KAJIADO,MASHUURU,95-99,15,24,39
KAJIADO,MASHUURU,100+,16,22,38
KAJIADO,MASHUURU,Not Stated,-,-,-
KAKAMEGA,ALL,Total,897133,970406,1867539
KAKAMEGA,ALL,0,20947,21181,42128
KAKAMEGA,ALL,1,21421,21831,43252
KAKAMEGA,ALL,2,21959,22153,44112
KAKAMEGA,ALL,3,23353,23920,47273
KAKAMEGA,ALL,4,24680,24474,49154
KAKAMEGA,ALL,0 - 4,112360,113559,225919
KAKAMEGA,ALL,5,25911,25358,51269
KAKAMEGA,ALL,6,26869,27071,53940
KAKAMEGA,ALL,7,26916,26673,53589
KAKAMEGA,ALL,8,25383,26266,51649
KAKAMEGA,ALL,9,29151,29187,58338
KAKAMEGA,ALL,05-Sep,134230,134555,268785
KAKAMEGA,ALL,10,29721,29391,59112
KAKAMEGA,ALL,11,27237,28443,55680
KAKAMEGA,ALL,12,30724,30365,61089
KAKAMEGA,ALL,13,29559,30716,60275
KAKAMEGA,ALL,14,27734,28087,55821
KAKAMEGA,ALL,Oct-14,144975,147002,291977
KAKAMEGA,ALL,15,27134,27642,54776
KAKAMEGA,ALL,16,25327,25606,50933
KAKAMEGA,ALL,17,25898,25078,50976
KAKAMEGA,ALL,18,20938,19504,40442
KAKAMEGA,ALL,19,20968,20576,41544
KAKAMEGA,ALL,15-19,120265,118406,238671
KAKAMEGA,ALL,20,17883,19015,36898
KAKAMEGA,ALL,21,14916,16061,30977
KAKAMEGA,ALL,22,13485,14853,28338
KAKAMEGA,ALL,23,13018,15563,28581
KAKAMEGA,ALL,24,11138,13652,24790
KAKAMEGA,ALL,20-24,70440,79144,149584
KAKAMEGA,ALL,25,12282,14558,26840
KAKAMEGA,ALL,26,10046,13150,23196
KAKAMEGA,ALL,27,10527,13419,23946
KAKAMEGA,ALL,28,8363,10812,19175
KAKAMEGA,ALL,29,9145,12011,21156
KAKAMEGA,ALL,25-29,50363,63950,114313
KAKAMEGA,ALL,30,11453,15639,27092
KAKAMEGA,ALL,31,9309,11887,21196
KAKAMEGA,ALL,32,11411,15079,26490
KAKAMEGA,ALL,33,9608,12784,22392
KAKAMEGA,ALL,34,8914,10707,19621
KAKAMEGA,ALL,30-34,50695,66096,116791
KAKAMEGA,ALL,35,10500,11717,22217
KAKAMEGA,ALL,36,8186,8623,16809
KAKAMEGA,ALL,37,8786,8523,17309
KAKAMEGA,ALL,38,6536,6666,13202
KAKAMEGA,ALL,39,7400,7534,14934
KAKAMEGA,ALL,35-39,41408,43063,84471
KAKAMEGA,ALL,40,8482,9399,17881
KAKAMEGA,ALL,41,8014,8812,16826
KAKAMEGA,ALL,42,8109,8964,17073
KAKAMEGA,ALL,43,7355,8603,15958
KAKAMEGA,ALL,44,6110,6873,12983
KAKAMEGA,ALL,40-44,38070,42651,80721
KAKAMEGA,ALL,45,7990,8986,16976
KAKAMEGA,ALL,46,6166,6793,12959
KAKAMEGA,ALL,47,6525,7021,13546
KAKAMEGA,ALL,48,4653,4912,9565
KAKAMEGA,ALL,49,5211,5741,10952
KAKAMEGA,ALL,45-49,30545,33453,63998
KAKAMEGA,ALL,50,6178,8034,14212
KAKAMEGA,ALL,51,5431,6677,12108
KAKAMEGA,ALL,52,4551,5244,9795
KAKAMEGA,ALL,53,3977,5006,8983
KAKAMEGA,ALL,54,4278,4836,9114
KAKAMEGA,ALL,50-54,24415,29797,54212
KAKAMEGA,ALL,55,4706,5257,9963
KAKAMEGA,ALL,56,4662,5529,10191
KAKAMEGA,ALL,57,4849,6916,11765
KAKAMEGA,ALL,58,3577,4214,7791
KAKAMEGA,ALL,59,4605,5501,10106
KAKAMEGA,ALL,55-59,22399,27417,49816
KAKAMEGA,ALL,60,4769,5948,10717
KAKAMEGA,ALL,61,4188,4917,9105
KAKAMEGA,ALL,62,3571,4054,7625
KAKAMEGA,ALL,63,3785,4654,8439
KAKAMEGA,ALL,64,3017,3475,6492
KAKAMEGA,ALL,60-64,19330,23048,42378
KAKAMEGA,ALL,65,3817,4614,8431
KAKAMEGA,ALL,66,2602,3071,5673
KAKAMEGA,ALL,67,3631,4536,8167
KAKAMEGA,ALL,68,1719,1870,3589
KAKAMEGA,ALL,69,2618,3176,5794
KAKAMEGA,ALL,65-69,14387,17267,31654
KAKAMEGA,ALL,70,3130,3985,7115
KAKAMEGA,ALL,71,2181,2551,4732
KAKAMEGA,ALL,72,1926,2000,3926
KAKAMEGA,ALL,73,1742,1895,3637
KAKAMEGA,ALL,74,1524,1890,3414
KAKAMEGA,ALL,70-74,10503,12321,22824
KAKAMEGA,ALL,75,1410,1930,3340
KAKAMEGA,ALL,76,1412,2310,3722
KAKAMEGA,ALL,77,1234,1864,3098
KAKAMEGA,ALL,78,719,884,1603
KAKAMEGA,ALL,79,874,1431,2305
KAKAMEGA,ALL,75-79,5649,8419,14068
KAKAMEGA,ALL,80,1056,1558,2614
KAKAMEGA,ALL,81,778,1042,1820
KAKAMEGA,ALL,82,698,895,1593
KAKAMEGA,ALL,83,821,1059,1880
KAKAMEGA,ALL,84,526,724,1250
KAKAMEGA,ALL,80-84,3879,5278,9157
KAKAMEGA,ALL,85,571,744,1315
KAKAMEGA,ALL,86,408,635,1043
KAKAMEGA,ALL,87,562,902,1464
KAKAMEGA,ALL,88,232,325,557
KAKAMEGA,ALL,89,332,670,1002
KAKAMEGA,ALL,85-89,2105,3276,5381
KAKAMEGA,ALL,90,220,297,517
KAKAMEGA,ALL,91,199,230,429
KAKAMEGA,ALL,92,128,169,297
KAKAMEGA,ALL,93,136,159,295
KAKAMEGA,ALL,94,63,124,187
KAKAMEGA,ALL,90-94,746,979,1725
KAKAMEGA,ALL,95,113,204,317
KAKAMEGA,ALL,96,46,85,131
KAKAMEGA,ALL,97,80,118,198
KAKAMEGA,ALL,98,36,55,91
KAKAMEGA,ALL,99,31,92,123
KAKAMEGA,ALL,95-99,306,554,860
KAKAMEGA,ALL,100+,47,156,203
KAKAMEGA,ALL,Not Stated,16,15,31
KAKAMEGA,BUTERE,Total,73634,80463,154097
KAKAMEGA,BUTERE,0,1636,1682,3318
KAKAMEGA,BUTERE,1,1714,1832,3546
KAKAMEGA,BUTERE,2,1869,1852,3721
KAKAMEGA,BUTERE,3,1839,2035,3874
KAKAMEGA,BUTERE,4,2025,2025,4050
KAKAMEGA,BUTERE,0 - 4,9083,9426,18509
KAKAMEGA,BUTERE,5,2169,1963,4132
KAKAMEGA,BUTERE,6,2237,2266,4503
KAKAMEGA,BUTERE,7,2252,2330,4582
KAKAMEGA,BUTERE,8,2152,2161,4313
KAKAMEGA,BUTERE,9,2419,2464,4883
KAKAMEGA,BUTERE,05-Sep,11229,11184,22413
KAKAMEGA,BUTERE,10,2516,2526,5042
KAKAMEGA,BUTERE,11,2276,2457,4733
KAKAMEGA,BUTERE,12,2659,2542,5201
KAKAMEGA,BUTERE,13,2425,2507,4932
KAKAMEGA,BUTERE,14,2310,2335,4645
KAKAMEGA,BUTERE,Oct-14,12186,12367,24553
KAKAMEGA,BUTERE,15,2260,2324,4584
KAKAMEGA,BUTERE,16,2081,2107,4188
KAKAMEGA,BUTERE,17,2166,2011,4177
KAKAMEGA,BUTERE,18,1736,1565,3301
KAKAMEGA,BUTERE,19,1720,1630,3350
KAKAMEGA,BUTERE,15-19,9963,9637,19600
KAKAMEGA,BUTERE,20,1379,1457,2836
KAKAMEGA,BUTERE,21,1087,1182,2269
KAKAMEGA,BUTERE,22,943,1069,2012
KAKAMEGA,BUTERE,23,881,1109,1990
KAKAMEGA,BUTERE,24,741,1029,1770
KAKAMEGA,BUTERE,20-24,5031,5846,10877
KAKAMEGA,BUTERE,25,787,1068,1855
KAKAMEGA,BUTERE,26,699,993,1692
KAKAMEGA,BUTERE,27,740,1061,1801
KAKAMEGA,BUTERE,28,644,809,1453
KAKAMEGA,BUTERE,29,629,852,1481
KAKAMEGA,BUTERE,25-29,3499,4783,8282
KAKAMEGA,BUTERE,30,855,1244,2099
KAKAMEGA,BUTERE,31,714,949,1663
KAKAMEGA,BUTERE,32,818,1162,1980
KAKAMEGA,BUTERE,33,687,1015,1702
KAKAMEGA,BUTERE,34,697,879,1576
KAKAMEGA,BUTERE,30-34,3771,5249,9020
KAKAMEGA,BUTERE,35,833,1007,1840
KAKAMEGA,BUTERE,36,649,757,1406
KAKAMEGA,BUTERE,37,705,743,1448
KAKAMEGA,BUTERE,38,496,519,1015
KAKAMEGA,BUTERE,39,582,629,1211
KAKAMEGA,BUTERE,35-39,3265,3655,6920
KAKAMEGA,BUTERE,40,726,795,1521
KAKAMEGA,BUTERE,41,660,699,1359
KAKAMEGA,BUTERE,42,600,711,1311
KAKAMEGA,BUTERE,43,570,645,1215
KAKAMEGA,BUTERE,44,456,524,980
KAKAMEGA,BUTERE,40-44,3012,3374,6386
KAKAMEGA,BUTERE,45,620,725,1345
KAKAMEGA,BUTERE,46,516,520,1036
KAKAMEGA,BUTERE,47,529,586,1115
KAKAMEGA,BUTERE,48,416,446,862
KAKAMEGA,BUTERE,49,450,485,935
KAKAMEGA,BUTERE,45-49,2531,2762,5293
KAKAMEGA,BUTERE,50,563,715,1278
KAKAMEGA,BUTERE,51,536,678,1214
KAKAMEGA,BUTERE,52,411,459,870
KAKAMEGA,BUTERE,53,394,482,876
KAKAMEGA,BUTERE,54,396,456,852
KAKAMEGA,BUTERE,50-54,2300,2790,5090
KAKAMEGA,BUTERE,55,435,493,928
KAKAMEGA,BUTERE,56,392,481,873
KAKAMEGA,BUTERE,57,442,658,1100
KAKAMEGA,BUTERE,58,302,343,645
KAKAMEGA,BUTERE,59,420,467,887
KAKAMEGA,BUTERE,55-59,1991,2442,4433
KAKAMEGA,BUTERE,60,446,614,1060
KAKAMEGA,BUTERE,61,415,428,843
KAKAMEGA,BUTERE,62,355,359,714
KAKAMEGA,BUTERE,63,333,387,720
KAKAMEGA,BUTERE,64,309,311,620
KAKAMEGA,BUTERE,60-64,1858,2099,3957
KAKAMEGA,BUTERE,65,362,414,776
KAKAMEGA,BUTERE,66,249,303,552
KAKAMEGA,BUTERE,67,375,446,821
KAKAMEGA,BUTERE,68,180,176,356
KAKAMEGA,BUTERE,69,226,304,530
KAKAMEGA,BUTERE,65-69,1392,1643,3035
KAKAMEGA,BUTERE,70,357,447,804
KAKAMEGA,BUTERE,71,207,262,469
KAKAMEGA,BUTERE,72,195,185,380
KAKAMEGA,BUTERE,73,178,156,334
KAKAMEGA,BUTERE,74,159,165,324
KAKAMEGA,BUTERE,70-74,1096,1215,2311
KAKAMEGA,BUTERE,75,156,194,350
KAKAMEGA,BUTERE,76,142,258,400
KAKAMEGA,BUTERE,77,150,194,344
KAKAMEGA,BUTERE,78,66,78,144
KAKAMEGA,BUTERE,79,84,180,264
KAKAMEGA,BUTERE,75-79,598,904,1502
KAKAMEGA,BUTERE,80,125,166,291
KAKAMEGA,BUTERE,81,88,102,190
KAKAMEGA,BUTERE,82,72,86,158
KAKAMEGA,BUTERE,83,97,106,203
KAKAMEGA,BUTERE,84,63,66,129
KAKAMEGA,BUTERE,80-84,445,526,971
KAKAMEGA,BUTERE,85,79,82,161
KAKAMEGA,BUTERE,86,33,62,95
KAKAMEGA,BUTERE,87,74,124,198
KAKAMEGA,BUTERE,88,34,31,65
KAKAMEGA,BUTERE,89,35,81,116
KAKAMEGA,BUTERE,85-89,255,380,635
KAKAMEGA,BUTERE,90,27,40,67
KAKAMEGA,BUTERE,91,20,28,48
KAKAMEGA,BUTERE,92,13,13,26
KAKAMEGA,BUTERE,93,24,18,42
KAKAMEGA,BUTERE,94,7,20,27
KAKAMEGA,BUTERE,90-94,91,119,210
KAKAMEGA,BUTERE,95,11,16,27
KAKAMEGA,BUTERE,96,3,8,11
KAKAMEGA,BUTERE,97,11,8,19
KAKAMEGA,BUTERE,98,3,7,10
KAKAMEGA,BUTERE,99,4,6,10
KAKAMEGA,BUTERE,95-99,32,45,77
KAKAMEGA,BUTERE,100+,5,17,22
KAKAMEGA,BUTERE,Not Stated,1,-,1
KAKAMEGA,KAKAMEGA CENTRAL,Total,92774,95432,188206
KAKAMEGA,KAKAMEGA CENTRAL,0,2236,2195,4431
KAKAMEGA,KAKAMEGA CENTRAL,1,2061,2106,4167
KAKAMEGA,KAKAMEGA CENTRAL,2,2044,2053,4097
KAKAMEGA,KAKAMEGA CENTRAL,3,2175,2124,4299
KAKAMEGA,KAKAMEGA CENTRAL,4,2099,2164,4263
KAKAMEGA,KAKAMEGA CENTRAL,0 - 4,10615,10642,21257
KAKAMEGA,KAKAMEGA CENTRAL,5,2231,2133,4364
KAKAMEGA,KAKAMEGA CENTRAL,6,2282,2241,4523
KAKAMEGA,KAKAMEGA CENTRAL,7,2261,2279,4540
KAKAMEGA,KAKAMEGA CENTRAL,8,2179,2235,4414
KAKAMEGA,KAKAMEGA CENTRAL,9,2314,2491,4805
KAKAMEGA,KAKAMEGA CENTRAL,05-Sep,11267,11379,22646
KAKAMEGA,KAKAMEGA CENTRAL,10,2421,2489,4910
KAKAMEGA,KAKAMEGA CENTRAL,11,2159,2297,4456
KAKAMEGA,KAKAMEGA CENTRAL,12,2407,2526,4933
KAKAMEGA,KAKAMEGA CENTRAL,13,2418,2661,5079
KAKAMEGA,KAKAMEGA CENTRAL,14,2251,2312,4563
KAKAMEGA,KAKAMEGA CENTRAL,Oct-14,11656,12285,23941
KAKAMEGA,KAKAMEGA CENTRAL,15,2246,2274,4520
KAKAMEGA,KAKAMEGA CENTRAL,16,2074,2211,4285
KAKAMEGA,KAKAMEGA CENTRAL,17,2211,2302,4513
KAKAMEGA,KAKAMEGA CENTRAL,18,1909,1880,3789
KAKAMEGA,KAKAMEGA CENTRAL,19,2066,2113,4179
KAKAMEGA,KAKAMEGA CENTRAL,15-19,10506,10780,21286
KAKAMEGA,KAKAMEGA CENTRAL,20,1942,2166,4108
KAKAMEGA,KAKAMEGA CENTRAL,21,2025,2151,4176
KAKAMEGA,KAKAMEGA CENTRAL,22,2067,2305,4372
KAKAMEGA,KAKAMEGA CENTRAL,23,2149,2276,4425
KAKAMEGA,KAKAMEGA CENTRAL,24,1928,2027,3955
KAKAMEGA,KAKAMEGA CENTRAL,20-24,10111,10925,21036
KAKAMEGA,KAKAMEGA CENTRAL,25,2066,1959,4025
KAKAMEGA,KAKAMEGA CENTRAL,26,1667,1731,3398
KAKAMEGA,KAKAMEGA CENTRAL,27,1717,1755,3472
KAKAMEGA,KAKAMEGA CENTRAL,28,1314,1518,2832
KAKAMEGA,KAKAMEGA CENTRAL,29,1473,1560,3033
KAKAMEGA,KAKAMEGA CENTRAL,25-29,8237,8523,16760
KAKAMEGA,KAKAMEGA CENTRAL,30,1790,1935,3725
KAKAMEGA,KAKAMEGA CENTRAL,31,1333,1312,2645
KAKAMEGA,KAKAMEGA CENTRAL,32,1676,1767,3443
KAKAMEGA,KAKAMEGA CENTRAL,33,1261,1391,2652
KAKAMEGA,KAKAMEGA CENTRAL,34,1243,1271,2514
KAKAMEGA,KAKAMEGA CENTRAL,30-34,7303,7676,14979
KAKAMEGA,KAKAMEGA CENTRAL,35,1491,1361,2852
KAKAMEGA,KAKAMEGA CENTRAL,36,1075,996,2071
KAKAMEGA,KAKAMEGA CENTRAL,37,1101,996,2097
KAKAMEGA,KAKAMEGA CENTRAL,38,901,835,1736
KAKAMEGA,KAKAMEGA CENTRAL,39,919,834,1753
KAKAMEGA,KAKAMEGA CENTRAL,35-39,5487,5022,10509
KAKAMEGA,KAKAMEGA CENTRAL,40,1141,1058,2199
KAKAMEGA,KAKAMEGA CENTRAL,41,949,848,1797
KAKAMEGA,KAKAMEGA CENTRAL,42,1027,874,1901
KAKAMEGA,KAKAMEGA CENTRAL,43,870,844,1714
KAKAMEGA,KAKAMEGA CENTRAL,44,707,661,1368
KAKAMEGA,KAKAMEGA CENTRAL,40-44,4694,4285,8979
KAKAMEGA,KAKAMEGA CENTRAL,45,955,848,1803
KAKAMEGA,KAKAMEGA CENTRAL,46,643,653,1296
KAKAMEGA,KAKAMEGA CENTRAL,47,700,657,1357
KAKAMEGA,KAKAMEGA CENTRAL,48,575,516,1091
KAKAMEGA,KAKAMEGA CENTRAL,49,578,541,1119
KAKAMEGA,KAKAMEGA CENTRAL,45-49,3451,3215,6666
KAKAMEGA,KAKAMEGA CENTRAL,50,723,784,1507
KAKAMEGA,KAKAMEGA CENTRAL,51,524,591,1115
KAKAMEGA,KAKAMEGA CENTRAL,52,517,511,1028
KAKAMEGA,KAKAMEGA CENTRAL,53,440,511,951
KAKAMEGA,KAKAMEGA CENTRAL,54,442,460,902
KAKAMEGA,KAKAMEGA CENTRAL,50-54,2646,2857,5503
KAKAMEGA,KAKAMEGA CENTRAL,55,430,467,897
KAKAMEGA,KAKAMEGA CENTRAL,56,498,564,1062
KAKAMEGA,KAKAMEGA CENTRAL,57,445,540,985
KAKAMEGA,KAKAMEGA CENTRAL,58,366,350,716
KAKAMEGA,KAKAMEGA CENTRAL,59,412,462,874
KAKAMEGA,KAKAMEGA CENTRAL,55-59,2151,2383,4534
KAKAMEGA,KAKAMEGA CENTRAL,60,437,477,914
KAKAMEGA,KAKAMEGA CENTRAL,61,349,397,746
KAKAMEGA,KAKAMEGA CENTRAL,62,300,346,646
KAKAMEGA,KAKAMEGA CENTRAL,63,355,373,728
KAKAMEGA,KAKAMEGA CENTRAL,64,263,266,529
KAKAMEGA,KAKAMEGA CENTRAL,60-64,1704,1859,3563
KAKAMEGA,KAKAMEGA CENTRAL,65,321,373,694
KAKAMEGA,KAKAMEGA CENTRAL,66,237,266,503
KAKAMEGA,KAKAMEGA CENTRAL,67,293,352,645
KAKAMEGA,KAKAMEGA CENTRAL,68,139,157,296
KAKAMEGA,KAKAMEGA CENTRAL,69,189,224,413
KAKAMEGA,KAKAMEGA CENTRAL,65-69,1179,1372,2551
KAKAMEGA,KAKAMEGA CENTRAL,70,249,319,568
KAKAMEGA,KAKAMEGA CENTRAL,71,168,194,362
KAKAMEGA,KAKAMEGA CENTRAL,72,149,168,317
KAKAMEGA,KAKAMEGA CENTRAL,73,151,141,292
KAKAMEGA,KAKAMEGA CENTRAL,74,110,156,266
KAKAMEGA,KAKAMEGA CENTRAL,70-74,827,978,1805
KAKAMEGA,KAKAMEGA CENTRAL,75,132,131,263
KAKAMEGA,KAKAMEGA CENTRAL,76,111,165,276
KAKAMEGA,KAKAMEGA CENTRAL,77,87,121,208
KAKAMEGA,KAKAMEGA CENTRAL,78,63,60,123
KAKAMEGA,KAKAMEGA CENTRAL,79,67,90,157
KAKAMEGA,KAKAMEGA CENTRAL,75-79,460,567,1027
KAKAMEGA,KAKAMEGA CENTRAL,80,69,131,200
KAKAMEGA,KAKAMEGA CENTRAL,81,57,66,123
KAKAMEGA,KAKAMEGA CENTRAL,82,55,45,100
KAKAMEGA,KAKAMEGA CENTRAL,83,52,60,112
KAKAMEGA,KAKAMEGA CENTRAL,84,22,43,65
KAKAMEGA,KAKAMEGA CENTRAL,80-84,255,345,600
KAKAMEGA,KAKAMEGA CENTRAL,85,46,50,96
KAKAMEGA,KAKAMEGA CENTRAL,86,25,36,61
KAKAMEGA,KAKAMEGA CENTRAL,87,32,59,91
KAKAMEGA,KAKAMEGA CENTRAL,88,11,22,33
KAKAMEGA,KAKAMEGA CENTRAL,89,25,47,72
KAKAMEGA,KAKAMEGA CENTRAL,85-89,139,214,353
KAKAMEGA,KAKAMEGA CENTRAL,90,14,17,31
KAKAMEGA,KAKAMEGA CENTRAL,91,10,17,27
KAKAMEGA,KAKAMEGA CENTRAL,92,6,9,15
KAKAMEGA,KAKAMEGA CENTRAL,93,15,14,29
KAKAMEGA,KAKAMEGA CENTRAL,94,5,10,15
KAKAMEGA,KAKAMEGA CENTRAL,90-94,50,67,117
KAKAMEGA,KAKAMEGA CENTRAL,95,6,16,22
KAKAMEGA,KAKAMEGA CENTRAL,96,4,5,9
KAKAMEGA,KAKAMEGA CENTRAL,97,7,12,19
KAKAMEGA,KAKAMEGA CENTRAL,98,8,6,14
KAKAMEGA,KAKAMEGA CENTRAL,99,4,5,9
KAKAMEGA,KAKAMEGA CENTRAL,95-99,29,44,73
KAKAMEGA,KAKAMEGA CENTRAL,100+,5,12,17
KAKAMEGA,KAKAMEGA CENTRAL,Not Stated,2,2,4
KAKAMEGA,KAKAMEGA EAST,Total,80853,86784,167637
KAKAMEGA,KAKAMEGA EAST,0,1711,1816,3527
KAKAMEGA,KAKAMEGA EAST,1,1890,1922,3812
KAKAMEGA,KAKAMEGA EAST,2,1852,1750,3602
KAKAMEGA,KAKAMEGA EAST,3,1949,1962,3911
KAKAMEGA,KAKAMEGA EAST,4,2084,2144,4228
KAKAMEGA,KAKAMEGA EAST,0 - 4,9486,9594,19080
KAKAMEGA,KAKAMEGA EAST,5,2198,2015,4213
KAKAMEGA,KAKAMEGA EAST,6,2316,2263,4579
KAKAMEGA,KAKAMEGA EAST,7,2412,2313,4725
KAKAMEGA,KAKAMEGA EAST,8,2141,2277,4418
KAKAMEGA,KAKAMEGA EAST,9,2474,2541,5015
KAKAMEGA,KAKAMEGA EAST,05-Sep,11541,11409,22950
KAKAMEGA,KAKAMEGA EAST,10,2554,2516,5070
KAKAMEGA,KAKAMEGA EAST,11,2335,2468,4803
KAKAMEGA,KAKAMEGA EAST,12,2669,2628,5297
KAKAMEGA,KAKAMEGA EAST,13,2586,2696,5282
KAKAMEGA,KAKAMEGA EAST,14,2425,2456,4881
KAKAMEGA,KAKAMEGA EAST,Oct-14,12569,12764,25333
KAKAMEGA,KAKAMEGA EAST,15,2402,2395,4797
KAKAMEGA,KAKAMEGA EAST,16,2340,2258,4598
KAKAMEGA,KAKAMEGA EAST,17,2456,2168,4624
KAKAMEGA,KAKAMEGA EAST,18,1972,1741,3713
KAKAMEGA,KAKAMEGA EAST,19,1837,1810,3647
KAKAMEGA,KAKAMEGA EAST,15-19,11007,10372,21379
KAKAMEGA,KAKAMEGA EAST,20,1588,1687,3275
KAKAMEGA,KAKAMEGA EAST,21,1259,1347,2606
KAKAMEGA,KAKAMEGA EAST,22,1193,1224,2417
KAKAMEGA,KAKAMEGA EAST,23,1114,1280,2394
KAKAMEGA,KAKAMEGA EAST,24,937,1088,2025
KAKAMEGA,KAKAMEGA EAST,20-24,6091,6626,12717
KAKAMEGA,KAKAMEGA EAST,25,1057,1263,2320
KAKAMEGA,KAKAMEGA EAST,26,861,1123,1984
KAKAMEGA,KAKAMEGA EAST,27,964,1123,2087
KAKAMEGA,KAKAMEGA EAST,28,820,990,1810
KAKAMEGA,KAKAMEGA EAST,29,835,1074,1909
KAKAMEGA,KAKAMEGA EAST,25-29,4537,5573,10110
KAKAMEGA,KAKAMEGA EAST,30,1050,1343,2393
KAKAMEGA,KAKAMEGA EAST,31,836,1096,1932
KAKAMEGA,KAKAMEGA EAST,32,991,1332,2323
KAKAMEGA,KAKAMEGA EAST,33,898,1061,1959
KAKAMEGA,KAKAMEGA EAST,34,829,896,1725
KAKAMEGA,KAKAMEGA EAST,30-34,4604,5728,10332
KAKAMEGA,KAKAMEGA EAST,35,987,1060,2047
KAKAMEGA,KAKAMEGA EAST,36,757,814,1571
KAKAMEGA,KAKAMEGA EAST,37,817,753,1570
KAKAMEGA,KAKAMEGA EAST,38,609,682,1291
KAKAMEGA,KAKAMEGA EAST,39,734,710,1444
KAKAMEGA,KAKAMEGA EAST,35-39,3904,4019,7923
KAKAMEGA,KAKAMEGA EAST,40,722,864,1586
KAKAMEGA,KAKAMEGA EAST,41,774,820,1594
KAKAMEGA,KAKAMEGA EAST,42,776,843,1619
KAKAMEGA,KAKAMEGA EAST,43,674,786,1460
KAKAMEGA,KAKAMEGA EAST,44,544,630,1174
KAKAMEGA,KAKAMEGA EAST,40-44,3490,3943,7433
KAKAMEGA,KAKAMEGA EAST,45,745,868,1613
KAKAMEGA,KAKAMEGA EAST,46,559,666,1225
KAKAMEGA,KAKAMEGA EAST,47,587,645,1232
KAKAMEGA,KAKAMEGA EAST,48,495,473,968
KAKAMEGA,KAKAMEGA EAST,49,462,576,1038
KAKAMEGA,KAKAMEGA EAST,45-49,2848,3228,6076
KAKAMEGA,KAKAMEGA EAST,50,569,783,1352
KAKAMEGA,KAKAMEGA EAST,51,549,584,1133
KAKAMEGA,KAKAMEGA EAST,52,471,548,1019
KAKAMEGA,KAKAMEGA EAST,53,387,484,871
KAKAMEGA,KAKAMEGA EAST,54,444,549,993
KAKAMEGA,KAKAMEGA EAST,50-54,2420,2948,5368
KAKAMEGA,KAKAMEGA EAST,55,444,552,996
KAKAMEGA,KAKAMEGA EAST,56,512,546,1058
KAKAMEGA,KAKAMEGA EAST,57,486,641,1127
KAKAMEGA,KAKAMEGA EAST,58,378,478,856
KAKAMEGA,KAKAMEGA EAST,59,437,528,965
KAKAMEGA,KAKAMEGA EAST,55-59,2257,2745,5002
KAKAMEGA,KAKAMEGA EAST,60,511,651,1162
KAKAMEGA,KAKAMEGA EAST,61,401,512,913
KAKAMEGA,KAKAMEGA EAST,62,414,466,880
KAKAMEGA,KAKAMEGA EAST,63,364,499,863
KAKAMEGA,KAKAMEGA EAST,64,327,437,764
KAKAMEGA,KAKAMEGA EAST,60-64,2017,2565,4582
KAKAMEGA,KAKAMEGA EAST,65,380,500,880
KAKAMEGA,KAKAMEGA EAST,66,269,353,622
KAKAMEGA,KAKAMEGA EAST,67,348,443,791
KAKAMEGA,KAKAMEGA EAST,68,209,214,423
KAKAMEGA,KAKAMEGA EAST,69,287,348,635
KAKAMEGA,KAKAMEGA EAST,65-69,1493,1858,3351
KAKAMEGA,KAKAMEGA EAST,70,342,412,754
KAKAMEGA,KAKAMEGA EAST,71,263,289,552
KAKAMEGA,KAKAMEGA EAST,72,227,216,443
KAKAMEGA,KAKAMEGA EAST,73,186,192,378
KAKAMEGA,KAKAMEGA EAST,74,174,204,378
KAKAMEGA,KAKAMEGA EAST,70-74,1192,1313,2505
KAKAMEGA,KAKAMEGA EAST,75,156,226,382
KAKAMEGA,KAKAMEGA EAST,76,205,289,494
KAKAMEGA,KAKAMEGA EAST,77,120,200,320
KAKAMEGA,KAKAMEGA EAST,78,74,95,169
KAKAMEGA,KAKAMEGA EAST,79,90,158,248
KAKAMEGA,KAKAMEGA EAST,75-79,645,968,1613
KAKAMEGA,KAKAMEGA EAST,80,105,161,266
KAKAMEGA,KAKAMEGA EAST,81,79,110,189
KAKAMEGA,KAKAMEGA EAST,82,78,103,181
KAKAMEGA,KAKAMEGA EAST,83,83,108,191
KAKAMEGA,KAKAMEGA EAST,84,60,74,134
KAKAMEGA,KAKAMEGA EAST,80-84,405,556,961
KAKAMEGA,KAKAMEGA EAST,85,61,82,143
KAKAMEGA,KAKAMEGA EAST,86,50,82,132
KAKAMEGA,KAKAMEGA EAST,87,61,78,139
KAKAMEGA,KAKAMEGA EAST,88,24,34,58
KAKAMEGA,KAKAMEGA EAST,89,31,75,106
KAKAMEGA,KAKAMEGA EAST,85-89,227,351,578
KAKAMEGA,KAKAMEGA EAST,90,31,30,61
KAKAMEGA,KAKAMEGA EAST,91,18,27,45
KAKAMEGA,KAKAMEGA EAST,92,17,22,39
KAKAMEGA,KAKAMEGA EAST,93,4,21,25
KAKAMEGA,KAKAMEGA EAST,94,8,16,24
KAKAMEGA,KAKAMEGA EAST,90-94,78,116,194
KAKAMEGA,KAKAMEGA EAST,95,16,29,45
KAKAMEGA,KAKAMEGA EAST,96,8,7,15
KAKAMEGA,KAKAMEGA EAST,97,7,14,21
KAKAMEGA,KAKAMEGA EAST,98,4,4,8
KAKAMEGA,KAKAMEGA EAST,99,2,17,19
KAKAMEGA,KAKAMEGA EAST,95-99,37,71,108
KAKAMEGA,KAKAMEGA EAST,100+,3,33,36
KAKAMEGA,KAKAMEGA EAST,Not Stated,2,4,6
KAKAMEGA,KAKAMEGA NORTH,Total,115511,122814,238325
KAKAMEGA,KAKAMEGA NORTH,0,2824,2766,5590
KAKAMEGA,KAKAMEGA NORTH,1,2836,2791,5627
KAKAMEGA,KAKAMEGA NORTH,2,2891,2946,5837
KAKAMEGA,KAKAMEGA NORTH,3,3024,3211,6235
KAKAMEGA,KAKAMEGA NORTH,4,3292,3219,6511
KAKAMEGA,KAKAMEGA NORTH,0 - 4,14867,14933,29800
KAKAMEGA,KAKAMEGA NORTH,5,3387,3485,6872
KAKAMEGA,KAKAMEGA NORTH,6,3465,3532,6997
KAKAMEGA,KAKAMEGA NORTH,7,3437,3391,6828
KAKAMEGA,KAKAMEGA NORTH,8,3437,3515,6952
KAKAMEGA,KAKAMEGA NORTH,9,3975,3870,7845
KAKAMEGA,KAKAMEGA NORTH,05-Sep,17701,17793,35494
KAKAMEGA,KAKAMEGA NORTH,10,3733,3760,7493
KAKAMEGA,KAKAMEGA NORTH,11,3744,3798,7542
KAKAMEGA,KAKAMEGA NORTH,12,3937,3875,7812
KAKAMEGA,KAKAMEGA NORTH,13,3979,4030,8009
KAKAMEGA,KAKAMEGA NORTH,14,3568,3593,7161
KAKAMEGA,KAKAMEGA NORTH,Oct-14,18961,19056,38017
KAKAMEGA,KAKAMEGA NORTH,15,3458,3592,7050
KAKAMEGA,KAKAMEGA NORTH,16,3328,3264,6592
KAKAMEGA,KAKAMEGA NORTH,17,3208,3148,6356
KAKAMEGA,KAKAMEGA NORTH,18,2640,2517,5157
KAKAMEGA,KAKAMEGA NORTH,19,2697,2575,5272
KAKAMEGA,KAKAMEGA NORTH,15-19,15331,15096,30427
KAKAMEGA,KAKAMEGA NORTH,20,2468,2550,5018
KAKAMEGA,KAKAMEGA NORTH,21,2039,2056,4095
KAKAMEGA,KAKAMEGA NORTH,22,1688,1788,3476
KAKAMEGA,KAKAMEGA NORTH,23,1615,1985,3600
KAKAMEGA,KAKAMEGA NORTH,24,1421,1599,3020
KAKAMEGA,KAKAMEGA NORTH,20-24,9231,9978,19209
KAKAMEGA,KAKAMEGA NORTH,25,1490,1928,3418
KAKAMEGA,KAKAMEGA NORTH,26,1297,1615,2912
KAKAMEGA,KAKAMEGA NORTH,27,1341,1767,3108
KAKAMEGA,KAKAMEGA NORTH,28,1024,1311,2335
KAKAMEGA,KAKAMEGA NORTH,29,1165,1570,2735
KAKAMEGA,KAKAMEGA NORTH,25-29,6317,8191,14508
KAKAMEGA,KAKAMEGA NORTH,30,1368,1927,3295
KAKAMEGA,KAKAMEGA NORTH,31,1230,1575,2805
KAKAMEGA,KAKAMEGA NORTH,32,1523,2036,3559
KAKAMEGA,KAKAMEGA NORTH,33,1346,1786,3132
KAKAMEGA,KAKAMEGA NORTH,34,1174,1494,2668
KAKAMEGA,KAKAMEGA NORTH,30-34,6641,8818,15459
KAKAMEGA,KAKAMEGA NORTH,35,1393,1514,2907
KAKAMEGA,KAKAMEGA NORTH,36,1034,1074,2108
KAKAMEGA,KAKAMEGA NORTH,37,1120,1100,2220
KAKAMEGA,KAKAMEGA NORTH,38,808,762,1570
KAKAMEGA,KAKAMEGA NORTH,39,907,875,1782
KAKAMEGA,KAKAMEGA NORTH,35-39,5262,5325,10587
KAKAMEGA,KAKAMEGA NORTH,40,996,1067,2063
KAKAMEGA,KAKAMEGA NORTH,41,1004,1107,2111
KAKAMEGA,KAKAMEGA NORTH,42,1107,1121,2228
KAKAMEGA,KAKAMEGA NORTH,43,1037,1095,2132
KAKAMEGA,KAKAMEGA NORTH,44,901,969,1870
KAKAMEGA,KAKAMEGA NORTH,40-44,5045,5359,10404
KAKAMEGA,KAKAMEGA NORTH,45,1089,1144,2233
KAKAMEGA,KAKAMEGA NORTH,46,859,872,1731
KAKAMEGA,KAKAMEGA NORTH,47,851,841,1692
KAKAMEGA,KAKAMEGA NORTH,48,605,575,1180
KAKAMEGA,KAKAMEGA NORTH,49,627,630,1257
KAKAMEGA,KAKAMEGA NORTH,45-49,4031,4062,8093
KAKAMEGA,KAKAMEGA NORTH,50,636,774,1410
KAKAMEGA,KAKAMEGA NORTH,51,663,712,1375
KAKAMEGA,KAKAMEGA NORTH,52,511,608,1119
KAKAMEGA,KAKAMEGA NORTH,53,453,562,1015
KAKAMEGA,KAKAMEGA NORTH,54,508,564,1072
KAKAMEGA,KAKAMEGA NORTH,50-54,2771,3220,5991
KAKAMEGA,KAKAMEGA NORTH,55,610,585,1195
KAKAMEGA,KAKAMEGA NORTH,56,530,597,1127
KAKAMEGA,KAKAMEGA NORTH,57,641,841,1482
KAKAMEGA,KAKAMEGA NORTH,58,468,464,932
KAKAMEGA,KAKAMEGA NORTH,59,603,638,1241
KAKAMEGA,KAKAMEGA NORTH,55-59,2852,3125,5977
KAKAMEGA,KAKAMEGA NORTH,60,567,590,1157
KAKAMEGA,KAKAMEGA NORTH,61,545,579,1124
KAKAMEGA,KAKAMEGA NORTH,62,389,461,850
KAKAMEGA,KAKAMEGA NORTH,63,446,550,996
KAKAMEGA,KAKAMEGA NORTH,64,337,410,747
KAKAMEGA,KAKAMEGA NORTH,60-64,2284,2590,4874
KAKAMEGA,KAKAMEGA NORTH,65,450,564,1014
KAKAMEGA,KAKAMEGA NORTH,66,276,323,599
KAKAMEGA,KAKAMEGA NORTH,67,399,464,863
KAKAMEGA,KAKAMEGA NORTH,68,193,226,419
KAKAMEGA,KAKAMEGA NORTH,69,292,332,624
KAKAMEGA,KAKAMEGA NORTH,65-69,1610,1909,3519
KAKAMEGA,KAKAMEGA NORTH,70,322,387,709
KAKAMEGA,KAKAMEGA NORTH,71,264,304,568
KAKAMEGA,KAKAMEGA NORTH,72,245,217,462
KAKAMEGA,KAKAMEGA NORTH,73,195,198,393
KAKAMEGA,KAKAMEGA NORTH,74,178,210,388
KAKAMEGA,KAKAMEGA NORTH,70-74,1204,1316,2520
KAKAMEGA,KAKAMEGA NORTH,75,161,224,385
KAKAMEGA,KAKAMEGA NORTH,76,160,308,468
KAKAMEGA,KAKAMEGA NORTH,77,144,216,360
KAKAMEGA,KAKAMEGA NORTH,78,78,107,185
KAKAMEGA,KAKAMEGA NORTH,79,82,159,241
KAKAMEGA,KAKAMEGA NORTH,75-79,625,1014,1639
KAKAMEGA,KAKAMEGA NORTH,80,111,140,251
KAKAMEGA,KAKAMEGA NORTH,81,88,134,222
KAKAMEGA,KAKAMEGA NORTH,82,91,95,186
KAKAMEGA,KAKAMEGA NORTH,83,88,116,204
KAKAMEGA,KAKAMEGA NORTH,84,59,61,120
KAKAMEGA,KAKAMEGA NORTH,80-84,437,546,983
KAKAMEGA,KAKAMEGA NORTH,85,58,55,113
KAKAMEGA,KAKAMEGA NORTH,86,59,69,128
KAKAMEGA,KAKAMEGA NORTH,87,59,97,156
KAKAMEGA,KAKAMEGA NORTH,88,14,31,45
KAKAMEGA,KAKAMEGA NORTH,89,38,58,96
KAKAMEGA,KAKAMEGA NORTH,85-89,228,310,538
KAKAMEGA,KAKAMEGA NORTH,90,17,29,46
KAKAMEGA,KAKAMEGA NORTH,91,23,18,41
KAKAMEGA,KAKAMEGA NORTH,92,17,22,39
KAKAMEGA,KAKAMEGA NORTH,93,14,14,28
KAKAMEGA,KAKAMEGA NORTH,94,2,9,11
KAKAMEGA,KAKAMEGA NORTH,90-94,73,92,165
KAKAMEGA,KAKAMEGA NORTH,95,7,25,32
KAKAMEGA,KAKAMEGA NORTH,96,6,10,16
KAKAMEGA,KAKAMEGA NORTH,97,11,12,23
KAKAMEGA,KAKAMEGA NORTH,98,4,10,14
KAKAMEGA,KAKAMEGA NORTH,99,4,9,13
KAKAMEGA,KAKAMEGA NORTH,95-99,32,66,98
KAKAMEGA,KAKAMEGA NORTH,100+,6,15,21
KAKAMEGA,KAKAMEGA NORTH,Not Stated,2,-,2
KAKAMEGA,KAKAMEGA SOUTH,Total,53219,58524,111743
KAKAMEGA,KAKAMEGA SOUTH,0,1107,1139,2246
KAKAMEGA,KAKAMEGA SOUTH,1,1284,1310,2594
KAKAMEGA,KAKAMEGA SOUTH,2,1223,1213,2436
KAKAMEGA,KAKAMEGA SOUTH,3,1353,1280,2633
KAKAMEGA,KAKAMEGA SOUTH,4,1351,1318,2669
KAKAMEGA,KAKAMEGA SOUTH,0 - 4,6318,6260,12578
KAKAMEGA,KAKAMEGA SOUTH,5,1410,1391,2801
KAKAMEGA,KAKAMEGA SOUTH,6,1549,1478,3027
KAKAMEGA,KAKAMEGA SOUTH,7,1606,1545,3151
KAKAMEGA,KAKAMEGA SOUTH,8,1512,1531,3043
KAKAMEGA,KAKAMEGA SOUTH,9,1621,1691,3312
KAKAMEGA,KAKAMEGA SOUTH,05-Sep,7698,7636,15334
KAKAMEGA,KAKAMEGA SOUTH,10,1638,1656,3294
KAKAMEGA,KAKAMEGA SOUTH,11,1541,1638,3179
KAKAMEGA,KAKAMEGA SOUTH,12,1736,1805,3541
KAKAMEGA,KAKAMEGA SOUTH,13,1765,1863,3628
KAKAMEGA,KAKAMEGA SOUTH,14,1544,1633,3177
KAKAMEGA,KAKAMEGA SOUTH,Oct-14,8224,8595,16819
KAKAMEGA,KAKAMEGA SOUTH,15,1557,1620,3177
KAKAMEGA,KAKAMEGA SOUTH,16,1398,1602,3000
KAKAMEGA,KAKAMEGA SOUTH,17,1578,1573,3151
KAKAMEGA,KAKAMEGA SOUTH,18,1299,1186,2485
KAKAMEGA,KAKAMEGA SOUTH,19,1296,1241,2537
KAKAMEGA,KAKAMEGA SOUTH,15-19,7128,7222,14350
KAKAMEGA,KAKAMEGA SOUTH,20,1093,1079,2172
KAKAMEGA,KAKAMEGA SOUTH,21,854,860,1714
KAKAMEGA,KAKAMEGA SOUTH,22,770,854,1624
KAKAMEGA,KAKAMEGA SOUTH,23,697,875,1572
KAKAMEGA,KAKAMEGA SOUTH,24,636,776,1412
KAKAMEGA,KAKAMEGA SOUTH,20-24,4050,4444,8494
KAKAMEGA,KAKAMEGA SOUTH,25,687,783,1470
KAKAMEGA,KAKAMEGA SOUTH,26,519,703,1222
KAKAMEGA,KAKAMEGA SOUTH,27,562,702,1264
KAKAMEGA,KAKAMEGA SOUTH,28,511,656,1167
KAKAMEGA,KAKAMEGA SOUTH,29,504,655,1159
KAKAMEGA,KAKAMEGA SOUTH,25-29,2783,3499,6282
KAKAMEGA,KAKAMEGA SOUTH,30,646,822,1468
KAKAMEGA,KAKAMEGA SOUTH,31,505,652,1157
KAKAMEGA,KAKAMEGA SOUTH,32,648,818,1466
KAKAMEGA,KAKAMEGA SOUTH,33,556,684,1240
KAKAMEGA,KAKAMEGA SOUTH,34,507,617,1124
KAKAMEGA,KAKAMEGA SOUTH,30-34,2862,3593,6455
KAKAMEGA,KAKAMEGA SOUTH,35,603,649,1252
KAKAMEGA,KAKAMEGA SOUTH,36,475,516,991
KAKAMEGA,KAKAMEGA SOUTH,37,514,494,1008
KAKAMEGA,KAKAMEGA SOUTH,38,379,409,788
KAKAMEGA,KAKAMEGA SOUTH,39,459,479,938
KAKAMEGA,KAKAMEGA SOUTH,35-39,2430,2547,4977
KAKAMEGA,KAKAMEGA SOUTH,40,512,514,1026
KAKAMEGA,KAKAMEGA SOUTH,41,441,545,986
KAKAMEGA,KAKAMEGA SOUTH,42,468,512,980
KAKAMEGA,KAKAMEGA SOUTH,43,406,541,947
KAKAMEGA,KAKAMEGA SOUTH,44,395,484,879
KAKAMEGA,KAKAMEGA SOUTH,40-44,2222,2596,4818
KAKAMEGA,KAKAMEGA SOUTH,45,485,585,1070
KAKAMEGA,KAKAMEGA SOUTH,46,371,406,777
KAKAMEGA,KAKAMEGA SOUTH,47,364,433,797
KAKAMEGA,KAKAMEGA SOUTH,48,285,328,613
KAKAMEGA,KAKAMEGA SOUTH,49,307,423,730
KAKAMEGA,KAKAMEGA SOUTH,45-49,1812,2175,3987
KAKAMEGA,KAKAMEGA SOUTH,50,380,563,943
KAKAMEGA,KAKAMEGA SOUTH,51,297,389,686
KAKAMEGA,KAKAMEGA SOUTH,52,313,372,685
KAKAMEGA,KAKAMEGA SOUTH,53,254,332,586
KAKAMEGA,KAKAMEGA SOUTH,54,304,349,653
KAKAMEGA,KAKAMEGA SOUTH,50-54,1548,2005,3553
KAKAMEGA,KAKAMEGA SOUTH,55,338,394,732
KAKAMEGA,KAKAMEGA SOUTH,56,334,448,782
KAKAMEGA,KAKAMEGA SOUTH,57,292,530,822
KAKAMEGA,KAKAMEGA SOUTH,58,237,333,570
KAKAMEGA,KAKAMEGA SOUTH,59,328,394,722
KAKAMEGA,KAKAMEGA SOUTH,55-59,1529,2099,3628
KAKAMEGA,KAKAMEGA SOUTH,60,360,461,821
KAKAMEGA,KAKAMEGA SOUTH,61,284,347,631
KAKAMEGA,KAKAMEGA SOUTH,62,289,353,642
KAKAMEGA,KAKAMEGA SOUTH,63,263,333,596
KAKAMEGA,KAKAMEGA SOUTH,64,266,256,522
KAKAMEGA,KAKAMEGA SOUTH,60-64,1462,1750,3212
KAKAMEGA,KAKAMEGA SOUTH,65,288,351,639
KAKAMEGA,KAKAMEGA SOUTH,66,208,269,477
KAKAMEGA,KAKAMEGA SOUTH,67,279,360,639
KAKAMEGA,KAKAMEGA SOUTH,68,151,174,325
KAKAMEGA,KAKAMEGA SOUTH,69,226,237,463
KAKAMEGA,KAKAMEGA SOUTH,65-69,1152,1391,2543
KAKAMEGA,KAKAMEGA SOUTH,70,253,283,536
KAKAMEGA,KAKAMEGA SOUTH,71,187,211,398
KAKAMEGA,KAKAMEGA SOUTH,72,174,185,359
KAKAMEGA,KAKAMEGA SOUTH,73,141,179,320
KAKAMEGA,KAKAMEGA SOUTH,74,126,176,302
KAKAMEGA,KAKAMEGA SOUTH,70-74,881,1034,1915
KAKAMEGA,KAKAMEGA SOUTH,75,118,175,293
KAKAMEGA,KAKAMEGA SOUTH,76,132,259,391
KAKAMEGA,KAKAMEGA SOUTH,77,107,155,262
KAKAMEGA,KAKAMEGA SOUTH,78,75,83,158
KAKAMEGA,KAKAMEGA SOUTH,79,85,131,216
KAKAMEGA,KAKAMEGA SOUTH,75-79,517,803,1320
KAKAMEGA,KAKAMEGA SOUTH,80,107,123,230
KAKAMEGA,KAKAMEGA SOUTH,81,59,98,157
KAKAMEGA,KAKAMEGA SOUTH,82,68,84,152
KAKAMEGA,KAKAMEGA SOUTH,83,66,75,141
KAKAMEGA,KAKAMEGA SOUTH,84,54,80,134
KAKAMEGA,KAKAMEGA SOUTH,80-84,354,460,814
KAKAMEGA,KAKAMEGA SOUTH,85,39,55,94
KAKAMEGA,KAKAMEGA SOUTH,86,25,68,93
KAKAMEGA,KAKAMEGA SOUTH,87,47,65,112
KAKAMEGA,KAKAMEGA SOUTH,88,25,28,53
KAKAMEGA,KAKAMEGA SOUTH,89,27,56,83
KAKAMEGA,KAKAMEGA SOUTH,85-89,163,272,435
KAKAMEGA,KAKAMEGA SOUTH,90,15,33,48
KAKAMEGA,KAKAMEGA SOUTH,91,17,22,39
KAKAMEGA,KAKAMEGA SOUTH,92,10,11,21
KAKAMEGA,KAKAMEGA SOUTH,93,8,7,15
KAKAMEGA,KAKAMEGA SOUTH,94,7,8,15
KAKAMEGA,KAKAMEGA SOUTH,90-94,57,81,138
KAKAMEGA,KAKAMEGA SOUTH,95,13,16,29
KAKAMEGA,KAKAMEGA SOUTH,96,2,4,6
KAKAMEGA,KAKAMEGA SOUTH,97,4,12,16
KAKAMEGA,KAKAMEGA SOUTH,98,2,3,5
KAKAMEGA,KAKAMEGA SOUTH,99,2,14,16
KAKAMEGA,KAKAMEGA SOUTH,95-99,23,49,72
KAKAMEGA,KAKAMEGA SOUTH,100+,5,12,17
KAKAMEGA,KAKAMEGA SOUTH,Not Stated,1,1,2
KAKAMEGA,KHWISERO,Total,53670,59803,113473
KAKAMEGA,KHWISERO,0,1177,1216,2393
KAKAMEGA,KHWISERO,1,1206,1174,2380
KAKAMEGA,KHWISERO,2,1246,1297,2543
KAKAMEGA,KHWISERO,3,1385,1394,2779
KAKAMEGA,KHWISERO,4,1472,1407,2879
KAKAMEGA,KHWISERO,0 - 4,6486,6488,12974
KAKAMEGA,KHWISERO,5,1530,1476,3006
KAKAMEGA,KHWISERO,6,1588,1610,3198
KAKAMEGA,KHWISERO,7,1608,1738,3346
KAKAMEGA,KHWISERO,8,1534,1617,3151
KAKAMEGA,KHWISERO,9,1736,1731,3467
KAKAMEGA,KHWISERO,05-Sep,7996,8172,16168
KAKAMEGA,KHWISERO,10,1817,1771,3588
KAKAMEGA,KHWISERO,11,1593,1716,3309
KAKAMEGA,KHWISERO,12,1949,1879,3828
KAKAMEGA,KHWISERO,13,1735,1849,3584
KAKAMEGA,KHWISERO,14,1717,1780,3497
KAKAMEGA,KHWISERO,Oct-14,8811,8995,17806
KAKAMEGA,KHWISERO,15,1737,1658,3395
KAKAMEGA,KHWISERO,16,1518,1543,3061
KAKAMEGA,KHWISERO,17,1566,1490,3056
KAKAMEGA,KHWISERO,18,1253,1168,2421
KAKAMEGA,KHWISERO,19,1187,1189,2376
KAKAMEGA,KHWISERO,15-19,7261,7048,14309
KAKAMEGA,KHWISERO,20,910,992,1902
KAKAMEGA,KHWISERO,21,713,863,1576
KAKAMEGA,KHWISERO,22,686,804,1490
KAKAMEGA,KHWISERO,23,596,746,1342
KAKAMEGA,KHWISERO,24,510,682,1192
KAKAMEGA,KHWISERO,20-24,3415,4087,7502
KAKAMEGA,KHWISERO,25,558,726,1284
KAKAMEGA,KHWISERO,26,475,706,1181
KAKAMEGA,KHWISERO,27,503,714,1217
KAKAMEGA,KHWISERO,28,447,586,1033
KAKAMEGA,KHWISERO,29,473,658,1131
KAKAMEGA,KHWISERO,25-29,2456,3390,5846
KAKAMEGA,KHWISERO,30,612,949,1561
KAKAMEGA,KHWISERO,31,443,631,1074
KAKAMEGA,KHWISERO,32,563,808,1371
KAKAMEGA,KHWISERO,33,458,680,1138
KAKAMEGA,KHWISERO,34,462,606,1068
KAKAMEGA,KHWISERO,30-34,2538,3674,6212
KAKAMEGA,KHWISERO,35,592,747,1339
KAKAMEGA,KHWISERO,36,474,536,1010
KAKAMEGA,KHWISERO,37,493,511,1004
KAKAMEGA,KHWISERO,38,393,408,801
KAKAMEGA,KHWISERO,39,377,509,886
KAKAMEGA,KHWISERO,35-39,2329,2711,5040
KAKAMEGA,KHWISERO,40,508,634,1142
KAKAMEGA,KHWISERO,41,459,578,1037
KAKAMEGA,KHWISERO,42,483,534,1017
KAKAMEGA,KHWISERO,43,408,500,908
KAKAMEGA,KHWISERO,44,373,391,764
KAKAMEGA,KHWISERO,40-44,2231,2637,4868
KAKAMEGA,KHWISERO,45,446,497,943
KAKAMEGA,KHWISERO,46,335,335,670
KAKAMEGA,KHWISERO,47,381,408,789
KAKAMEGA,KHWISERO,48,296,342,638
KAKAMEGA,KHWISERO,49,340,359,699
KAKAMEGA,KHWISERO,45-49,1798,1941,3739
KAKAMEGA,KHWISERO,50,456,621,1077
KAKAMEGA,KHWISERO,51,320,474,794
KAKAMEGA,KHWISERO,52,333,409,742
KAKAMEGA,KHWISERO,53,274,370,644
KAKAMEGA,KHWISERO,54,295,327,622
KAKAMEGA,KHWISERO,50-54,1678,2201,3879
KAKAMEGA,KHWISERO,55,338,382,720
KAKAMEGA,KHWISERO,56,353,388,741
KAKAMEGA,KHWISERO,57,344,481,825
KAKAMEGA,KHWISERO,58,252,310,562
KAKAMEGA,KHWISERO,59,317,435,752
KAKAMEGA,KHWISERO,55-59,1604,1996,3600
KAKAMEGA,KHWISERO,60,372,512,884
KAKAMEGA,KHWISERO,61,330,377,707
KAKAMEGA,KHWISERO,62,306,317,623
KAKAMEGA,KHWISERO,63,319,365,684
KAKAMEGA,KHWISERO,64,225,309,534
KAKAMEGA,KHWISERO,60-64,1552,1880,3432
KAKAMEGA,KHWISERO,65,316,381,697
KAKAMEGA,KHWISERO,66,267,281,548
KAKAMEGA,KHWISERO,67,315,409,724
KAKAMEGA,KHWISERO,68,132,165,297
KAKAMEGA,KHWISERO,69,235,293,528
KAKAMEGA,KHWISERO,65-69,1265,1529,2794
KAKAMEGA,KHWISERO,70,332,482,814
KAKAMEGA,KHWISERO,71,186,205,391
KAKAMEGA,KHWISERO,72,202,187,389
KAKAMEGA,KHWISERO,73,142,181,323
KAKAMEGA,KHWISERO,74,147,188,335
KAKAMEGA,KHWISERO,70-74,1009,1243,2252
KAKAMEGA,KHWISERO,75,126,177,303
KAKAMEGA,KHWISERO,76,136,243,379
KAKAMEGA,KHWISERO,77,108,169,277
KAKAMEGA,KHWISERO,78,75,81,156
KAKAMEGA,KHWISERO,79,89,122,211
KAKAMEGA,KHWISERO,75-79,534,792,1326
KAKAMEGA,KHWISERO,80,115,193,308
KAKAMEGA,KHWISERO,81,82,87,169
KAKAMEGA,KHWISERO,82,63,112,175
KAKAMEGA,KHWISERO,83,80,85,165
KAKAMEGA,KHWISERO,84,56,78,134
KAKAMEGA,KHWISERO,80-84,396,555,951
KAKAMEGA,KHWISERO,85,57,77,134
KAKAMEGA,KHWISERO,86,41,47,88
KAKAMEGA,KHWISERO,87,46,86,132
KAKAMEGA,KHWISERO,88,35,38,73
KAKAMEGA,KHWISERO,89,28,60,88
KAKAMEGA,KHWISERO,85-89,207,308,515
KAKAMEGA,KHWISERO,90,31,29,60
KAKAMEGA,KHWISERO,91,17,18,35
KAKAMEGA,KHWISERO,92,8,18,26
KAKAMEGA,KHWISERO,93,12,18,30
KAKAMEGA,KHWISERO,94,11,11,22
KAKAMEGA,KHWISERO,90-94,79,94,173
KAKAMEGA,KHWISERO,95,9,19,28
KAKAMEGA,KHWISERO,96,2,10,12
KAKAMEGA,KHWISERO,97,6,4,10
KAKAMEGA,KHWISERO,98,1,4,5
KAKAMEGA,KHWISERO,99,2,11,13
KAKAMEGA,KHWISERO,95-99,20,48,68
KAKAMEGA,KHWISERO,100+,4,14,18
KAKAMEGA,KHWISERO,Not Stated,1,-,1
KAKAMEGA,LIKUYANI,Total,73710,78341,152051
KAKAMEGA,LIKUYANI,0,1698,1663,3361
KAKAMEGA,LIKUYANI,1,1765,1762,3527
KAKAMEGA,LIKUYANI,2,1758,1795,3553
KAKAMEGA,LIKUYANI,3,1931,1937,3868
KAKAMEGA,LIKUYANI,4,2025,1952,3977
KAKAMEGA,LIKUYANI,0 - 4,9177,9109,18286
KAKAMEGA,LIKUYANI,5,2048,1968,4016
KAKAMEGA,LIKUYANI,6,2182,2177,4359
KAKAMEGA,LIKUYANI,7,2200,2034,4234
KAKAMEGA,LIKUYANI,8,2030,2128,4158
KAKAMEGA,LIKUYANI,9,2379,2327,4706
KAKAMEGA,LIKUYANI,05-Sep,10839,10634,21473
KAKAMEGA,LIKUYANI,10,2509,2337,4846
KAKAMEGA,LIKUYANI,11,2206,2306,4512
KAKAMEGA,LIKUYANI,12,2536,2407,4943
KAKAMEGA,LIKUYANI,13,2400,2436,4836
KAKAMEGA,LIKUYANI,14,2380,2361,4741
KAKAMEGA,LIKUYANI,Oct-14,12031,11847,23878
KAKAMEGA,LIKUYANI,15,2120,2214,4334
KAKAMEGA,LIKUYANI,16,2202,2113,4315
KAKAMEGA,LIKUYANI,17,2155,2070,4225
KAKAMEGA,LIKUYANI,18,1800,1572,3372
KAKAMEGA,LIKUYANI,19,1773,1646,3419
KAKAMEGA,LIKUYANI,15-19,10050,9615,19665
KAKAMEGA,LIKUYANI,20,1572,1566,3138
KAKAMEGA,LIKUYANI,21,1297,1317,2614
KAKAMEGA,LIKUYANI,22,1154,1252,2406
KAKAMEGA,LIKUYANI,23,1078,1238,2316
KAKAMEGA,LIKUYANI,24,920,1088,2008
KAKAMEGA,LIKUYANI,20-24,6021,6461,12482
KAKAMEGA,LIKUYANI,25,1024,1139,2163
KAKAMEGA,LIKUYANI,26,840,1005,1845
KAKAMEGA,LIKUYANI,27,797,989,1786
KAKAMEGA,LIKUYANI,28,632,778,1410
KAKAMEGA,LIKUYANI,29,762,927,1689
KAKAMEGA,LIKUYANI,25-29,4055,4838,8893
KAKAMEGA,LIKUYANI,30,912,1188,2100
KAKAMEGA,LIKUYANI,31,738,898,1636
KAKAMEGA,LIKUYANI,32,901,1173,2074
KAKAMEGA,LIKUYANI,33,787,976,1763
KAKAMEGA,LIKUYANI,34,660,802,1462
KAKAMEGA,LIKUYANI,30-34,3998,5037,9035
KAKAMEGA,LIKUYANI,35,814,963,1777
KAKAMEGA,LIKUYANI,36,635,705,1340
KAKAMEGA,LIKUYANI,37,676,687,1363
KAKAMEGA,LIKUYANI,38,558,580,1138
KAKAMEGA,LIKUYANI,39,599,711,1310
KAKAMEGA,LIKUYANI,35-39,3282,3646,6928
KAKAMEGA,LIKUYANI,40,690,886,1576
KAKAMEGA,LIKUYANI,41,694,814,1508
KAKAMEGA,LIKUYANI,42,726,826,1552
KAKAMEGA,LIKUYANI,43,612,789,1401
KAKAMEGA,LIKUYANI,44,506,565,1071
KAKAMEGA,LIKUYANI,40-44,3228,3880,7108
KAKAMEGA,LIKUYANI,45,671,763,1434
KAKAMEGA,LIKUYANI,46,549,577,1126
KAKAMEGA,LIKUYANI,47,575,670,1245
KAKAMEGA,LIKUYANI,48,401,481,882
KAKAMEGA,LIKUYANI,49,528,558,1086
KAKAMEGA,LIKUYANI,45-49,2724,3049,5773
KAKAMEGA,LIKUYANI,50,527,718,1245
KAKAMEGA,LIKUYANI,51,482,533,1015
KAKAMEGA,LIKUYANI,52,420,487,907
KAKAMEGA,LIKUYANI,53,352,417,769
KAKAMEGA,LIKUYANI,54,357,406,763
KAKAMEGA,LIKUYANI,50-54,2138,2561,4699
KAKAMEGA,LIKUYANI,55,374,435,809
KAKAMEGA,LIKUYANI,56,341,463,804
KAKAMEGA,LIKUYANI,57,416,573,989
KAKAMEGA,LIKUYANI,58,312,394,706
KAKAMEGA,LIKUYANI,59,373,444,817
KAKAMEGA,LIKUYANI,55-59,1816,2309,4125
KAKAMEGA,LIKUYANI,60,399,437,836
KAKAMEGA,LIKUYANI,61,321,372,693
KAKAMEGA,LIKUYANI,62,298,335,633
KAKAMEGA,LIKUYANI,63,303,422,725
KAKAMEGA,LIKUYANI,64,212,251,463
KAKAMEGA,LIKUYANI,60-64,1533,1817,3350
KAKAMEGA,LIKUYANI,65,304,354,658
KAKAMEGA,LIKUYANI,66,197,223,420
KAKAMEGA,LIKUYANI,67,292,347,639
KAKAMEGA,LIKUYANI,68,136,157,293
KAKAMEGA,LIKUYANI,69,225,286,511
KAKAMEGA,LIKUYANI,65-69,1154,1367,2521
KAKAMEGA,LIKUYANI,70,220,252,472
KAKAMEGA,LIKUYANI,71,153,192,345
KAKAMEGA,LIKUYANI,72,132,160,292
KAKAMEGA,LIKUYANI,73,135,147,282
KAKAMEGA,LIKUYANI,74,114,158,272
KAKAMEGA,LIKUYANI,70-74,754,909,1663
KAKAMEGA,LIKUYANI,75,83,140,223
KAKAMEGA,LIKUYANI,76,107,143,250
KAKAMEGA,LIKUYANI,77,86,118,204
KAKAMEGA,LIKUYANI,78,58,79,137
KAKAMEGA,LIKUYANI,79,68,78,146
KAKAMEGA,LIKUYANI,75-79,402,558,960
KAKAMEGA,LIKUYANI,80,82,100,182
KAKAMEGA,LIKUYANI,81,46,57,103
KAKAMEGA,LIKUYANI,82,56,77,133
KAKAMEGA,LIKUYANI,83,53,86,139
KAKAMEGA,LIKUYANI,84,33,62,95
KAKAMEGA,LIKUYANI,80-84,270,382,652
KAKAMEGA,LIKUYANI,85,38,44,82
KAKAMEGA,LIKUYANI,86,26,50,76
KAKAMEGA,LIKUYANI,87,44,46,90
KAKAMEGA,LIKUYANI,88,19,26,45
KAKAMEGA,LIKUYANI,89,21,45,66
KAKAMEGA,LIKUYANI,85-89,148,211,359
KAKAMEGA,LIKUYANI,90,17,15,32
KAKAMEGA,LIKUYANI,91,18,16,34
KAKAMEGA,LIKUYANI,92,7,17,24
KAKAMEGA,LIKUYANI,93,3,8,11
KAKAMEGA,LIKUYANI,94,7,4,11
KAKAMEGA,LIKUYANI,90-94,52,60,112
KAKAMEGA,LIKUYANI,95,10,13,23
KAKAMEGA,LIKUYANI,96,6,7,13
KAKAMEGA,LIKUYANI,97,9,9,18
KAKAMEGA,LIKUYANI,98,2,4,6
KAKAMEGA,LIKUYANI,99,6,3,9
KAKAMEGA,LIKUYANI,95-99,33,36,69
KAKAMEGA,LIKUYANI,100+,3,14,17
KAKAMEGA,LIKUYANI,Not Stated,2,1,3
KAKAMEGA,LUGARI,Total,59135,63593,122728
KAKAMEGA,LUGARI,0,1379,1400,2779
KAKAMEGA,LUGARI,1,1408,1447,2855
KAKAMEGA,LUGARI,2,1448,1484,2932
KAKAMEGA,LUGARI,3,1537,1594,3131
KAKAMEGA,LUGARI,4,1599,1596,3195
KAKAMEGA,LUGARI,0 - 4,7371,7521,14892
KAKAMEGA,LUGARI,5,1625,1588,3213
KAKAMEGA,LUGARI,6,1622,1758,3380
KAKAMEGA,LUGARI,7,1791,1686,3477
KAKAMEGA,LUGARI,8,1580,1672,3252
KAKAMEGA,LUGARI,9,2027,1979,4006
KAKAMEGA,LUGARI,05-Sep,8645,8683,17328
KAKAMEGA,LUGARI,10,2014,1948,3962
KAKAMEGA,LUGARI,11,1791,1871,3662
KAKAMEGA,LUGARI,12,1959,2019,3978
KAKAMEGA,LUGARI,13,1903,1902,3805
KAKAMEGA,LUGARI,14,1844,1794,3638
KAKAMEGA,LUGARI,Oct-14,9511,9534,19045
KAKAMEGA,LUGARI,15,1772,1782,3554
KAKAMEGA,LUGARI,16,1745,1689,3434
KAKAMEGA,LUGARI,17,1780,1687,3467
KAKAMEGA,LUGARI,18,1461,1289,2750
KAKAMEGA,LUGARI,19,1470,1333,2803
KAKAMEGA,LUGARI,15-19,8228,7780,16008
KAKAMEGA,LUGARI,20,1135,1159,2294
KAKAMEGA,LUGARI,21,990,1016,2006
KAKAMEGA,LUGARI,22,883,893,1776
KAKAMEGA,LUGARI,23,854,928,1782
KAKAMEGA,LUGARI,24,726,839,1565
KAKAMEGA,LUGARI,20-24,4588,4835,9423
KAKAMEGA,LUGARI,25,795,901,1696
KAKAMEGA,LUGARI,26,582,822,1404
KAKAMEGA,LUGARI,27,677,821,1498
KAKAMEGA,LUGARI,28,490,656,1146
KAKAMEGA,LUGARI,29,554,731,1285
KAKAMEGA,LUGARI,25-29,3098,3931,7029
KAKAMEGA,LUGARI,30,714,946,1660
KAKAMEGA,LUGARI,31,562,772,1334
KAKAMEGA,LUGARI,32,789,956,1745
KAKAMEGA,LUGARI,33,574,765,1339
KAKAMEGA,LUGARI,34,577,664,1241
KAKAMEGA,LUGARI,30-34,3216,4103,7319
KAKAMEGA,LUGARI,35,643,736,1379
KAKAMEGA,LUGARI,36,543,549,1092
KAKAMEGA,LUGARI,37,584,603,1187
KAKAMEGA,LUGARI,38,414,471,885
KAKAMEGA,LUGARI,39,469,507,976
KAKAMEGA,LUGARI,35-39,2653,2866,5519
KAKAMEGA,LUGARI,40,525,607,1132
KAKAMEGA,LUGARI,41,522,616,1138
KAKAMEGA,LUGARI,42,499,692,1191
KAKAMEGA,LUGARI,43,490,591,1081
KAKAMEGA,LUGARI,44,381,477,858
KAKAMEGA,LUGARI,40-44,2417,2983,5400
KAKAMEGA,LUGARI,45,515,672,1187
KAKAMEGA,LUGARI,46,448,578,1026
KAKAMEGA,LUGARI,47,431,494,925
KAKAMEGA,LUGARI,48,337,352,689
KAKAMEGA,LUGARI,49,355,459,814
KAKAMEGA,LUGARI,45-49,2086,2555,4641
KAKAMEGA,LUGARI,50,414,537,951
KAKAMEGA,LUGARI,51,367,493,860
KAKAMEGA,LUGARI,52,324,410,734
KAKAMEGA,LUGARI,53,276,388,664
KAKAMEGA,LUGARI,54,355,392,747
KAKAMEGA,LUGARI,50-54,1736,2220,3956
KAKAMEGA,LUGARI,55,375,422,797
KAKAMEGA,LUGARI,56,361,450,811
KAKAMEGA,LUGARI,57,328,500,828
KAKAMEGA,LUGARI,58,276,335,611
KAKAMEGA,LUGARI,59,324,403,727
KAKAMEGA,LUGARI,55-59,1664,2110,3774
KAKAMEGA,LUGARI,60,365,443,808
KAKAMEGA,LUGARI,61,318,336,654
KAKAMEGA,LUGARI,62,289,292,581
KAKAMEGA,LUGARI,63,261,328,589
KAKAMEGA,LUGARI,64,242,244,486
KAKAMEGA,LUGARI,60-64,1475,1643,3118
KAKAMEGA,LUGARI,65,279,313,592
KAKAMEGA,LUGARI,66,198,210,408
KAKAMEGA,LUGARI,67,256,259,515
KAKAMEGA,LUGARI,68,137,120,257
KAKAMEGA,LUGARI,69,196,168,364
KAKAMEGA,LUGARI,65-69,1066,1070,2136
KAKAMEGA,LUGARI,70,184,197,381
KAKAMEGA,LUGARI,71,140,151,291
KAKAMEGA,LUGARI,72,127,122,249
KAKAMEGA,LUGARI,73,108,106,214
KAKAMEGA,LUGARI,74,80,97,177
KAKAMEGA,LUGARI,70-74,639,673,1312
KAKAMEGA,LUGARI,75,82,107,189
KAKAMEGA,LUGARI,76,70,132,202
KAKAMEGA,LUGARI,77,56,107,163
KAKAMEGA,LUGARI,78,48,44,92
KAKAMEGA,LUGARI,79,44,66,110
KAKAMEGA,LUGARI,75-79,300,456,756
KAKAMEGA,LUGARI,80,57,96,153
KAKAMEGA,LUGARI,81,43,74,117
KAKAMEGA,LUGARI,82,43,59,102
KAKAMEGA,LUGARI,83,48,73,121
KAKAMEGA,LUGARI,84,35,45,80
KAKAMEGA,LUGARI,80-84,226,347,573
KAKAMEGA,LUGARI,85,37,42,79
KAKAMEGA,LUGARI,86,33,42,75
KAKAMEGA,LUGARI,87,32,39,71
KAKAMEGA,LUGARI,88,12,27,39
KAKAMEGA,LUGARI,89,30,26,56
KAKAMEGA,LUGARI,85-89,144,176,320
KAKAMEGA,LUGARI,90,10,20,30
KAKAMEGA,LUGARI,91,12,21,33
KAKAMEGA,LUGARI,92,14,7,21
KAKAMEGA,LUGARI,93,11,11,22
KAKAMEGA,LUGARI,94,6,3,9
KAKAMEGA,LUGARI,90-94,53,62,115
KAKAMEGA,LUGARI,95,8,15,23
KAKAMEGA,LUGARI,96,3,4,7
KAKAMEGA,LUGARI,97,2,10,12
KAKAMEGA,LUGARI,98,2,4,6
KAKAMEGA,LUGARI,99,2,3,5
KAKAMEGA,LUGARI,95-99,17,36,53
KAKAMEGA,LUGARI,100+,2,7,9
KAKAMEGA,LUGARI,Not Stated,-,2,2
KAKAMEGA,MATETE,Total,31749,34423,66172
KAKAMEGA,MATETE,0,744,752,1496
KAKAMEGA,MATETE,1,793,833,1626
KAKAMEGA,MATETE,2,800,851,1651
KAKAMEGA,MATETE,3,900,904,1804
KAKAMEGA,MATETE,4,922,913,1835
KAKAMEGA,MATETE,0 - 4,4159,4253,8412
KAKAMEGA,MATETE,5,987,1000,1987
KAKAMEGA,MATETE,6,1007,1055,2062
KAKAMEGA,MATETE,7,1009,1018,2027
KAKAMEGA,MATETE,8,902,948,1850
KAKAMEGA,MATETE,9,1182,1142,2324
KAKAMEGA,MATETE,05-Sep,5087,5163,10250
KAKAMEGA,MATETE,10,1176,1062,2238
KAKAMEGA,MATETE,11,998,1132,2130
KAKAMEGA,MATETE,12,1082,1085,2167
KAKAMEGA,MATETE,13,1074,1160,2234
KAKAMEGA,MATETE,14,1028,989,2017
KAKAMEGA,MATETE,Oct-14,5358,5428,10786
KAKAMEGA,MATETE,15,1107,1030,2137
KAKAMEGA,MATETE,16,985,937,1922
KAKAMEGA,MATETE,17,986,955,1941
KAKAMEGA,MATETE,18,704,664,1368
KAKAMEGA,MATETE,19,754,778,1532
KAKAMEGA,MATETE,15-19,4536,4364,8900
KAKAMEGA,MATETE,20,622,668,1290
KAKAMEGA,MATETE,21,550,578,1128
KAKAMEGA,MATETE,22,448,488,936
KAKAMEGA,MATETE,23,416,566,982
KAKAMEGA,MATETE,24,314,483,797
KAKAMEGA,MATETE,20-24,2350,2783,5133
KAKAMEGA,MATETE,25,388,533,921
KAKAMEGA,MATETE,26,364,442,806
KAKAMEGA,MATETE,27,338,470,808
KAKAMEGA,MATETE,28,218,353,571
KAKAMEGA,MATETE,29,322,412,734
KAKAMEGA,MATETE,25-29,1630,2210,3840
KAKAMEGA,MATETE,30,361,526,887
KAKAMEGA,MATETE,31,314,433,747
KAKAMEGA,MATETE,32,411,541,952
KAKAMEGA,MATETE,33,336,462,798
KAKAMEGA,MATETE,34,301,332,633
KAKAMEGA,MATETE,30-34,1723,2294,4017
KAKAMEGA,MATETE,35,348,391,739
KAKAMEGA,MATETE,36,230,274,504
KAKAMEGA,MATETE,37,277,252,529
KAKAMEGA,MATETE,38,194,189,383
KAKAMEGA,MATETE,39,255,264,519
KAKAMEGA,MATETE,35-39,1304,1370,2674
KAKAMEGA,MATETE,40,255,309,564
KAKAMEGA,MATETE,41,275,263,538
KAKAMEGA,MATETE,42,273,317,590
KAKAMEGA,MATETE,43,268,312,580
KAKAMEGA,MATETE,44,215,241,456
KAKAMEGA,MATETE,40-44,1286,1442,2728
KAKAMEGA,MATETE,45,272,304,576
KAKAMEGA,MATETE,46,228,240,468
KAKAMEGA,MATETE,47,243,263,506
KAKAMEGA,MATETE,48,134,142,276
KAKAMEGA,MATETE,49,161,177,338
KAKAMEGA,MATETE,45-49,1038,1126,2164
KAKAMEGA,MATETE,50,174,196,370
KAKAMEGA,MATETE,51,187,211,398
KAKAMEGA,MATETE,52,153,166,319
KAKAMEGA,MATETE,53,112,163,275
KAKAMEGA,MATETE,54,120,132,252
KAKAMEGA,MATETE,50-54,746,868,1614
KAKAMEGA,MATETE,55,139,160,299
KAKAMEGA,MATETE,56,121,157,278
KAKAMEGA,MATETE,57,161,226,387
KAKAMEGA,MATETE,58,147,159,306
KAKAMEGA,MATETE,59,182,200,382
KAKAMEGA,MATETE,55-59,750,902,1652
KAKAMEGA,MATETE,60,168,158,326
KAKAMEGA,MATETE,61,120,193,313
KAKAMEGA,MATETE,62,107,126,233
KAKAMEGA,MATETE,63,152,152,304
KAKAMEGA,MATETE,64,106,92,198
KAKAMEGA,MATETE,60-64,653,721,1374
KAKAMEGA,MATETE,65,131,135,266
KAKAMEGA,MATETE,66,73,88,161
KAKAMEGA,MATETE,67,110,119,229
KAKAMEGA,MATETE,68,51,51,102
KAKAMEGA,MATETE,69,80,98,178
KAKAMEGA,MATETE,65-69,445,491,936
KAKAMEGA,MATETE,70,81,107,188
KAKAMEGA,MATETE,71,78,68,146
KAKAMEGA,MATETE,72,55,71,126
KAKAMEGA,MATETE,73,56,71,127
KAKAMEGA,MATETE,74,56,57,113
KAKAMEGA,MATETE,70-74,326,374,700
KAKAMEGA,MATETE,75,51,71,122
KAKAMEGA,MATETE,76,42,65,107
KAKAMEGA,MATETE,77,30,52,82
KAKAMEGA,MATETE,78,23,30,53
KAKAMEGA,MATETE,79,27,53,80
KAKAMEGA,MATETE,75-79,173,271,444
KAKAMEGA,MATETE,80,22,32,54
KAKAMEGA,MATETE,81,31,29,60
KAKAMEGA,MATETE,82,11,23,34
KAKAMEGA,MATETE,83,20,59,79
KAKAMEGA,MATETE,84,15,28,43
KAKAMEGA,MATETE,80-84,99,171,270
KAKAMEGA,MATETE,85,13,34,47
KAKAMEGA,MATETE,86,6,25,31
KAKAMEGA,MATETE,87,16,39,55
KAKAMEGA,MATETE,88,3,11,14
KAKAMEGA,MATETE,89,11,20,31
KAKAMEGA,MATETE,85-89,49,129,178
KAKAMEGA,MATETE,90,11,12,23
KAKAMEGA,MATETE,91,8,6,14
KAKAMEGA,MATETE,92,2,10,12
KAKAMEGA,MATETE,93,6,8,14
KAKAMEGA,MATETE,94,1,2,3
KAKAMEGA,MATETE,90-94,28,38,66
KAKAMEGA,MATETE,95,4,5,9
KAKAMEGA,MATETE,96,1,7,8
KAKAMEGA,MATETE,97,2,3,5
KAKAMEGA,MATETE,98,-,2,2
KAKAMEGA,MATETE,99,1,3,4
KAKAMEGA,MATETE,95-99,8,20,28
KAKAMEGA,MATETE,100+,1,5,6
KAKAMEGA,MATETE,Not Stated,-,-,-
KAKAMEGA,MATUNGU,Total,78793,88143,166936
KAKAMEGA,MATUNGU,0,1939,2008,3947
KAKAMEGA,MATUNGU,1,1974,2052,4026
KAKAMEGA,MATUNGU,2,2082,2255,4337
KAKAMEGA,MATUNGU,3,2257,2372,4629
KAKAMEGA,MATUNGU,4,2342,2416,4758
KAKAMEGA,MATUNGU,0 - 4,10594,11103,21697
KAKAMEGA,MATUNGU,5,2561,2579,5140
KAKAMEGA,MATUNGU,6,2704,2680,5384
KAKAMEGA,MATUNGU,7,2528,2599,5127
KAKAMEGA,MATUNGU,8,2444,2480,4924
KAKAMEGA,MATUNGU,9,2763,2709,5472
KAKAMEGA,MATUNGU,05-Sep,13000,13047,26047
KAKAMEGA,MATUNGU,10,2905,2929,5834
KAKAMEGA,MATUNGU,11,2638,2662,5300
KAKAMEGA,MATUNGU,12,3083,2946,6029
KAKAMEGA,MATUNGU,13,2821,2909,5730
KAKAMEGA,MATUNGU,14,2655,2789,5444
KAKAMEGA,MATUNGU,Oct-14,14102,14235,28337
KAKAMEGA,MATUNGU,15,2589,2698,5287
KAKAMEGA,MATUNGU,16,2276,2395,4671
KAKAMEGA,MATUNGU,17,2415,2351,4766
KAKAMEGA,MATUNGU,18,1884,1792,3676
KAKAMEGA,MATUNGU,19,1806,1869,3675
KAKAMEGA,MATUNGU,15-19,10970,11105,22075
KAKAMEGA,MATUNGU,20,1556,1692,3248
KAKAMEGA,MATUNGU,21,1173,1379,2552
KAKAMEGA,MATUNGU,22,1027,1281,2308
KAKAMEGA,MATUNGU,23,1018,1340,2358
KAKAMEGA,MATUNGU,24,841,1195,2036
KAKAMEGA,MATUNGU,20-24,5615,6887,12502
KAKAMEGA,MATUNGU,25,980,1271,2251
KAKAMEGA,MATUNGU,26,820,1172,1992
KAKAMEGA,MATUNGU,27,838,1169,2007
KAKAMEGA,MATUNGU,28,638,866,1504
KAKAMEGA,MATUNGU,29,667,990,1657
KAKAMEGA,MATUNGU,25-29,3943,5468,9411
KAKAMEGA,MATUNGU,30,913,1359,2272
KAKAMEGA,MATUNGU,31,780,1036,1816
KAKAMEGA,MATUNGU,32,906,1367,2273
KAKAMEGA,MATUNGU,33,777,1118,1895
KAKAMEGA,MATUNGU,34,728,904,1632
KAKAMEGA,MATUNGU,30-34,4104,5784,9888
KAKAMEGA,MATUNGU,35,762,899,1661
KAKAMEGA,MATUNGU,36,634,646,1280
KAKAMEGA,MATUNGU,37,720,676,1396
KAKAMEGA,MATUNGU,38,488,530,1018
KAKAMEGA,MATUNGU,39,563,573,1136
KAKAMEGA,MATUNGU,35-39,3167,3324,6491
KAKAMEGA,MATUNGU,40,729,892,1621
KAKAMEGA,MATUNGU,41,682,830,1512
KAKAMEGA,MATUNGU,42,629,872,1501
KAKAMEGA,MATUNGU,43,580,812,1392
KAKAMEGA,MATUNGU,44,468,596,1064
KAKAMEGA,MATUNGU,40-44,3088,4002,7090
KAKAMEGA,MATUNGU,45,625,771,1396
KAKAMEGA,MATUNGU,46,489,562,1051
KAKAMEGA,MATUNGU,47,548,639,1187
KAKAMEGA,MATUNGU,48,280,355,635
KAKAMEGA,MATUNGU,49,393,466,859
KAKAMEGA,MATUNGU,45-49,2335,2793,5128
KAKAMEGA,MATUNGU,50,558,791,1349
KAKAMEGA,MATUNGU,51,450,634,1084
KAKAMEGA,MATUNGU,52,325,384,709
KAKAMEGA,MATUNGU,53,308,394,702
KAKAMEGA,MATUNGU,54,296,333,629
KAKAMEGA,MATUNGU,50-54,1937,2536,4473
KAKAMEGA,MATUNGU,55,379,418,797
KAKAMEGA,MATUNGU,56,349,411,760
KAKAMEGA,MATUNGU,57,377,602,979
KAKAMEGA,MATUNGU,58,266,333,599
KAKAMEGA,MATUNGU,59,366,480,846
KAKAMEGA,MATUNGU,55-59,1737,2244,3981
KAKAMEGA,MATUNGU,60,366,525,891
KAKAMEGA,MATUNGU,61,316,398,714
KAKAMEGA,MATUNGU,62,220,286,506
KAKAMEGA,MATUNGU,63,307,369,676
KAKAMEGA,MATUNGU,64,187,243,430
KAKAMEGA,MATUNGU,60-64,1396,1821,3217
KAKAMEGA,MATUNGU,65,288,358,646
KAKAMEGA,MATUNGU,66,189,195,384
KAKAMEGA,MATUNGU,67,293,402,695
KAKAMEGA,MATUNGU,68,111,109,220
KAKAMEGA,MATUNGU,69,186,266,452
KAKAMEGA,MATUNGU,65-69,1067,1330,2397
KAKAMEGA,MATUNGU,70,253,364,617
KAKAMEGA,MATUNGU,71,152,186,338
KAKAMEGA,MATUNGU,72,132,147,279
KAKAMEGA,MATUNGU,73,129,170,299
KAKAMEGA,MATUNGU,74,111,148,259
KAKAMEGA,MATUNGU,70-74,777,1015,1792
KAKAMEGA,MATUNGU,75,109,155,264
KAKAMEGA,MATUNGU,76,86,96,182
KAKAMEGA,MATUNGU,77,114,153,267
KAKAMEGA,MATUNGU,78,58,65,123
KAKAMEGA,MATUNGU,79,67,134,201
KAKAMEGA,MATUNGU,75-79,434,603,1037
KAKAMEGA,MATUNGU,80,88,148,236
KAKAMEGA,MATUNGU,81,61,75,136
KAKAMEGA,MATUNGU,82,49,65,114
KAKAMEGA,MATUNGU,83,70,83,153
KAKAMEGA,MATUNGU,84,33,62,95
KAKAMEGA,MATUNGU,80-84,301,433,734
KAKAMEGA,MATUNGU,85,34,72,106
KAKAMEGA,MATUNGU,86,38,49,87
KAKAMEGA,MATUNGU,87,40,81,121
KAKAMEGA,MATUNGU,88,13,21,34
KAKAMEGA,MATUNGU,89,21,66,87
KAKAMEGA,MATUNGU,85-89,146,289,435
KAKAMEGA,MATUNGU,90,18,26,44
KAKAMEGA,MATUNGU,91,12,18,30
KAKAMEGA,MATUNGU,92,9,7,16
KAKAMEGA,MATUNGU,93,14,15,29
KAKAMEGA,MATUNGU,94,2,9,11
KAKAMEGA,MATUNGU,90-94,55,75,130
KAKAMEGA,MATUNGU,95,10,16,26
KAKAMEGA,MATUNGU,96,3,4,7
KAKAMEGA,MATUNGU,97,6,13,19
KAKAMEGA,MATUNGU,98,2,2,4
KAKAMEGA,MATUNGU,99,1,4,5
KAKAMEGA,MATUNGU,95-99,22,39,61
KAKAMEGA,MATUNGU,100+,1,9,10
KAKAMEGA,MATUNGU,Not Stated,2,1,3
KAKAMEGA,MUMIAS EAST,Total,55895,60953,116848
KAKAMEGA,MUMIAS EAST,0,1314,1372,2686
KAKAMEGA,MUMIAS EAST,1,1346,1402,2748
KAKAMEGA,MUMIAS EAST,2,1422,1388,2810
KAKAMEGA,MUMIAS EAST,3,1465,1490,2955
KAKAMEGA,MUMIAS EAST,4,1663,1607,3270
KAKAMEGA,MUMIAS EAST,0 - 4,7210,7259,14469
KAKAMEGA,MUMIAS EAST,5,1698,1710,3408
KAKAMEGA,MUMIAS EAST,6,1783,1738,3521
KAKAMEGA,MUMIAS EAST,7,1728,1723,3451
KAKAMEGA,MUMIAS EAST,8,1621,1692,3313
KAKAMEGA,MUMIAS EAST,9,1893,1832,3725
KAKAMEGA,MUMIAS EAST,05-Sep,8723,8695,17418
KAKAMEGA,MUMIAS EAST,10,1967,1957,3924
KAKAMEGA,MUMIAS EAST,11,1783,1848,3631
KAKAMEGA,MUMIAS EAST,12,2075,1999,4074
KAKAMEGA,MUMIAS EAST,13,1913,1954,3867
KAKAMEGA,MUMIAS EAST,14,1830,1862,3692
KAKAMEGA,MUMIAS EAST,Oct-14,9568,9620,19188
KAKAMEGA,MUMIAS EAST,15,1776,1856,3632
KAKAMEGA,MUMIAS EAST,16,1629,1598,3227
KAKAMEGA,MUMIAS EAST,17,1644,1602,3246
KAKAMEGA,MUMIAS EAST,18,1272,1239,2511
KAKAMEGA,MUMIAS EAST,19,1331,1345,2676
KAKAMEGA,MUMIAS EAST,15-19,7652,7640,15292
KAKAMEGA,MUMIAS EAST,20,1113,1222,2335
KAKAMEGA,MUMIAS EAST,21,941,1085,2026
KAKAMEGA,MUMIAS EAST,22,818,908,1726
KAKAMEGA,MUMIAS EAST,23,841,941,1782
KAKAMEGA,MUMIAS EAST,24,684,856,1540
KAKAMEGA,MUMIAS EAST,20-24,4397,5012,9409
KAKAMEGA,MUMIAS EAST,25,801,896,1697
KAKAMEGA,MUMIAS EAST,26,596,904,1500
KAKAMEGA,MUMIAS EAST,27,633,875,1508
KAKAMEGA,MUMIAS EAST,28,565,716,1281
KAKAMEGA,MUMIAS EAST,29,583,804,1387
KAKAMEGA,MUMIAS EAST,25-29,3178,4195,7373
KAKAMEGA,MUMIAS EAST,30,708,1079,1787
KAKAMEGA,MUMIAS EAST,31,565,780,1345
KAKAMEGA,MUMIAS EAST,32,675,1000,1675
KAKAMEGA,MUMIAS EAST,33,617,902,1519
KAKAMEGA,MUMIAS EAST,34,540,752,1292
KAKAMEGA,MUMIAS EAST,30-34,3105,4513,7618
KAKAMEGA,MUMIAS EAST,35,685,726,1411
KAKAMEGA,MUMIAS EAST,36,551,547,1098
KAKAMEGA,MUMIAS EAST,37,539,541,1080
KAKAMEGA,MUMIAS EAST,38,418,401,819
KAKAMEGA,MUMIAS EAST,39,528,400,928
KAKAMEGA,MUMIAS EAST,35-39,2721,2615,5336
KAKAMEGA,MUMIAS EAST,40,521,509,1030
KAKAMEGA,MUMIAS EAST,41,525,511,1036
KAKAMEGA,MUMIAS EAST,42,457,471,928
KAKAMEGA,MUMIAS EAST,43,430,470,900
KAKAMEGA,MUMIAS EAST,44,364,384,748
KAKAMEGA,MUMIAS EAST,40-44,2297,2345,4642
KAKAMEGA,MUMIAS EAST,45,440,463,903
KAKAMEGA,MUMIAS EAST,46,351,421,772
KAKAMEGA,MUMIAS EAST,47,421,375,796
KAKAMEGA,MUMIAS EAST,48,241,273,514
KAKAMEGA,MUMIAS EAST,49,319,326,645
KAKAMEGA,MUMIAS EAST,45-49,1772,1858,3630
KAKAMEGA,MUMIAS EAST,50,339,526,865
KAKAMEGA,MUMIAS EAST,51,321,422,743
KAKAMEGA,MUMIAS EAST,52,235,261,496
KAKAMEGA,MUMIAS EAST,53,224,266,490
KAKAMEGA,MUMIAS EAST,54,204,267,471
KAKAMEGA,MUMIAS EAST,50-54,1323,1742,3065
KAKAMEGA,MUMIAS EAST,55,248,297,545
KAKAMEGA,MUMIAS EAST,56,252,316,568
KAKAMEGA,MUMIAS EAST,57,279,401,680
KAKAMEGA,MUMIAS EAST,58,154,234,388
KAKAMEGA,MUMIAS EAST,59,220,295,515
KAKAMEGA,MUMIAS EAST,55-59,1153,1543,2696
KAKAMEGA,MUMIAS EAST,60,232,326,558
KAKAMEGA,MUMIAS EAST,61,198,341,539
KAKAMEGA,MUMIAS EAST,62,161,214,375
KAKAMEGA,MUMIAS EAST,63,185,266,451
KAKAMEGA,MUMIAS EAST,64,152,199,351
KAKAMEGA,MUMIAS EAST,60-64,928,1346,2274
KAKAMEGA,MUMIAS EAST,65,174,243,417
KAKAMEGA,MUMIAS EAST,66,143,171,314
KAKAMEGA,MUMIAS EAST,67,199,269,468
KAKAMEGA,MUMIAS EAST,68,86,92,178
KAKAMEGA,MUMIAS EAST,69,148,170,318
KAKAMEGA,MUMIAS EAST,65-69,750,945,1695
KAKAMEGA,MUMIAS EAST,70,170,226,396
KAKAMEGA,MUMIAS EAST,71,106,143,249
KAKAMEGA,MUMIAS EAST,72,77,103,180
KAKAMEGA,MUMIAS EAST,73,81,107,188
KAKAMEGA,MUMIAS EAST,74,58,88,146
KAKAMEGA,MUMIAS EAST,70-74,492,667,1159
KAKAMEGA,MUMIAS EAST,75,66,100,166
KAKAMEGA,MUMIAS EAST,76,43,103,146
KAKAMEGA,MUMIAS EAST,77,60,90,150
KAKAMEGA,MUMIAS EAST,78,27,52,79
KAKAMEGA,MUMIAS EAST,79,40,64,104
KAKAMEGA,MUMIAS EAST,75-79,236,409,645
KAKAMEGA,MUMIAS EAST,80,46,71,117
KAKAMEGA,MUMIAS EAST,81,42,64,106
KAKAMEGA,MUMIAS EAST,82,43,45,88
KAKAMEGA,MUMIAS EAST,83,38,57,95
KAKAMEGA,MUMIAS EAST,84,37,28,65
KAKAMEGA,MUMIAS EAST,80-84,206,265,471
KAKAMEGA,MUMIAS EAST,85,34,41,75
KAKAMEGA,MUMIAS EAST,86,14,41,55
KAKAMEGA,MUMIAS EAST,87,28,64,92
KAKAMEGA,MUMIAS EAST,88,13,15,28
KAKAMEGA,MUMIAS EAST,89,25,47,72
KAKAMEGA,MUMIAS EAST,85-89,114,208,322
KAKAMEGA,MUMIAS EAST,90,12,13,25
KAKAMEGA,MUMIAS EAST,91,19,10,29
KAKAMEGA,MUMIAS EAST,92,7,6,13
KAKAMEGA,MUMIAS EAST,93,6,6,12
KAKAMEGA,MUMIAS EAST,94,2,10,12
KAKAMEGA,MUMIAS EAST,90-94,46,45,91
KAKAMEGA,MUMIAS EAST,95,6,7,13
KAKAMEGA,MUMIAS EAST,96,4,2,6
KAKAMEGA,MUMIAS EAST,97,4,11,15
KAKAMEGA,MUMIAS EAST,98,4,3,7
KAKAMEGA,MUMIAS EAST,99,-,5,5
KAKAMEGA,MUMIAS EAST,95-99,18,28,46
KAKAMEGA,MUMIAS EAST,100+,6,3,9
KAKAMEGA,MUMIAS EAST,Not Stated,-,-,-
KAKAMEGA,MUMIAS WEST,Total,54915,60438,115353
KAKAMEGA,MUMIAS WEST,0,1340,1385,2725
KAKAMEGA,MUMIAS WEST,1,1320,1383,2703
KAKAMEGA,MUMIAS WEST,2,1383,1348,2731
KAKAMEGA,MUMIAS WEST,3,1516,1508,3024
KAKAMEGA,MUMIAS WEST,4,1567,1502,3069
KAKAMEGA,MUMIAS WEST,0 - 4,7126,7126,14252
KAKAMEGA,MUMIAS WEST,5,1640,1576,3216
KAKAMEGA,MUMIAS WEST,6,1659,1707,3366
KAKAMEGA,MUMIAS WEST,7,1679,1659,3338
KAKAMEGA,MUMIAS WEST,8,1550,1627,3177
KAKAMEGA,MUMIAS WEST,9,1792,1724,3516
KAKAMEGA,MUMIAS WEST,05-Sep,8320,8293,16613
KAKAMEGA,MUMIAS WEST,10,1807,1849,3656
KAKAMEGA,MUMIAS WEST,11,1733,1745,3478
KAKAMEGA,MUMIAS WEST,12,1917,1953,3870
KAKAMEGA,MUMIAS WEST,13,1892,1999,3891
KAKAMEGA,MUMIAS WEST,14,1657,1742,3399
KAKAMEGA,MUMIAS WEST,Oct-14,9006,9288,18294
KAKAMEGA,MUMIAS WEST,15,1731,1705,3436
KAKAMEGA,MUMIAS WEST,16,1548,1648,3196
KAKAMEGA,MUMIAS WEST,17,1571,1569,3140
KAKAMEGA,MUMIAS WEST,18,1326,1301,2627
KAKAMEGA,MUMIAS WEST,19,1311,1336,2647
KAKAMEGA,MUMIAS WEST,15-19,7487,7559,15046
KAKAMEGA,MUMIAS WEST,20,1069,1163,2232
KAKAMEGA,MUMIAS WEST,21,837,947,1784
KAKAMEGA,MUMIAS WEST,22,821,843,1664
KAKAMEGA,MUMIAS WEST,23,791,1023,1814
KAKAMEGA,MUMIAS WEST,24,657,883,1540
KAKAMEGA,MUMIAS WEST,20-24,4175,4859,9034
KAKAMEGA,MUMIAS WEST,25,773,933,1706
KAKAMEGA,MUMIAS WEST,26,581,839,1420
KAKAMEGA,MUMIAS WEST,27,607,870,1477
KAKAMEGA,MUMIAS WEST,28,517,709,1226
KAKAMEGA,MUMIAS WEST,29,525,799,1324
KAKAMEGA,MUMIAS WEST,25-29,3003,4150,7153
KAKAMEGA,MUMIAS WEST,30,710,1043,1753
KAKAMEGA,MUMIAS WEST,31,591,719,1310
KAKAMEGA,MUMIAS WEST,32,692,930,1622
KAKAMEGA,MUMIAS WEST,33,580,885,1465
KAKAMEGA,MUMIAS WEST,34,553,685,1238
KAKAMEGA,MUMIAS WEST,30-34,3126,4262,7388
KAKAMEGA,MUMIAS WEST,35,636,785,1421
KAKAMEGA,MUMIAS WEST,36,512,594,1106
KAKAMEGA,MUMIAS WEST,37,581,543,1124
KAKAMEGA,MUMIAS WEST,38,409,438,847
KAKAMEGA,MUMIAS WEST,39,468,501,969
KAKAMEGA,MUMIAS WEST,35-39,2606,2861,5467
KAKAMEGA,MUMIAS WEST,40,526,603,1129
KAKAMEGA,MUMIAS WEST,41,466,506,972
KAKAMEGA,MUMIAS WEST,42,472,518,990
KAKAMEGA,MUMIAS WEST,43,445,500,945
KAKAMEGA,MUMIAS WEST,44,361,371,732
KAKAMEGA,MUMIAS WEST,40-44,2270,2498,4768
KAKAMEGA,MUMIAS WEST,45,511,578,1089
KAKAMEGA,MUMIAS WEST,46,388,449,837
KAKAMEGA,MUMIAS WEST,47,393,473,866
KAKAMEGA,MUMIAS WEST,48,287,312,599
KAKAMEGA,MUMIAS WEST,49,333,318,651
KAKAMEGA,MUMIAS WEST,45-49,1912,2130,4042
KAKAMEGA,MUMIAS WEST,50,405,527,932
KAKAMEGA,MUMIAS WEST,51,358,422,780
KAKAMEGA,MUMIAS WEST,52,244,294,538
KAKAMEGA,MUMIAS WEST,53,237,274,511
KAKAMEGA,MUMIAS WEST,54,242,290,532
KAKAMEGA,MUMIAS WEST,50-54,1486,1807,3293
KAKAMEGA,MUMIAS WEST,55,289,284,573
KAKAMEGA,MUMIAS WEST,56,267,289,556
KAKAMEGA,MUMIAS WEST,57,277,403,680
KAKAMEGA,MUMIAS WEST,58,188,209,397
KAKAMEGA,MUMIAS WEST,59,270,336,606
KAKAMEGA,MUMIAS WEST,55-59,1291,1521,2812
KAKAMEGA,MUMIAS WEST,60,223,326,549
KAKAMEGA,MUMIAS WEST,61,248,285,533
KAKAMEGA,MUMIAS WEST,62,178,212,390
KAKAMEGA,MUMIAS WEST,63,209,269,478
KAKAMEGA,MUMIAS WEST,64,168,190,358
KAKAMEGA,MUMIAS WEST,60-64,1026,1282,2308
KAKAMEGA,MUMIAS WEST,65,217,262,479
KAKAMEGA,MUMIAS WEST,66,149,181,330
KAKAMEGA,MUMIAS WEST,67,234,317,551
KAKAMEGA,MUMIAS WEST,68,95,92,187
KAKAMEGA,MUMIAS WEST,69,137,212,349
KAKAMEGA,MUMIAS WEST,65-69,832,1064,1896
KAKAMEGA,MUMIAS WEST,70,167,245,412
KAKAMEGA,MUMIAS WEST,71,113,152,265
KAKAMEGA,MUMIAS WEST,72,74,113,187
KAKAMEGA,MUMIAS WEST,73,109,109,218
KAKAMEGA,MUMIAS WEST,74,88,93,181
KAKAMEGA,MUMIAS WEST,70-74,551,712,1263
KAKAMEGA,MUMIAS WEST,75,77,83,160
KAKAMEGA,MUMIAS WEST,76,65,89,154
KAKAMEGA,MUMIAS WEST,77,79,126,205
KAKAMEGA,MUMIAS WEST,78,29,51,80
KAKAMEGA,MUMIAS WEST,79,59,89,148
KAKAMEGA,MUMIAS WEST,75-79,309,438,747
KAKAMEGA,MUMIAS WEST,80,66,98,164
KAKAMEGA,MUMIAS WEST,81,50,66,116
KAKAMEGA,MUMIAS WEST,82,30,51,81
KAKAMEGA,MUMIAS WEST,83,41,58,99
KAKAMEGA,MUMIAS WEST,84,23,42,65
KAKAMEGA,MUMIAS WEST,80-84,210,315,525
KAKAMEGA,MUMIAS WEST,85,37,53,90
KAKAMEGA,MUMIAS WEST,86,19,30,49
KAKAMEGA,MUMIAS WEST,87,42,42,84
KAKAMEGA,MUMIAS WEST,88,16,17,33
KAKAMEGA,MUMIAS WEST,89,15,37,52
KAKAMEGA,MUMIAS WEST,85-89,129,179,308
KAKAMEGA,MUMIAS WEST,90,7,16,23
KAKAMEGA,MUMIAS WEST,91,11,13,24
KAKAMEGA,MUMIAS WEST,92,10,11,21
KAKAMEGA,MUMIAS WEST,93,6,5,11
KAKAMEGA,MUMIAS WEST,94,-,9,9
KAKAMEGA,MUMIAS WEST,90-94,34,54,88
KAKAMEGA,MUMIAS WEST,95,3,16,19
KAKAMEGA,MUMIAS WEST,96,2,8,10
KAKAMEGA,MUMIAS WEST,97,5,2,7
KAKAMEGA,MUMIAS WEST,98,1,2,3
KAKAMEGA,MUMIAS WEST,99,1,6,7
KAKAMEGA,MUMIAS WEST,95-99,12,34,46
KAKAMEGA,MUMIAS WEST,100+,1,4,5
KAKAMEGA,MUMIAS WEST,Not Stated,3,2,5
KAKAMEGA,NAVAKHOLO,Total,73275,80695,153970
KAKAMEGA,NAVAKHOLO,0,1842,1787,3629
KAKAMEGA,NAVAKHOLO,1,1824,1817,3641
KAKAMEGA,NAVAKHOLO,2,1941,1921,3862
KAKAMEGA,NAVAKHOLO,3,2022,2109,4131
KAKAMEGA,NAVAKHOLO,4,2239,2211,4450
KAKAMEGA,NAVAKHOLO,0 - 4,9868,9845,19713
KAKAMEGA,NAVAKHOLO,5,2427,2474,4901
KAKAMEGA,NAVAKHOLO,6,2475,2566,5041
KAKAMEGA,NAVAKHOLO,7,2405,2358,4763
KAKAMEGA,NAVAKHOLO,8,2301,2383,4684
KAKAMEGA,NAVAKHOLO,9,2576,2686,5262
KAKAMEGA,NAVAKHOLO,05-Sep,12184,12467,24651
KAKAMEGA,NAVAKHOLO,10,2664,2591,5255
KAKAMEGA,NAVAKHOLO,11,2440,2505,4945
KAKAMEGA,NAVAKHOLO,12,2715,2701,5416
KAKAMEGA,NAVAKHOLO,13,2648,2750,5398
KAKAMEGA,NAVAKHOLO,14,2525,2441,4966
KAKAMEGA,NAVAKHOLO,Oct-14,12992,12988,25980
KAKAMEGA,NAVAKHOLO,15,2379,2494,4873
KAKAMEGA,NAVAKHOLO,16,2203,2241,4444
KAKAMEGA,NAVAKHOLO,17,2162,2152,4314
KAKAMEGA,NAVAKHOLO,18,1682,1590,3272
KAKAMEGA,NAVAKHOLO,19,1720,1711,3431
KAKAMEGA,NAVAKHOLO,15-19,10146,10188,20334
KAKAMEGA,NAVAKHOLO,20,1436,1614,3050
KAKAMEGA,NAVAKHOLO,21,1151,1280,2431
KAKAMEGA,NAVAKHOLO,22,987,1144,2131
KAKAMEGA,NAVAKHOLO,23,968,1256,2224
KAKAMEGA,NAVAKHOLO,24,823,1107,1930
KAKAMEGA,NAVAKHOLO,20-24,5365,6401,11766
KAKAMEGA,NAVAKHOLO,25,876,1158,2034
KAKAMEGA,NAVAKHOLO,26,745,1095,1840
KAKAMEGA,NAVAKHOLO,27,810,1103,1913
KAKAMEGA,NAVAKHOLO,28,543,864,1407
KAKAMEGA,NAVAKHOLO,29,653,979,1632
KAKAMEGA,NAVAKHOLO,25-29,3627,5199,8826
KAKAMEGA,NAVAKHOLO,30,814,1278,2092
KAKAMEGA,NAVAKHOLO,31,698,1034,1732
KAKAMEGA,NAVAKHOLO,32,818,1189,2007
KAKAMEGA,NAVAKHOLO,33,731,1059,1790
KAKAMEGA,NAVAKHOLO,34,643,805,1448
KAKAMEGA,NAVAKHOLO,30-34,3704,5365,9069
KAKAMEGA,NAVAKHOLO,35,713,879,1592
KAKAMEGA,NAVAKHOLO,36,617,615,1232
KAKAMEGA,NAVAKHOLO,37,659,624,1283
KAKAMEGA,NAVAKHOLO,38,469,442,911
KAKAMEGA,NAVAKHOLO,39,540,542,1082
KAKAMEGA,NAVAKHOLO,35-39,2998,3102,6100
KAKAMEGA,NAVAKHOLO,40,631,661,1292
KAKAMEGA,NAVAKHOLO,41,563,675,1238
KAKAMEGA,NAVAKHOLO,42,592,673,1265
KAKAMEGA,NAVAKHOLO,43,565,718,1283
KAKAMEGA,NAVAKHOLO,44,439,580,1019
KAKAMEGA,NAVAKHOLO,40-44,2790,3307,6097
KAKAMEGA,NAVAKHOLO,45,616,768,1384
KAKAMEGA,NAVAKHOLO,46,430,514,944
KAKAMEGA,NAVAKHOLO,47,502,537,1039
KAKAMEGA,NAVAKHOLO,48,301,317,618
KAKAMEGA,NAVAKHOLO,49,358,423,781
KAKAMEGA,NAVAKHOLO,45-49,2207,2559,4766
KAKAMEGA,NAVAKHOLO,50,434,499,933
KAKAMEGA,NAVAKHOLO,51,377,534,911
KAKAMEGA,NAVAKHOLO,52,294,335,629
KAKAMEGA,NAVAKHOLO,53,266,363,629
KAKAMEGA,NAVAKHOLO,54,315,311,626
KAKAMEGA,NAVAKHOLO,50-54,1686,2042,3728
KAKAMEGA,NAVAKHOLO,55,307,368,675
KAKAMEGA,NAVAKHOLO,56,352,419,771
KAKAMEGA,NAVAKHOLO,57,361,520,881
KAKAMEGA,NAVAKHOLO,58,231,272,503
KAKAMEGA,NAVAKHOLO,59,353,419,772
KAKAMEGA,NAVAKHOLO,55-59,1604,1998,3602
KAKAMEGA,NAVAKHOLO,60,323,428,751
KAKAMEGA,NAVAKHOLO,61,343,352,695
KAKAMEGA,NAVAKHOLO,62,265,287,552
KAKAMEGA,NAVAKHOLO,63,288,341,629
KAKAMEGA,NAVAKHOLO,64,223,267,490
KAKAMEGA,NAVAKHOLO,60-64,1442,1675,3117
KAKAMEGA,NAVAKHOLO,65,307,366,673
KAKAMEGA,NAVAKHOLO,66,147,208,355
KAKAMEGA,NAVAKHOLO,67,238,349,587
KAKAMEGA,NAVAKHOLO,68,99,137,236
KAKAMEGA,NAVAKHOLO,69,191,238,429
KAKAMEGA,NAVAKHOLO,65-69,982,1298,2280
KAKAMEGA,NAVAKHOLO,70,200,264,464
KAKAMEGA,NAVAKHOLO,71,164,194,358
KAKAMEGA,NAVAKHOLO,72,137,126,263
KAKAMEGA,NAVAKHOLO,73,131,138,269
KAKAMEGA,NAVAKHOLO,74,123,150,273
KAKAMEGA,NAVAKHOLO,70-74,755,872,1627
KAKAMEGA,NAVAKHOLO,75,93,147,240
KAKAMEGA,NAVAKHOLO,76,113,160,273
KAKAMEGA,NAVAKHOLO,77,93,163,256
KAKAMEGA,NAVAKHOLO,78,45,59,104
KAKAMEGA,NAVAKHOLO,79,72,107,179
KAKAMEGA,NAVAKHOLO,75-79,416,636,1052
KAKAMEGA,NAVAKHOLO,80,63,99,162
KAKAMEGA,NAVAKHOLO,81,52,80,132
KAKAMEGA,NAVAKHOLO,82,39,50,89
KAKAMEGA,NAVAKHOLO,83,85,93,178
KAKAMEGA,NAVAKHOLO,84,36,55,91
KAKAMEGA,NAVAKHOLO,80-84,275,377,652
KAKAMEGA,NAVAKHOLO,85,38,57,95
KAKAMEGA,NAVAKHOLO,86,39,34,73
KAKAMEGA,NAVAKHOLO,87,41,82,123
KAKAMEGA,NAVAKHOLO,88,13,24,37
KAKAMEGA,NAVAKHOLO,89,25,52,77
KAKAMEGA,NAVAKHOLO,85-89,156,249,405
KAKAMEGA,NAVAKHOLO,90,10,17,27
KAKAMEGA,NAVAKHOLO,91,14,16,30
KAKAMEGA,NAVAKHOLO,92,8,16,24
KAKAMEGA,NAVAKHOLO,93,13,14,27
KAKAMEGA,NAVAKHOLO,94,5,13,18
KAKAMEGA,NAVAKHOLO,90-94,50,76,126
KAKAMEGA,NAVAKHOLO,95,10,11,21
KAKAMEGA,NAVAKHOLO,96,2,9,11
KAKAMEGA,NAVAKHOLO,97,6,8,14
KAKAMEGA,NAVAKHOLO,98,3,4,7
KAKAMEGA,NAVAKHOLO,99,2,6,8
KAKAMEGA,NAVAKHOLO,95-99,23,38,61
KAKAMEGA,NAVAKHOLO,100+,5,11,16
KAKAMEGA,NAVAKHOLO,Not Stated,-,2,2
KERICHO,ALL,Total,450741,451008,901749
KERICHO,ALL,0,10058,9876,19934
KERICHO,ALL,1,10667,10527,21194
KERICHO,ALL,2,11093,10753,21846
KERICHO,ALL,3,11667,11610,23277
KERICHO,ALL,4,11852,11455,23307
KERICHO,ALL,0 - 4,55337,54221,109558
KERICHO,ALL,5,11696,11512,23208
KERICHO,ALL,6,11742,11562,23304
KERICHO,ALL,7,12075,11718,23793
KERICHO,ALL,8,11223,10990,22213
KERICHO,ALL,9,12965,12742,25707
KERICHO,ALL,05-Sep,59701,58524,118225
KERICHO,ALL,10,12579,12315,24894
KERICHO,ALL,11,12047,11999,24046
KERICHO,ALL,12,13808,13224,27032
KERICHO,ALL,13,12694,13213,25907
KERICHO,ALL,14,12562,12576,25138
KERICHO,ALL,Oct-14,63690,63327,127017
KERICHO,ALL,15,12405,12128,24533
KERICHO,ALL,16,11191,10992,22183
KERICHO,ALL,17,11150,10678,21828
KERICHO,ALL,18,8930,8694,17624
KERICHO,ALL,19,10680,10342,21022
KERICHO,ALL,15-19,54356,52834,107190
KERICHO,ALL,20,8505,9269,17774
KERICHO,ALL,21,8726,9366,18092
KERICHO,ALL,22,7874,8623,16497
KERICHO,ALL,23,8277,9422,17699
KERICHO,ALL,24,7477,8038,15515
KERICHO,ALL,20-24,40859,44718,85577
KERICHO,ALL,25,8351,8891,17242
KERICHO,ALL,26,6954,7699,14653
KERICHO,ALL,27,7608,8184,15792
KERICHO,ALL,28,5671,6185,11856
KERICHO,ALL,29,6616,7206,13822
KERICHO,ALL,25-29,35200,38165,73365
KERICHO,ALL,30,7781,8831,16612
KERICHO,ALL,31,6156,6812,12968
KERICHO,ALL,32,7315,8212,15527
KERICHO,ALL,33,6341,7086,13427
KERICHO,ALL,34,5621,5955,11576
KERICHO,ALL,30-34,33214,36896,70110
KERICHO,ALL,35,7243,6405,13648
KERICHO,ALL,36,4752,3661,8413
KERICHO,ALL,37,5138,3903,9041
KERICHO,ALL,38,3243,2561,5804
KERICHO,ALL,39,4476,3543,8019
KERICHO,ALL,35-39,24852,20073,44925
KERICHO,ALL,40,4918,4089,9007
KERICHO,ALL,41,5814,4869,10683
KERICHO,ALL,42,4351,3746,8097
KERICHO,ALL,43,3548,3605,7153
KERICHO,ALL,44,2796,2761,5557
KERICHO,ALL,40-44,21427,19070,40497
KERICHO,ALL,45,6068,4946,11014
KERICHO,ALL,46,3351,3301,6652
KERICHO,ALL,47,3746,3749,7495
KERICHO,ALL,48,2082,1949,4031
KERICHO,ALL,49,2770,2709,5479
KERICHO,ALL,45-49,18017,16654,34671
KERICHO,ALL,50,3022,3169,6191
KERICHO,ALL,51,2744,2674,5418
KERICHO,ALL,52,1889,1746,3635
KERICHO,ALL,53,1462,1276,2738
KERICHO,ALL,54,1602,1487,3089
KERICHO,ALL,50-54,10719,10352,21071
KERICHO,ALL,55,1663,1536,3199
KERICHO,ALL,56,1644,1744,3388
KERICHO,ALL,57,1953,2238,4191
KERICHO,ALL,58,2629,3185,5814
KERICHO,ALL,59,2111,2008,4119
KERICHO,ALL,55-59,10000,10711,20711
KERICHO,ALL,60,2193,2373,4566
KERICHO,ALL,61,1770,1764,3534
KERICHO,ALL,62,1373,1364,2737
KERICHO,ALL,63,1395,1438,2833
KERICHO,ALL,64,963,1104,2067
KERICHO,ALL,60-64,7694,8043,15737
KERICHO,ALL,65,1733,1774,3507
KERICHO,ALL,66,999,821,1820
KERICHO,ALL,67,1610,1562,3172
KERICHO,ALL,68,659,663,1322
KERICHO,ALL,69,1077,1065,2142
KERICHO,ALL,65-69,6078,5885,11963
KERICHO,ALL,70,1369,1618,2987
KERICHO,ALL,71,1264,929,2193
KERICHO,ALL,72,832,561,1393
KERICHO,ALL,73,649,607,1256
KERICHO,ALL,74,642,686,1328
KERICHO,ALL,70-74,4756,4401,9157
KERICHO,ALL,75,478,633,1111
KERICHO,ALL,76,367,397,764
KERICHO,ALL,77,538,498,1036
KERICHO,ALL,78,266,285,551
KERICHO,ALL,79,394,704,1098
KERICHO,ALL,75-79,2043,2517,4560
KERICHO,ALL,80,406,785,1191
KERICHO,ALL,81,246,423,669
KERICHO,ALL,82,233,243,476
KERICHO,ALL,83,243,310,553
KERICHO,ALL,84,235,404,639
KERICHO,ALL,80-84,1363,2165,3528
KERICHO,ALL,85,212,311,523
KERICHO,ALL,86,151,154,305
KERICHO,ALL,87,178,206,384
KERICHO,ALL,88,109,135,244
KERICHO,ALL,89,184,499,683
KERICHO,ALL,85-89,834,1305,2139
KERICHO,ALL,90,119,239,358
KERICHO,ALL,91,54,118,172
KERICHO,ALL,92,45,70,115
KERICHO,ALL,93,47,66,113
KERICHO,ALL,94,50,120,170
KERICHO,ALL,90-94,315,613,928
KERICHO,ALL,95,94,133,227
KERICHO,ALL,96,30,50,80
KERICHO,ALL,97,36,53,89
KERICHO,ALL,98,18,45,63
KERICHO,ALL,99,34,98,132
KERICHO,ALL,95-99,212,379,591
KERICHO,ALL,100+,64,152,216
KERICHO,ALL,Not Stated,10,3,13
KERICHO,BELGUT,Total,72508,72564,145072
KERICHO,BELGUT,0,1376,1414,2790
KERICHO,BELGUT,1,1519,1531,3050
KERICHO,BELGUT,2,1570,1533,3103
KERICHO,BELGUT,3,1736,1653,3389
KERICHO,BELGUT,4,1729,1640,3369
KERICHO,BELGUT,0 - 4,7930,7771,15701
KERICHO,BELGUT,5,1674,1682,3356
KERICHO,BELGUT,6,1705,1702,3407
KERICHO,BELGUT,7,1759,1742,3501
KERICHO,BELGUT,8,1622,1725,3347
KERICHO,BELGUT,9,1975,1871,3846
KERICHO,BELGUT,05-Sep,8735,8722,17457
KERICHO,BELGUT,10,1976,1935,3911
KERICHO,BELGUT,11,1859,1905,3764
KERICHO,BELGUT,12,2194,2050,4244
KERICHO,BELGUT,13,1957,2100,4057
KERICHO,BELGUT,14,2043,2064,4107
KERICHO,BELGUT,Oct-14,10029,10054,20083
KERICHO,BELGUT,15,2017,1964,3981
KERICHO,BELGUT,16,1811,1784,3595
KERICHO,BELGUT,17,1780,1796,3576
KERICHO,BELGUT,18,1370,1432,2802
KERICHO,BELGUT,19,1649,1582,3231
KERICHO,BELGUT,15-19,8627,8558,17185
KERICHO,BELGUT,20,1329,1435,2764
KERICHO,BELGUT,21,1343,1473,2816
KERICHO,BELGUT,22,1253,1352,2605
KERICHO,BELGUT,23,1291,1470,2761
KERICHO,BELGUT,24,1162,1274,2436
KERICHO,BELGUT,20-24,6378,7004,13382
KERICHO,BELGUT,25,1349,1432,2781
KERICHO,BELGUT,26,1108,1208,2316
KERICHO,BELGUT,27,1163,1261,2424
KERICHO,BELGUT,28,887,1044,1931
KERICHO,BELGUT,29,1154,1169,2323
KERICHO,BELGUT,25-29,5661,6114,11775
KERICHO,BELGUT,30,1295,1544,2839
KERICHO,BELGUT,31,1117,1198,2315
KERICHO,BELGUT,32,1275,1481,2756
KERICHO,BELGUT,33,1088,1237,2325
KERICHO,BELGUT,34,956,1077,2033
KERICHO,BELGUT,30-34,5731,6537,12268
KERICHO,BELGUT,35,1281,1198,2479
KERICHO,BELGUT,36,898,692,1590
KERICHO,BELGUT,37,893,728,1621
KERICHO,BELGUT,38,582,457,1039
KERICHO,BELGUT,39,828,653,1481
KERICHO,BELGUT,35-39,4482,3728,8210
KERICHO,BELGUT,40,968,871,1839
KERICHO,BELGUT,41,1199,979,2178
KERICHO,BELGUT,42,819,723,1542
KERICHO,BELGUT,43,674,662,1336
KERICHO,BELGUT,44,551,496,1047
KERICHO,BELGUT,40-44,4211,3731,7942
KERICHO,BELGUT,45,1079,850,1929
KERICHO,BELGUT,46,575,587,1162
KERICHO,BELGUT,47,700,668,1368
KERICHO,BELGUT,48,353,317,670
KERICHO,BELGUT,49,497,450,947
KERICHO,BELGUT,45-49,3204,2872,6076
KERICHO,BELGUT,50,541,567,1108
KERICHO,BELGUT,51,467,449,916
KERICHO,BELGUT,52,361,317,678
KERICHO,BELGUT,53,266,221,487
KERICHO,BELGUT,54,254,252,506
KERICHO,BELGUT,50-54,1889,1806,3695
KERICHO,BELGUT,55,285,250,535
KERICHO,BELGUT,56,285,267,552
KERICHO,BELGUT,57,337,351,688
KERICHO,BELGUT,58,470,511,981
KERICHO,BELGUT,59,351,285,636
KERICHO,BELGUT,55-59,1728,1664,3392
KERICHO,BELGUT,60,419,392,811
KERICHO,BELGUT,61,284,254,538
KERICHO,BELGUT,62,228,216,444
KERICHO,BELGUT,63,235,213,448
KERICHO,BELGUT,64,158,161,319
KERICHO,BELGUT,60-64,1324,1236,2560
KERICHO,BELGUT,65,293,292,585
KERICHO,BELGUT,66,171,119,290
KERICHO,BELGUT,67,227,283,510
KERICHO,BELGUT,68,96,96,192
KERICHO,BELGUT,69,166,185,351
KERICHO,BELGUT,65-69,953,975,1928
KERICHO,BELGUT,70,206,240,446
KERICHO,BELGUT,71,223,154,377
KERICHO,BELGUT,72,164,81,245
KERICHO,BELGUT,73,117,104,221
KERICHO,BELGUT,74,111,113,224
KERICHO,BELGUT,70-74,821,692,1513
KERICHO,BELGUT,75,77,84,161
KERICHO,BELGUT,76,64,55,119
KERICHO,BELGUT,77,98,73,171
KERICHO,BELGUT,78,39,35,74
KERICHO,BELGUT,79,69,111,180
KERICHO,BELGUT,75-79,347,358,705
KERICHO,BELGUT,80,63,135,198
KERICHO,BELGUT,81,37,77,114
KERICHO,BELGUT,82,39,39,78
KERICHO,BELGUT,83,43,44,87
KERICHO,BELGUT,84,44,62,106
KERICHO,BELGUT,80-84,226,357,583
KERICHO,BELGUT,85,38,42,80
KERICHO,BELGUT,86,27,23,50
KERICHO,BELGUT,87,30,34,64
KERICHO,BELGUT,88,18,19,37
KERICHO,BELGUT,89,26,90,116
KERICHO,BELGUT,85-89,139,208,347
KERICHO,BELGUT,90,15,45,60
KERICHO,BELGUT,91,8,15,23
KERICHO,BELGUT,92,12,18,30
KERICHO,BELGUT,93,4,4,8
KERICHO,BELGUT,94,9,25,34
KERICHO,BELGUT,90-94,48,107,155
KERICHO,BELGUT,95,20,16,36
KERICHO,BELGUT,96,10,7,17
KERICHO,BELGUT,97,3,5,8
KERICHO,BELGUT,98,2,4,6
KERICHO,BELGUT,99,3,17,20
KERICHO,BELGUT,95-99,38,49,87
KERICHO,BELGUT,100+,7,21,28
KERICHO,BELGUT,Not Stated,-,-,-
KERICHO,BURETI,Total,98823,100642,199465
KERICHO,BURETI,0,2157,2179,4336
KERICHO,BURETI,1,2341,2228,4569
KERICHO,BURETI,2,2441,2335,4776
KERICHO,BURETI,3,2480,2560,5040
KERICHO,BURETI,4,2533,2492,5025
KERICHO,BURETI,0 - 4,11952,11794,23746
KERICHO,BURETI,5,2539,2534,5073
KERICHO,BURETI,6,2572,2547,5119
KERICHO,BURETI,7,2660,2622,5282
KERICHO,BURETI,8,2433,2424,4857
KERICHO,BURETI,9,2822,2815,5637
KERICHO,BURETI,05-Sep,13026,12942,25968
KERICHO,BURETI,10,2722,2672,5394
KERICHO,BURETI,11,2606,2592,5198
KERICHO,BURETI,12,3025,2974,5999
KERICHO,BURETI,13,2810,2959,5769
KERICHO,BURETI,14,2859,2898,5757
KERICHO,BURETI,Oct-14,14022,14095,28117
KERICHO,BURETI,15,2791,2816,5607
KERICHO,BURETI,16,2565,2560,5125
KERICHO,BURETI,17,2524,2509,5033
KERICHO,BURETI,18,2026,1973,3999
KERICHO,BURETI,19,2365,2448,4813
KERICHO,BURETI,15-19,12271,12306,24577
KERICHO,BURETI,20,1958,2082,4040
KERICHO,BURETI,21,1987,2042,4029
KERICHO,BURETI,22,1773,2032,3805
KERICHO,BURETI,23,1876,2132,4008
KERICHO,BURETI,24,1638,1831,3469
KERICHO,BURETI,20-24,9232,10119,19351
KERICHO,BURETI,25,1936,2066,4002
KERICHO,BURETI,26,1533,1761,3294
KERICHO,BURETI,27,1697,1813,3510
KERICHO,BURETI,28,1243,1350,2593
KERICHO,BURETI,29,1328,1554,2882
KERICHO,BURETI,25-29,7737,8544,16281
KERICHO,BURETI,30,1653,2083,3736
KERICHO,BURETI,31,1308,1500,2808
KERICHO,BURETI,32,1502,1766,3268
KERICHO,BURETI,33,1325,1527,2852
KERICHO,BURETI,34,1209,1332,2541
KERICHO,BURETI,30-34,6997,8208,15205
KERICHO,BURETI,35,1578,1289,2867
KERICHO,BURETI,36,1060,785,1845
KERICHO,BURETI,37,1193,853,2046
KERICHO,BURETI,38,660,532,1192
KERICHO,BURETI,39,1002,795,1797
KERICHO,BURETI,35-39,5493,4254,9747
KERICHO,BURETI,40,1016,892,1908
KERICHO,BURETI,41,1116,974,2090
KERICHO,BURETI,42,894,780,1674
KERICHO,BURETI,43,737,796,1533
KERICHO,BURETI,44,558,620,1178
KERICHO,BURETI,40-44,4321,4062,8383
KERICHO,BURETI,45,1366,1198,2564
KERICHO,BURETI,46,724,757,1481
KERICHO,BURETI,47,834,916,1750
KERICHO,BURETI,48,429,425,854
KERICHO,BURETI,49,618,600,1218
KERICHO,BURETI,45-49,3971,3896,7867
KERICHO,BURETI,50,655,722,1377
KERICHO,BURETI,51,622,593,1215
KERICHO,BURETI,52,365,358,723
KERICHO,BURETI,53,280,247,527
KERICHO,BURETI,54,313,301,614
KERICHO,BURETI,50-54,2235,2221,4456
KERICHO,BURETI,55,304,302,606
KERICHO,BURETI,56,281,351,632
KERICHO,BURETI,57,438,520,958
KERICHO,BURETI,58,595,742,1337
KERICHO,BURETI,59,476,454,930
KERICHO,BURETI,55-59,2094,2369,4463
KERICHO,BURETI,60,512,546,1058
KERICHO,BURETI,61,464,378,842
KERICHO,BURETI,62,329,302,631
KERICHO,BURETI,63,317,341,658
KERICHO,BURETI,64,239,252,491
KERICHO,BURETI,60-64,1861,1819,3680
KERICHO,BURETI,65,441,421,862
KERICHO,BURETI,66,213,233,446
KERICHO,BURETI,67,418,339,757
KERICHO,BURETI,68,136,144,280
KERICHO,BURETI,69,246,229,475
KERICHO,BURETI,65-69,1454,1366,2820
KERICHO,BURETI,70,344,333,677
KERICHO,BURETI,71,299,249,548
KERICHO,BURETI,72,175,123,298
KERICHO,BURETI,73,172,139,311
KERICHO,BURETI,74,148,148,296
KERICHO,BURETI,70-74,1138,992,2130
KERICHO,BURETI,75,103,142,245
KERICHO,BURETI,76,71,84,155
KERICHO,BURETI,77,116,121,237
KERICHO,BURETI,78,59,59,118
KERICHO,BURETI,79,81,162,243
KERICHO,BURETI,75-79,430,568,998
KERICHO,BURETI,80,111,144,255
KERICHO,BURETI,81,62,103,165
KERICHO,BURETI,82,50,52,102
KERICHO,BURETI,83,51,78,129
KERICHO,BURETI,84,42,99,141
KERICHO,BURETI,80-84,316,476,792
KERICHO,BURETI,85,38,73,111
KERICHO,BURETI,86,36,38,74
KERICHO,BURETI,87,24,59,83
KERICHO,BURETI,88,22,41,63
KERICHO,BURETI,89,31,114,145
KERICHO,BURETI,85-89,151,325,476
KERICHO,BURETI,90,30,62,92
KERICHO,BURETI,91,11,34,45
KERICHO,BURETI,92,9,17,26
KERICHO,BURETI,93,9,16,25
KERICHO,BURETI,94,9,30,39
KERICHO,BURETI,90-94,68,159,227
KERICHO,BURETI,95,20,38,58
KERICHO,BURETI,96,4,9,13
KERICHO,BURETI,97,5,13,18
KERICHO,BURETI,98,5,14,19
KERICHO,BURETI,99,5,30,35
KERICHO,BURETI,95-99,39,104,143
KERICHO,BURETI,100+,15,23,38
KERICHO,BURETI,Not Stated,-,-,-
KERICHO,KERICHO EAST,Total,86671,83947,170618
KERICHO,KERICHO EAST,0,1960,1735,3695
KERICHO,KERICHO EAST,1,1806,1909,3715
KERICHO,KERICHO EAST,2,1954,1873,3827
KERICHO,KERICHO EAST,3,2077,2030,4107
KERICHO,KERICHO EAST,4,2081,2010,4091
KERICHO,KERICHO EAST,0 - 4,9878,9557,19435
KERICHO,KERICHO EAST,5,1952,1909,3861
KERICHO,KERICHO EAST,6,2003,2014,4017
KERICHO,KERICHO EAST,7,2103,1960,4063
KERICHO,KERICHO EAST,8,1887,1930,3817
KERICHO,KERICHO EAST,9,2205,2267,4472
KERICHO,KERICHO EAST,05-Sep,10150,10080,20230
KERICHO,KERICHO EAST,10,2049,2082,4131
KERICHO,KERICHO EAST,11,1983,2037,4020
KERICHO,KERICHO EAST,12,2322,2240,4562
KERICHO,KERICHO EAST,13,2148,2166,4314
KERICHO,KERICHO EAST,14,2129,2101,4230
KERICHO,KERICHO EAST,Oct-14,10631,10626,21257
KERICHO,KERICHO EAST,15,2080,2023,4103
KERICHO,KERICHO EAST,16,1868,1882,3750
KERICHO,KERICHO EAST,17,1868,1875,3743
KERICHO,KERICHO EAST,18,1591,1632,3223
KERICHO,KERICHO EAST,19,1843,1889,3732
KERICHO,KERICHO EAST,15-19,9250,9301,18551
KERICHO,KERICHO EAST,20,1644,1909,3553
KERICHO,KERICHO EAST,21,1845,1954,3799
KERICHO,KERICHO EAST,22,1714,1878,3592
KERICHO,KERICHO EAST,23,1881,2115,3996
KERICHO,KERICHO EAST,24,1823,1808,3631
KERICHO,KERICHO EAST,20-24,8907,9664,18571
KERICHO,KERICHO EAST,25,1962,1945,3907
KERICHO,KERICHO EAST,26,1718,1687,3405
KERICHO,KERICHO EAST,27,1906,1798,3704
KERICHO,KERICHO EAST,28,1393,1336,2729
KERICHO,KERICHO EAST,29,1621,1581,3202
KERICHO,KERICHO EAST,25-29,8600,8347,16947
KERICHO,KERICHO EAST,30,1877,1788,3665
KERICHO,KERICHO EAST,31,1394,1357,2751
KERICHO,KERICHO EAST,32,1684,1683,3367
KERICHO,KERICHO EAST,33,1381,1389,2770
KERICHO,KERICHO EAST,34,1245,1192,2437
KERICHO,KERICHO EAST,30-34,7581,7409,14990
KERICHO,KERICHO EAST,35,1544,1343,2887
KERICHO,KERICHO EAST,36,1007,848,1855
KERICHO,KERICHO EAST,37,1122,818,1940
KERICHO,KERICHO EAST,38,798,603,1401
KERICHO,KERICHO EAST,39,965,677,1642
KERICHO,KERICHO EAST,35-39,5436,4289,9725
KERICHO,KERICHO EAST,40,1106,811,1917
KERICHO,KERICHO EAST,41,1160,852,2012
KERICHO,KERICHO EAST,42,944,695,1639
KERICHO,KERICHO EAST,43,783,666,1449
KERICHO,KERICHO EAST,44,547,494,1041
KERICHO,KERICHO EAST,40-44,4540,3518,8058
KERICHO,KERICHO EAST,45,1162,892,2054
KERICHO,KERICHO EAST,46,653,627,1280
KERICHO,KERICHO EAST,47,713,654,1367
KERICHO,KERICHO EAST,48,438,384,822
KERICHO,KERICHO EAST,49,522,495,1017
KERICHO,KERICHO EAST,45-49,3488,3052,6540
KERICHO,KERICHO EAST,50,581,582,1163
KERICHO,KERICHO EAST,51,497,505,1002
KERICHO,KERICHO EAST,52,398,293,691
KERICHO,KERICHO EAST,53,315,241,556
KERICHO,KERICHO EAST,54,365,314,679
KERICHO,KERICHO EAST,50-54,2156,1935,4091
KERICHO,KERICHO EAST,55,359,263,622
KERICHO,KERICHO EAST,56,338,343,681
KERICHO,KERICHO EAST,57,372,411,783
KERICHO,KERICHO EAST,58,461,467,928
KERICHO,KERICHO EAST,59,444,348,792
KERICHO,KERICHO EAST,55-59,1974,1832,3806
KERICHO,KERICHO EAST,60,389,407,796
KERICHO,KERICHO EAST,61,306,333,639
KERICHO,KERICHO EAST,62,235,243,478
KERICHO,KERICHO EAST,63,250,244,494
KERICHO,KERICHO EAST,64,158,193,351
KERICHO,KERICHO EAST,60-64,1338,1420,2758
KERICHO,KERICHO EAST,65,302,273,575
KERICHO,KERICHO EAST,66,204,131,335
KERICHO,KERICHO EAST,67,273,252,525
KERICHO,KERICHO EAST,68,104,105,209
KERICHO,KERICHO EAST,69,194,177,371
KERICHO,KERICHO EAST,65-69,1077,938,2015
KERICHO,KERICHO EAST,70,244,287,531
KERICHO,KERICHO EAST,71,224,133,357
KERICHO,KERICHO EAST,72,146,95,241
KERICHO,KERICHO EAST,73,112,101,213
KERICHO,KERICHO EAST,74,105,143,248
KERICHO,KERICHO EAST,70-74,831,759,1590
KERICHO,KERICHO EAST,75,82,101,183
KERICHO,KERICHO EAST,76,53,64,117
KERICHO,KERICHO EAST,77,96,85,181
KERICHO,KERICHO EAST,78,48,55,103
KERICHO,KERICHO EAST,79,60,136,196
KERICHO,KERICHO EAST,75-79,339,441,780
KERICHO,KERICHO EAST,80,73,131,204
KERICHO,KERICHO EAST,81,43,62,105
KERICHO,KERICHO EAST,82,27,39,66
KERICHO,KERICHO EAST,83,48,57,105
KERICHO,KERICHO EAST,84,33,56,89
KERICHO,KERICHO EAST,80-84,224,345,569
KERICHO,KERICHO EAST,85,33,66,99
KERICHO,KERICHO EAST,86,32,37,69
KERICHO,KERICHO EAST,87,38,25,63
KERICHO,KERICHO EAST,88,22,22,44
KERICHO,KERICHO EAST,89,38,85,123
KERICHO,KERICHO EAST,85-89,163,235,398
KERICHO,KERICHO EAST,90,15,42,57
KERICHO,KERICHO EAST,91,15,21,36
KERICHO,KERICHO EAST,92,7,10,17
KERICHO,KERICHO EAST,93,8,10,18
KERICHO,KERICHO EAST,94,9,17,26
KERICHO,KERICHO EAST,90-94,54,100,154
KERICHO,KERICHO EAST,95,16,17,33
KERICHO,KERICHO EAST,96,5,7,12
KERICHO,KERICHO EAST,97,5,8,13
KERICHO,KERICHO EAST,98,3,15,18
KERICHO,KERICHO EAST,99,8,10,18
KERICHO,KERICHO EAST,95-99,37,57,94
KERICHO,KERICHO EAST,100+,11,40,51
KERICHO,KERICHO EAST,Not Stated,6,2,8
KERICHO,KIPKELION,Total,61066,61460,122526
KERICHO,KIPKELION,0,1539,1658,3197
KERICHO,KIPKELION,1,1772,1654,3426
KERICHO,KIPKELION,2,1720,1762,3482
KERICHO,KIPKELION,3,1828,1838,3666
KERICHO,KIPKELION,4,1902,1843,3745
KERICHO,KIPKELION,0 - 4,8761,8755,17516
KERICHO,KIPKELION,5,1920,1859,3779
KERICHO,KIPKELION,6,1846,1873,3719
KERICHO,KIPKELION,7,1880,1826,3706
KERICHO,KIPKELION,8,1801,1619,3420
KERICHO,KIPKELION,9,1950,1909,3859
KERICHO,KIPKELION,05-Sep,9397,9086,18483
KERICHO,KIPKELION,10,1889,1863,3752
KERICHO,KIPKELION,11,1888,1744,3632
KERICHO,KIPKELION,12,1999,1945,3944
KERICHO,KIPKELION,13,1814,1841,3655
KERICHO,KIPKELION,14,1729,1732,3461
KERICHO,KIPKELION,Oct-14,9319,9125,18444
KERICHO,KIPKELION,15,1762,1634,3396
KERICHO,KIPKELION,16,1490,1604,3094
KERICHO,KIPKELION,17,1567,1342,2909
KERICHO,KIPKELION,18,1290,1151,2441
KERICHO,KIPKELION,19,1508,1358,2866
KERICHO,KIPKELION,15-19,7617,7089,14706
KERICHO,KIPKELION,20,1186,1238,2424
KERICHO,KIPKELION,21,1112,1275,2387
KERICHO,KIPKELION,22,1022,1067,2089
KERICHO,KIPKELION,23,1011,1176,2187
KERICHO,KIPKELION,24,913,932,1845
KERICHO,KIPKELION,20-24,5244,5688,10932
KERICHO,KIPKELION,25,975,1050,2025
KERICHO,KIPKELION,26,801,926,1727
KERICHO,KIPKELION,27,871,986,1857
KERICHO,KIPKELION,28,579,698,1277
KERICHO,KIPKELION,29,749,855,1604
KERICHO,KIPKELION,25-29,3975,4515,8490
KERICHO,KIPKELION,30,833,991,1824
KERICHO,KIPKELION,31,710,826,1536
KERICHO,KIPKELION,32,835,956,1791
KERICHO,KIPKELION,33,762,829,1591
KERICHO,KIPKELION,34,633,649,1282
KERICHO,KIPKELION,30-34,3773,4251,8024
KERICHO,KIPKELION,35,849,746,1595
KERICHO,KIPKELION,36,543,362,905
KERICHO,KIPKELION,37,561,432,993
KERICHO,KIPKELION,38,318,277,595
KERICHO,KIPKELION,39,462,399,861
KERICHO,KIPKELION,35-39,2733,2216,4949
KERICHO,KIPKELION,40,472,417,889
KERICHO,KIPKELION,41,649,569,1218
KERICHO,KIPKELION,42,524,466,990
KERICHO,KIPKELION,43,422,475,897
KERICHO,KIPKELION,44,346,356,702
KERICHO,KIPKELION,40-44,2413,2283,4696
KERICHO,KIPKELION,45,661,601,1262
KERICHO,KIPKELION,46,394,420,814
KERICHO,KIPKELION,47,450,441,891
KERICHO,KIPKELION,48,249,235,484
KERICHO,KIPKELION,49,324,312,636
KERICHO,KIPKELION,45-49,2078,2009,4087
KERICHO,KIPKELION,50,356,406,762
KERICHO,KIPKELION,51,343,315,658
KERICHO,KIPKELION,52,232,236,468
KERICHO,KIPKELION,53,197,192,389
KERICHO,KIPKELION,54,217,190,407
KERICHO,KIPKELION,50-54,1345,1339,2684
KERICHO,KIPKELION,55,216,224,440
KERICHO,KIPKELION,56,218,241,459
KERICHO,KIPKELION,57,241,330,571
KERICHO,KIPKELION,58,346,500,846
KERICHO,KIPKELION,59,264,301,565
KERICHO,KIPKELION,55-59,1285,1596,2881
KERICHO,KIPKELION,60,255,308,563
KERICHO,KIPKELION,61,225,267,492
KERICHO,KIPKELION,62,188,206,394
KERICHO,KIPKELION,63,211,208,419
KERICHO,KIPKELION,64,128,146,274
KERICHO,KIPKELION,60-64,1007,1135,2142
KERICHO,KIPKELION,65,239,238,477
KERICHO,KIPKELION,66,131,94,225
KERICHO,KIPKELION,67,210,224,434
KERICHO,KIPKELION,68,109,95,204
KERICHO,KIPKELION,69,160,151,311
KERICHO,KIPKELION,65-69,849,802,1651
KERICHO,KIPKELION,70,176,254,430
KERICHO,KIPKELION,71,161,113,274
KERICHO,KIPKELION,72,106,70,176
KERICHO,KIPKELION,73,75,66,141
KERICHO,KIPKELION,74,78,103,181
KERICHO,KIPKELION,70-74,596,606,1202
KERICHO,KIPKELION,75,58,93,151
KERICHO,KIPKELION,76,57,59,116
KERICHO,KIPKELION,77,69,61,130
KERICHO,KIPKELION,78,34,44,78
KERICHO,KIPKELION,79,50,98,148
KERICHO,KIPKELION,75-79,268,355,623
KERICHO,KIPKELION,80,60,116,176
KERICHO,KIPKELION,81,38,62,100
KERICHO,KIPKELION,82,31,40,71
KERICHO,KIPKELION,83,35,36,71
KERICHO,KIPKELION,84,40,47,87
KERICHO,KIPKELION,80-84,204,301,505
KERICHO,KIPKELION,85,32,43,75
KERICHO,KIPKELION,86,17,19,36
KERICHO,KIPKELION,87,29,29,58
KERICHO,KIPKELION,88,9,14,23
KERICHO,KIPKELION,89,31,69,100
KERICHO,KIPKELION,85-89,118,174,292
KERICHO,KIPKELION,90,21,33,54
KERICHO,KIPKELION,91,7,9,16
KERICHO,KIPKELION,92,5,10,15
KERICHO,KIPKELION,93,8,15,23
KERICHO,KIPKELION,94,8,14,22
KERICHO,KIPKELION,90-94,49,81,130
KERICHO,KIPKELION,95,8,13,21
KERICHO,KIPKELION,96,4,6,10
KERICHO,KIPKELION,97,4,8,12
KERICHO,KIPKELION,98,2,2,4
KERICHO,KIPKELION,99,8,8,16
KERICHO,KIPKELION,95-99,26,37,63
KERICHO,KIPKELION,100+,7,17,24
KERICHO,KIPKELION,Not Stated,2,-,2
KERICHO,LONDIANI,Total,68570,69000,137570
KERICHO,LONDIANI,0,1649,1585,3234
KERICHO,LONDIANI,1,1720,1733,3453
KERICHO,LONDIANI,2,1853,1707,3560
KERICHO,LONDIANI,3,1932,1883,3815
KERICHO,LONDIANI,4,1921,1859,3780
KERICHO,LONDIANI,0 - 4,9075,8767,17842
KERICHO,LONDIANI,5,1919,1857,3776
KERICHO,LONDIANI,6,1872,1800,3672
KERICHO,LONDIANI,7,1864,1824,3688
KERICHO,LONDIANI,8,1798,1732,3530
KERICHO,LONDIANI,9,2028,2056,4084
KERICHO,LONDIANI,05-Sep,9481,9269,18750
KERICHO,LONDIANI,10,1931,1880,3811
KERICHO,LONDIANI,11,1881,1849,3730
KERICHO,LONDIANI,12,2150,2010,4160
KERICHO,LONDIANI,13,2041,2083,4124
KERICHO,LONDIANI,14,1920,1907,3827
KERICHO,LONDIANI,Oct-14,9923,9729,19652
KERICHO,LONDIANI,15,1886,1895,3781
KERICHO,LONDIANI,16,1796,1668,3464
KERICHO,LONDIANI,17,1807,1638,3445
KERICHO,LONDIANI,18,1420,1303,2723
KERICHO,LONDIANI,19,1728,1553,3281
KERICHO,LONDIANI,15-19,8637,8057,16694
KERICHO,LONDIANI,20,1254,1289,2543
KERICHO,LONDIANI,21,1293,1397,2690
KERICHO,LONDIANI,22,1126,1184,2310
KERICHO,LONDIANI,23,1084,1307,2391
KERICHO,LONDIANI,24,1018,1142,2160
KERICHO,LONDIANI,20-24,5775,6319,12094
KERICHO,LONDIANI,25,1080,1179,2259
KERICHO,LONDIANI,26,982,1108,2090
KERICHO,LONDIANI,27,987,1182,2169
KERICHO,LONDIANI,28,801,885,1686
KERICHO,LONDIANI,29,906,1011,1917
KERICHO,LONDIANI,25-29,4756,5365,10121
KERICHO,LONDIANI,30,1047,1213,2260
KERICHO,LONDIANI,31,788,1030,1818
KERICHO,LONDIANI,32,1024,1214,2238
KERICHO,LONDIANI,33,872,1094,1966
KERICHO,LONDIANI,34,791,876,1667
KERICHO,LONDIANI,30-34,4522,5427,9949
KERICHO,LONDIANI,35,987,992,1979
KERICHO,LONDIANI,36,680,567,1247
KERICHO,LONDIANI,37,715,611,1326
KERICHO,LONDIANI,38,521,402,923
KERICHO,LONDIANI,39,662,569,1231
KERICHO,LONDIANI,35-39,3565,3141,6706
KERICHO,LONDIANI,40,700,595,1295
KERICHO,LONDIANI,41,915,819,1734
KERICHO,LONDIANI,42,654,581,1235
KERICHO,LONDIANI,43,492,566,1058
KERICHO,LONDIANI,44,445,405,850
KERICHO,LONDIANI,40-44,3206,2966,6172
KERICHO,LONDIANI,45,910,722,1632
KERICHO,LONDIANI,46,533,513,1046
KERICHO,LONDIANI,47,549,520,1069
KERICHO,LONDIANI,48,340,342,682
KERICHO,LONDIANI,49,453,410,863
KERICHO,LONDIANI,45-49,2785,2507,5292
KERICHO,LONDIANI,50,476,453,929
KERICHO,LONDIANI,51,416,435,851
KERICHO,LONDIANI,52,288,287,575
KERICHO,LONDIANI,53,211,199,410
KERICHO,LONDIANI,54,257,248,505
KERICHO,LONDIANI,50-54,1648,1622,3270
KERICHO,LONDIANI,55,272,293,565
KERICHO,LONDIANI,56,317,290,607
KERICHO,LONDIANI,57,311,349,660
KERICHO,LONDIANI,58,370,505,875
KERICHO,LONDIANI,59,282,338,620
KERICHO,LONDIANI,55-59,1552,1775,3327
KERICHO,LONDIANI,60,308,370,678
KERICHO,LONDIANI,61,256,284,540
KERICHO,LONDIANI,62,217,212,429
KERICHO,LONDIANI,63,193,220,413
KERICHO,LONDIANI,64,153,178,331
KERICHO,LONDIANI,60-64,1127,1264,2391
KERICHO,LONDIANI,65,229,276,505
KERICHO,LONDIANI,66,148,133,281
KERICHO,LONDIANI,67,260,252,512
KERICHO,LONDIANI,68,120,120,240
KERICHO,LONDIANI,69,163,150,313
KERICHO,LONDIANI,65-69,920,931,1851
KERICHO,LONDIANI,70,216,261,477
KERICHO,LONDIANI,71,200,133,333
KERICHO,LONDIANI,72,141,115,256
KERICHO,LONDIANI,73,112,115,227
KERICHO,LONDIANI,74,100,99,199
KERICHO,LONDIANI,70-74,769,723,1492
KERICHO,LONDIANI,75,78,124,202
KERICHO,LONDIANI,76,77,89,166
KERICHO,LONDIANI,77,85,84,169
KERICHO,LONDIANI,78,55,58,113
KERICHO,LONDIANI,79,69,93,162
KERICHO,LONDIANI,75-79,364,448,812
KERICHO,LONDIANI,80,50,121,171
KERICHO,LONDIANI,81,42,57,99
KERICHO,LONDIANI,82,56,46,102
KERICHO,LONDIANI,83,38,47,85
KERICHO,LONDIANI,84,40,57,97
KERICHO,LONDIANI,80-84,226,328,554
KERICHO,LONDIANI,85,36,44,80
KERICHO,LONDIANI,86,21,13,34
KERICHO,LONDIANI,87,37,25,62
KERICHO,LONDIANI,88,22,16,38
KERICHO,LONDIANI,89,24,70,94
KERICHO,LONDIANI,85-89,140,168,308
KERICHO,LONDIANI,90,22,38,60
KERICHO,LONDIANI,91,9,21,30
KERICHO,LONDIANI,92,5,7,12
KERICHO,LONDIANI,93,8,13,21
KERICHO,LONDIANI,94,4,18,22
KERICHO,LONDIANI,90-94,48,97,145
KERICHO,LONDIANI,95,16,27,43
KERICHO,LONDIANI,96,6,11,17
KERICHO,LONDIANI,97,9,10,19
KERICHO,LONDIANI,98,4,8,12
KERICHO,LONDIANI,99,4,15,19
KERICHO,LONDIANI,95-99,39,71,110
KERICHO,LONDIANI,100+,12,25,37
KERICHO,LONDIANI,Not Stated,-,1,1
KERICHO,SOIN SIGOWET,Total,63103,63395,126498
KERICHO,SOIN SIGOWET,0,1377,1305,2682
KERICHO,SOIN SIGOWET,1,1509,1472,2981
KERICHO,SOIN SIGOWET,2,1555,1543,3098
KERICHO,SOIN SIGOWET,3,1614,1646,3260
KERICHO,SOIN SIGOWET,4,1686,1611,3297
KERICHO,SOIN SIGOWET,0 - 4,7741,7577,15318
KERICHO,SOIN SIGOWET,5,1692,1671,3363
KERICHO,SOIN SIGOWET,6,1744,1626,3370
KERICHO,SOIN SIGOWET,7,1809,1744,3553
KERICHO,SOIN SIGOWET,8,1682,1560,3242
KERICHO,SOIN SIGOWET,9,1985,1824,3809
KERICHO,SOIN SIGOWET,05-Sep,8912,8425,17337
KERICHO,SOIN SIGOWET,10,2012,1883,3895
KERICHO,SOIN SIGOWET,11,1830,1872,3702
KERICHO,SOIN SIGOWET,12,2118,2005,4123
KERICHO,SOIN SIGOWET,13,1924,2064,3988
KERICHO,SOIN SIGOWET,14,1882,1874,3756
KERICHO,SOIN SIGOWET,Oct-14,9766,9698,19464
KERICHO,SOIN SIGOWET,15,1869,1796,3665
KERICHO,SOIN SIGOWET,16,1661,1494,3155
KERICHO,SOIN SIGOWET,17,1604,1518,3122
KERICHO,SOIN SIGOWET,18,1233,1203,2436
KERICHO,SOIN SIGOWET,19,1587,1512,3099
KERICHO,SOIN SIGOWET,15-19,7954,7523,15477
KERICHO,SOIN SIGOWET,20,1134,1316,2450
KERICHO,SOIN SIGOWET,21,1146,1225,2371
KERICHO,SOIN SIGOWET,22,986,1110,2096
KERICHO,SOIN SIGOWET,23,1134,1222,2356
KERICHO,SOIN SIGOWET,24,923,1051,1974
KERICHO,SOIN SIGOWET,20-24,5323,5924,11247
KERICHO,SOIN SIGOWET,25,1049,1219,2268
KERICHO,SOIN SIGOWET,26,812,1009,1821
KERICHO,SOIN SIGOWET,27,984,1144,2128
KERICHO,SOIN SIGOWET,28,768,872,1640
KERICHO,SOIN SIGOWET,29,858,1036,1894
KERICHO,SOIN SIGOWET,25-29,4471,5280,9751
KERICHO,SOIN SIGOWET,30,1076,1212,2288
KERICHO,SOIN SIGOWET,31,839,901,1740
KERICHO,SOIN SIGOWET,32,995,1112,2107
KERICHO,SOIN SIGOWET,33,913,1010,1923
KERICHO,SOIN SIGOWET,34,787,829,1616
KERICHO,SOIN SIGOWET,30-34,4610,5064,9674
KERICHO,SOIN SIGOWET,35,1004,837,1841
KERICHO,SOIN SIGOWET,36,564,407,971
KERICHO,SOIN SIGOWET,37,654,461,1115
KERICHO,SOIN SIGOWET,38,364,290,654
KERICHO,SOIN SIGOWET,39,557,450,1007
KERICHO,SOIN SIGOWET,35-39,3143,2445,5588
KERICHO,SOIN SIGOWET,40,656,503,1159
KERICHO,SOIN SIGOWET,41,775,676,1451
KERICHO,SOIN SIGOWET,42,516,501,1017
KERICHO,SOIN SIGOWET,43,440,440,880
KERICHO,SOIN SIGOWET,44,349,390,739
KERICHO,SOIN SIGOWET,40-44,2736,2510,5246
KERICHO,SOIN SIGOWET,45,890,683,1573
KERICHO,SOIN SIGOWET,46,472,397,869
KERICHO,SOIN SIGOWET,47,500,550,1050
KERICHO,SOIN SIGOWET,48,273,246,519
KERICHO,SOIN SIGOWET,49,356,442,798
KERICHO,SOIN SIGOWET,45-49,2491,2318,4809
KERICHO,SOIN SIGOWET,50,413,439,852
KERICHO,SOIN SIGOWET,51,399,377,776
KERICHO,SOIN SIGOWET,52,245,255,500
KERICHO,SOIN SIGOWET,53,193,176,369
KERICHO,SOIN SIGOWET,54,196,182,378
KERICHO,SOIN SIGOWET,50-54,1446,1429,2875
KERICHO,SOIN SIGOWET,55,227,204,431
KERICHO,SOIN SIGOWET,56,205,252,457
KERICHO,SOIN SIGOWET,57,254,277,531
KERICHO,SOIN SIGOWET,58,387,460,847
KERICHO,SOIN SIGOWET,59,294,282,576
KERICHO,SOIN SIGOWET,55-59,1367,1475,2842
KERICHO,SOIN SIGOWET,60,310,350,660
KERICHO,SOIN SIGOWET,61,235,248,483
KERICHO,SOIN SIGOWET,62,176,185,361
KERICHO,SOIN SIGOWET,63,189,212,401
KERICHO,SOIN SIGOWET,64,127,174,301
KERICHO,SOIN SIGOWET,60-64,1037,1169,2206
KERICHO,SOIN SIGOWET,65,229,274,503
KERICHO,SOIN SIGOWET,66,132,111,243
KERICHO,SOIN SIGOWET,67,222,212,434
KERICHO,SOIN SIGOWET,68,94,103,197
KERICHO,SOIN SIGOWET,69,148,173,321
KERICHO,SOIN SIGOWET,65-69,825,873,1698
KERICHO,SOIN SIGOWET,70,183,243,426
KERICHO,SOIN SIGOWET,71,157,147,304
KERICHO,SOIN SIGOWET,72,100,77,177
KERICHO,SOIN SIGOWET,73,61,82,143
KERICHO,SOIN SIGOWET,74,100,80,180
KERICHO,SOIN SIGOWET,70-74,601,629,1230
KERICHO,SOIN SIGOWET,75,80,89,169
KERICHO,SOIN SIGOWET,76,45,46,91
KERICHO,SOIN SIGOWET,77,74,74,148
KERICHO,SOIN SIGOWET,78,31,34,65
KERICHO,SOIN SIGOWET,79,65,104,169
KERICHO,SOIN SIGOWET,75-79,295,347,642
KERICHO,SOIN SIGOWET,80,49,138,187
KERICHO,SOIN SIGOWET,81,24,62,86
KERICHO,SOIN SIGOWET,82,30,27,57
KERICHO,SOIN SIGOWET,83,28,48,76
KERICHO,SOIN SIGOWET,84,36,83,119
KERICHO,SOIN SIGOWET,80-84,167,358,525
KERICHO,SOIN SIGOWET,85,35,43,78
KERICHO,SOIN SIGOWET,86,18,24,42
KERICHO,SOIN SIGOWET,87,20,34,54
KERICHO,SOIN SIGOWET,88,16,23,39
KERICHO,SOIN SIGOWET,89,34,71,105
KERICHO,SOIN SIGOWET,85-89,123,195,318
KERICHO,SOIN SIGOWET,90,16,19,35
KERICHO,SOIN SIGOWET,91,4,18,22
KERICHO,SOIN SIGOWET,92,7,8,15
KERICHO,SOIN SIGOWET,93,10,8,18
KERICHO,SOIN SIGOWET,94,11,16,27
KERICHO,SOIN SIGOWET,90-94,48,69,117
KERICHO,SOIN SIGOWET,95,14,22,36
KERICHO,SOIN SIGOWET,96,1,10,11
KERICHO,SOIN SIGOWET,97,10,9,19
KERICHO,SOIN SIGOWET,98,2,2,4
KERICHO,SOIN SIGOWET,99,6,18,24
KERICHO,SOIN SIGOWET,95-99,33,61,94
KERICHO,SOIN SIGOWET,100+,12,26,38
KERICHO,SOIN SIGOWET,Not Stated,2,-,2
KIAMBU,ALL,Total,1187146,1230454,2417600
KIAMBU,ALL,0,29608,29445,59053
KIAMBU,ALL,1,29092,28394,57486
KIAMBU,ALL,2,27832,27383,55215
KIAMBU,ALL,3,27477,27311,54788
KIAMBU,ALL,4,26120,25479,51599
KIAMBU,ALL,0 - 4,140129,138012,278141
KIAMBU,ALL,5,24814,24226,49040
KIAMBU,ALL,6,24023,24057,48080
KIAMBU,ALL,7,24337,24214,48551
KIAMBU,ALL,8,22817,23190,46007
KIAMBU,ALL,9,24994,25128,50122
KIAMBU,ALL,05-Sep,120985,120815,241800
KIAMBU,ALL,10,23830,23625,47455
KIAMBU,ALL,11,21337,21947,43284
KIAMBU,ALL,12,23207,23303,46510
KIAMBU,ALL,13,23198,23336,46534
KIAMBU,ALL,14,21644,21903,43547
KIAMBU,ALL,Oct-14,113216,114114,227330
KIAMBU,ALL,15,20776,21335,42111
KIAMBU,ALL,16,20083,21412,41495
KIAMBU,ALL,17,21420,22041,43461
KIAMBU,ALL,18,18209,20478,38687
KIAMBU,ALL,19,21311,24856,46167
KIAMBU,ALL,15-19,101799,110122,211921
KIAMBU,ALL,20,21452,27039,48491
KIAMBU,ALL,21,23451,27587,51038
KIAMBU,ALL,22,24229,29090,53319
KIAMBU,ALL,23,27337,31887,59224
KIAMBU,ALL,24,26505,29516,56021
KIAMBU,ALL,20-24,122974,145119,268093
KIAMBU,ALL,25,26922,28956,55878
KIAMBU,ALL,26,24378,26745,51123
KIAMBU,ALL,27,25227,26172,51399
KIAMBU,ALL,28,22122,23883,46005
KIAMBU,ALL,29,24169,25387,49556
KIAMBU,ALL,25-29,122818,131143,253961
KIAMBU,ALL,30,27508,29535,57043
KIAMBU,ALL,31,20308,20718,41026
KIAMBU,ALL,32,24707,25615,50322
KIAMBU,ALL,33,20182,21540,41722
KIAMBU,ALL,34,19413,20070,39483
KIAMBU,ALL,30-34,112118,117478,229596
KIAMBU,ALL,35,23309,23140,46449
KIAMBU,ALL,36,17392,18311,35703
KIAMBU,ALL,37,17437,17292,34729
KIAMBU,ALL,38,15647,16043,31690
KIAMBU,ALL,39,16447,16310,32757
KIAMBU,ALL,35-39,90232,91096,181328
KIAMBU,ALL,40,18378,17650,36028
KIAMBU,ALL,41,15437,14881,30318
KIAMBU,ALL,42,15087,14168,29255
KIAMBU,ALL,43,13082,12638,25720
KIAMBU,ALL,44,11129,10603,21732
KIAMBU,ALL,40-44,73113,69940,143053
KIAMBU,ALL,45,15508,13966,29474
KIAMBU,ALL,46,11751,11043,22794
KIAMBU,ALL,47,12084,10955,23039
KIAMBU,ALL,48,9168,8699,17867
KIAMBU,ALL,49,10071,9355,19426
KIAMBU,ALL,45-49,58582,54018,112600
KIAMBU,ALL,50,10942,10700,21642
KIAMBU,ALL,51,8423,7630,16053
KIAMBU,ALL,52,9289,8541,17830
KIAMBU,ALL,53,6414,6241,12655
KIAMBU,ALL,54,7544,6992,14536
KIAMBU,ALL,50-54,42612,40104,82716
KIAMBU,ALL,55,7675,6646,14321
KIAMBU,ALL,56,7677,7027,14704
KIAMBU,ALL,57,6067,6410,12477
KIAMBU,ALL,58,5008,4929,9937
KIAMBU,ALL,59,5332,5220,10552
KIAMBU,ALL,55-59,31759,30232,61991
KIAMBU,ALL,60,5606,5638,11244
KIAMBU,ALL,61,4358,4300,8658
KIAMBU,ALL,62,3912,3687,7599
KIAMBU,ALL,63,3285,3160,6445
KIAMBU,ALL,64,2469,2570,5039
KIAMBU,ALL,60-64,19630,19355,38985
KIAMBU,ALL,65,3631,3737,7368
KIAMBU,ALL,66,2479,2654,5133
KIAMBU,ALL,67,4016,4304,8320
KIAMBU,ALL,68,1830,1866,3696
KIAMBU,ALL,69,2587,2871,5458
KIAMBU,ALL,65-69,14543,15432,29975
KIAMBU,ALL,70,3142,3922,7064
KIAMBU,ALL,71,2282,2475,4757
KIAMBU,ALL,72,2344,2227,4571
KIAMBU,ALL,73,1800,1915,3715
KIAMBU,ALL,74,1608,1881,3489
KIAMBU,ALL,70-74,11176,12420,23596
KIAMBU,ALL,75,1288,1919,3207
KIAMBU,ALL,76,1379,2512,3891
KIAMBU,ALL,77,1083,1514,2597
KIAMBU,ALL,78,674,946,1620
KIAMBU,ALL,79,759,1446,2205
KIAMBU,ALL,75-79,5183,8337,13520
KIAMBU,ALL,80,991,1995,2986
KIAMBU,ALL,81,568,1006,1574
KIAMBU,ALL,82,585,779,1364
KIAMBU,ALL,83,622,876,1498
KIAMBU,ALL,84,557,1010,1567
KIAMBU,ALL,80-84,3323,5666,8989
KIAMBU,ALL,85,456,1068,1524
KIAMBU,ALL,86,380,722,1102
KIAMBU,ALL,87,386,607,993
KIAMBU,ALL,88,212,372,584
KIAMBU,ALL,89,357,851,1208
KIAMBU,ALL,85-89,1791,3620,5411
KIAMBU,ALL,90,189,583,772
KIAMBU,ALL,91,196,384,580
KIAMBU,ALL,92,129,273,402
KIAMBU,ALL,93,101,256,357
KIAMBU,ALL,94,62,237,299
KIAMBU,ALL,90-94,677,1733,2410
KIAMBU,ALL,95,103,313,416
KIAMBU,ALL,96,71,222,293
KIAMBU,ALL,97,102,220,322
KIAMBU,ALL,98,35,125,160
KIAMBU,ALL,99,53,234,287
KIAMBU,ALL,95-99,364,1114,1478
KIAMBU,ALL,100+,92,566,658
KIAMBU,ALL,Not Stated,30,18,48
KIAMBU,GATUNDU NORTH,Total,54189,55678,109867
KIAMBU,GATUNDU NORTH,0,1139,1133,2272
KIAMBU,GATUNDU NORTH,1,1173,1082,2255
KIAMBU,GATUNDU NORTH,2,1135,1098,2233
KIAMBU,GATUNDU NORTH,3,1145,1167,2312
KIAMBU,GATUNDU NORTH,4,1213,1165,2378
KIAMBU,GATUNDU NORTH,0 - 4,5805,5645,11450
KIAMBU,GATUNDU NORTH,5,1150,1044,2194
KIAMBU,GATUNDU NORTH,6,1098,1187,2285
KIAMBU,GATUNDU NORTH,7,1194,1203,2397
KIAMBU,GATUNDU NORTH,8,1090,1085,2175
KIAMBU,GATUNDU NORTH,9,1286,1268,2554
KIAMBU,GATUNDU NORTH,05-Sep,5818,5787,11605
KIAMBU,GATUNDU NORTH,10,1226,1180,2406
KIAMBU,GATUNDU NORTH,11,1147,1178,2325
KIAMBU,GATUNDU NORTH,12,1244,1222,2466
KIAMBU,GATUNDU NORTH,13,1304,1314,2618
KIAMBU,GATUNDU NORTH,14,1234,1182,2416
KIAMBU,GATUNDU NORTH,Oct-14,6155,6076,12231
KIAMBU,GATUNDU NORTH,15,1228,1204,2432
KIAMBU,GATUNDU NORTH,16,1236,1270,2506
KIAMBU,GATUNDU NORTH,17,1404,1174,2578
KIAMBU,GATUNDU NORTH,18,1038,955,1993
KIAMBU,GATUNDU NORTH,19,1079,922,2001
KIAMBU,GATUNDU NORTH,15-19,5985,5525,11510
KIAMBU,GATUNDU NORTH,20,936,825,1761
KIAMBU,GATUNDU NORTH,21,857,770,1627
KIAMBU,GATUNDU NORTH,22,799,802,1601
KIAMBU,GATUNDU NORTH,23,801,781,1582
KIAMBU,GATUNDU NORTH,24,698,704,1402
KIAMBU,GATUNDU NORTH,20-24,4091,3882,7973
KIAMBU,GATUNDU NORTH,25,659,723,1382
KIAMBU,GATUNDU NORTH,26,616,615,1231
KIAMBU,GATUNDU NORTH,27,683,664,1347
KIAMBU,GATUNDU NORTH,28,641,651,1292
KIAMBU,GATUNDU NORTH,29,702,761,1463
KIAMBU,GATUNDU NORTH,25-29,3301,3414,6715
KIAMBU,GATUNDU NORTH,30,816,906,1722
KIAMBU,GATUNDU NORTH,31,595,622,1217
KIAMBU,GATUNDU NORTH,32,796,859,1655
KIAMBU,GATUNDU NORTH,33,699,763,1462
KIAMBU,GATUNDU NORTH,34,662,706,1368
KIAMBU,GATUNDU NORTH,30-34,3568,3856,7424
KIAMBU,GATUNDU NORTH,35,850,897,1747
KIAMBU,GATUNDU NORTH,36,689,716,1405
KIAMBU,GATUNDU NORTH,37,745,719,1464
KIAMBU,GATUNDU NORTH,38,595,667,1262
KIAMBU,GATUNDU NORTH,39,693,711,1404
KIAMBU,GATUNDU NORTH,35-39,3572,3710,7282
KIAMBU,GATUNDU NORTH,40,748,849,1597
KIAMBU,GATUNDU NORTH,41,699,669,1368
KIAMBU,GATUNDU NORTH,42,654,715,1369
KIAMBU,GATUNDU NORTH,43,674,636,1310
KIAMBU,GATUNDU NORTH,44,547,554,1101
KIAMBU,GATUNDU NORTH,40-44,3322,3423,6745
KIAMBU,GATUNDU NORTH,45,762,776,1538
KIAMBU,GATUNDU NORTH,46,613,628,1241
KIAMBU,GATUNDU NORTH,47,642,627,1269
KIAMBU,GATUNDU NORTH,48,447,434,881
KIAMBU,GATUNDU NORTH,49,533,540,1073
KIAMBU,GATUNDU NORTH,45-49,2997,3005,6002
KIAMBU,GATUNDU NORTH,50,580,684,1264
KIAMBU,GATUNDU NORTH,51,481,517,998
KIAMBU,GATUNDU NORTH,52,564,590,1154
KIAMBU,GATUNDU NORTH,53,367,354,721
KIAMBU,GATUNDU NORTH,54,412,447,859
KIAMBU,GATUNDU NORTH,50-54,2404,2592,4996
KIAMBU,GATUNDU NORTH,55,490,437,927
KIAMBU,GATUNDU NORTH,56,508,496,1004
KIAMBU,GATUNDU NORTH,57,409,511,920
KIAMBU,GATUNDU NORTH,58,319,371,690
KIAMBU,GATUNDU NORTH,59,362,391,753
KIAMBU,GATUNDU NORTH,55-59,2088,2206,4294
KIAMBU,GATUNDU NORTH,60,403,445,848
KIAMBU,GATUNDU NORTH,61,304,363,667
KIAMBU,GATUNDU NORTH,62,284,311,595
KIAMBU,GATUNDU NORTH,63,276,257,533
KIAMBU,GATUNDU NORTH,64,201,234,435
KIAMBU,GATUNDU NORTH,60-64,1468,1610,3078
KIAMBU,GATUNDU NORTH,65,330,314,644
KIAMBU,GATUNDU NORTH,66,229,223,452
KIAMBU,GATUNDU NORTH,67,367,403,770
KIAMBU,GATUNDU NORTH,68,152,178,330
KIAMBU,GATUNDU NORTH,69,214,290,504
KIAMBU,GATUNDU NORTH,65-69,1292,1408,2700
KIAMBU,GATUNDU NORTH,70,315,388,703
KIAMBU,GATUNDU NORTH,71,233,238,471
KIAMBU,GATUNDU NORTH,72,202,176,378
KIAMBU,GATUNDU NORTH,73,167,190,357
KIAMBU,GATUNDU NORTH,74,166,188,354
KIAMBU,GATUNDU NORTH,70-74,1083,1180,2263
KIAMBU,GATUNDU NORTH,75,141,195,336
KIAMBU,GATUNDU NORTH,76,145,261,406
KIAMBU,GATUNDU NORTH,77,106,160,266
KIAMBU,GATUNDU NORTH,78,76,104,180
KIAMBU,GATUNDU NORTH,79,85,153,238
KIAMBU,GATUNDU NORTH,75-79,553,873,1426
KIAMBU,GATUNDU NORTH,80,95,229,324
KIAMBU,GATUNDU NORTH,81,57,107,164
KIAMBU,GATUNDU NORTH,82,53,93,146
KIAMBU,GATUNDU NORTH,83,78,121,199
KIAMBU,GATUNDU NORTH,84,72,119,191
KIAMBU,GATUNDU NORTH,80-84,355,669,1024
KIAMBU,GATUNDU NORTH,85,50,128,178
KIAMBU,GATUNDU NORTH,86,41,94,135
KIAMBU,GATUNDU NORTH,87,56,44,100
KIAMBU,GATUNDU NORTH,88,24,51,75
KIAMBU,GATUNDU NORTH,89,42,112,154
KIAMBU,GATUNDU NORTH,85-89,213,429,642
KIAMBU,GATUNDU NORTH,90,28,61,89
KIAMBU,GATUNDU NORTH,91,14,33,47
KIAMBU,GATUNDU NORTH,92,15,30,45
KIAMBU,GATUNDU NORTH,93,12,43,55
KIAMBU,GATUNDU NORTH,94,4,30,34
KIAMBU,GATUNDU NORTH,90-94,73,197,270
KIAMBU,GATUNDU NORTH,95,13,28,41
KIAMBU,GATUNDU NORTH,96,4,27,31
KIAMBU,GATUNDU NORTH,97,11,21,32
KIAMBU,GATUNDU NORTH,98,3,15,18
KIAMBU,GATUNDU NORTH,99,2,34,36
KIAMBU,GATUNDU NORTH,95-99,33,125,158
KIAMBU,GATUNDU NORTH,100+,12,66,78
KIAMBU,GATUNDU NORTH,Not Stated,1,-,1
KIAMBU,GATUNDU SOUTH,Total,60384,61714,122098
KIAMBU,GATUNDU SOUTH,0,1170,1218,2388
KIAMBU,GATUNDU SOUTH,1,1192,1192,2384
KIAMBU,GATUNDU SOUTH,2,1184,1176,2360
KIAMBU,GATUNDU SOUTH,3,1197,1237,2434
KIAMBU,GATUNDU SOUTH,4,1338,1246,2584
KIAMBU,GATUNDU SOUTH,0 - 4,6081,6069,12150
KIAMBU,GATUNDU SOUTH,5,1199,1175,2374
KIAMBU,GATUNDU SOUTH,6,1213,1180,2393
KIAMBU,GATUNDU SOUTH,7,1315,1276,2591
KIAMBU,GATUNDU SOUTH,8,1247,1194,2441
KIAMBU,GATUNDU SOUTH,9,1356,1307,2663
KIAMBU,GATUNDU SOUTH,05-Sep,6330,6132,12462
KIAMBU,GATUNDU SOUTH,10,1352,1304,2656
KIAMBU,GATUNDU SOUTH,11,1207,1206,2413
KIAMBU,GATUNDU SOUTH,12,1381,1362,2743
KIAMBU,GATUNDU SOUTH,13,1428,1347,2775
KIAMBU,GATUNDU SOUTH,14,1372,1324,2696
KIAMBU,GATUNDU SOUTH,Oct-14,6740,6543,13283
KIAMBU,GATUNDU SOUTH,15,1385,1328,2713
KIAMBU,GATUNDU SOUTH,16,1370,1343,2713
KIAMBU,GATUNDU SOUTH,17,1490,1313,2803
KIAMBU,GATUNDU SOUTH,18,1227,1044,2271
KIAMBU,GATUNDU SOUTH,19,1182,1101,2283
KIAMBU,GATUNDU SOUTH,15-19,6654,6129,12783
KIAMBU,GATUNDU SOUTH,20,1095,982,2077
KIAMBU,GATUNDU SOUTH,21,1013,882,1895
KIAMBU,GATUNDU SOUTH,22,944,867,1811
KIAMBU,GATUNDU SOUTH,23,951,908,1859
KIAMBU,GATUNDU SOUTH,24,858,797,1655
KIAMBU,GATUNDU SOUTH,20-24,4861,4436,9297
KIAMBU,GATUNDU SOUTH,25,857,756,1613
KIAMBU,GATUNDU SOUTH,26,726,701,1427
KIAMBU,GATUNDU SOUTH,27,745,686,1431
KIAMBU,GATUNDU SOUTH,28,655,706,1361
KIAMBU,GATUNDU SOUTH,29,709,793,1502
KIAMBU,GATUNDU SOUTH,25-29,3692,3642,7334
KIAMBU,GATUNDU SOUTH,30,889,945,1834
KIAMBU,GATUNDU SOUTH,31,675,787,1462
KIAMBU,GATUNDU SOUTH,32,854,862,1716
KIAMBU,GATUNDU SOUTH,33,769,821,1590
KIAMBU,GATUNDU SOUTH,34,785,766,1551
KIAMBU,GATUNDU SOUTH,30-34,3972,4181,8153
KIAMBU,GATUNDU SOUTH,35,956,992,1948
KIAMBU,GATUNDU SOUTH,36,720,858,1578
KIAMBU,GATUNDU SOUTH,37,814,768,1582
KIAMBU,GATUNDU SOUTH,38,731,710,1441
KIAMBU,GATUNDU SOUTH,39,783,795,1578
KIAMBU,GATUNDU SOUTH,35-39,4004,4123,8127
KIAMBU,GATUNDU SOUTH,40,853,973,1826
KIAMBU,GATUNDU SOUTH,41,831,809,1640
KIAMBU,GATUNDU SOUTH,42,735,783,1518
KIAMBU,GATUNDU SOUTH,43,717,736,1453
KIAMBU,GATUNDU SOUTH,44,591,593,1184
KIAMBU,GATUNDU SOUTH,40-44,3727,3894,7621
KIAMBU,GATUNDU SOUTH,45,847,798,1645
KIAMBU,GATUNDU SOUTH,46,717,743,1460
KIAMBU,GATUNDU SOUTH,47,715,713,1428
KIAMBU,GATUNDU SOUTH,48,512,560,1072
KIAMBU,GATUNDU SOUTH,49,567,610,1177
KIAMBU,GATUNDU SOUTH,45-49,3358,3424,6782
KIAMBU,GATUNDU SOUTH,50,607,755,1362
KIAMBU,GATUNDU SOUTH,51,525,561,1086
KIAMBU,GATUNDU SOUTH,52,559,607,1166
KIAMBU,GATUNDU SOUTH,53,389,425,814
KIAMBU,GATUNDU SOUTH,54,524,555,1079
KIAMBU,GATUNDU SOUTH,50-54,2604,2903,5507
KIAMBU,GATUNDU SOUTH,55,541,503,1044
KIAMBU,GATUNDU SOUTH,56,613,585,1198
KIAMBU,GATUNDU SOUTH,57,454,537,991
KIAMBU,GATUNDU SOUTH,58,377,439,816
KIAMBU,GATUNDU SOUTH,59,406,488,894
KIAMBU,GATUNDU SOUTH,55-59,2391,2552,4943
KIAMBU,GATUNDU SOUTH,60,468,507,975
KIAMBU,GATUNDU SOUTH,61,381,475,856
KIAMBU,GATUNDU SOUTH,62,353,338,691
KIAMBU,GATUNDU SOUTH,63,331,321,652
KIAMBU,GATUNDU SOUTH,64,234,283,517
KIAMBU,GATUNDU SOUTH,60-64,1767,1924,3691
KIAMBU,GATUNDU SOUTH,65,367,386,753
KIAMBU,GATUNDU SOUTH,66,267,273,540
KIAMBU,GATUNDU SOUTH,67,413,503,916
KIAMBU,GATUNDU SOUTH,68,173,197,370
KIAMBU,GATUNDU SOUTH,69,263,275,538
KIAMBU,GATUNDU SOUTH,65-69,1483,1634,3117
KIAMBU,GATUNDU SOUTH,70,334,474,808
KIAMBU,GATUNDU SOUTH,71,272,284,556
KIAMBU,GATUNDU SOUTH,72,244,232,476
KIAMBU,GATUNDU SOUTH,73,224,225,449
KIAMBU,GATUNDU SOUTH,74,183,210,393
KIAMBU,GATUNDU SOUTH,70-74,1257,1425,2682
KIAMBU,GATUNDU SOUTH,75,152,238,390
KIAMBU,GATUNDU SOUTH,76,169,363,532
KIAMBU,GATUNDU SOUTH,77,147,197,344
KIAMBU,GATUNDU SOUTH,78,75,133,208
KIAMBU,GATUNDU SOUTH,79,99,187,286
KIAMBU,GATUNDU SOUTH,75-79,642,1118,1760
KIAMBU,GATUNDU SOUTH,80,133,290,423
KIAMBU,GATUNDU SOUTH,81,76,127,203
KIAMBU,GATUNDU SOUTH,82,61,80,141
KIAMBU,GATUNDU SOUTH,83,103,96,199
KIAMBU,GATUNDU SOUTH,84,56,120,176
KIAMBU,GATUNDU SOUTH,80-84,429,713,1142
KIAMBU,GATUNDU SOUTH,85,62,128,190
KIAMBU,GATUNDU SOUTH,86,49,95,144
KIAMBU,GATUNDU SOUTH,87,49,60,109
KIAMBU,GATUNDU SOUTH,88,24,52,76
KIAMBU,GATUNDU SOUTH,89,54,119,173
KIAMBU,GATUNDU SOUTH,85-89,238,454,692
KIAMBU,GATUNDU SOUTH,90,24,70,94
KIAMBU,GATUNDU SOUTH,91,23,45,68
KIAMBU,GATUNDU SOUTH,92,16,35,51
KIAMBU,GATUNDU SOUTH,93,11,31,42
KIAMBU,GATUNDU SOUTH,94,5,29,34
KIAMBU,GATUNDU SOUTH,90-94,79,210,289
KIAMBU,GATUNDU SOUTH,95,10,31,41
KIAMBU,GATUNDU SOUTH,96,11,23,34
KIAMBU,GATUNDU SOUTH,97,20,22,42
KIAMBU,GATUNDU SOUTH,98,6,13,19
KIAMBU,GATUNDU SOUTH,99,8,44,52
KIAMBU,GATUNDU SOUTH,95-99,55,133,188
KIAMBU,GATUNDU SOUTH,100+,16,72,88
KIAMBU,GATUNDU SOUTH,Not Stated,4,3,7
KIAMBU,GITHUNGURI,Total,82037,83187,165224
KIAMBU,GITHUNGURI,0,1629,1647,3276
KIAMBU,GITHUNGURI,1,1622,1605,3227
KIAMBU,GITHUNGURI,2,1723,1670,3393
KIAMBU,GITHUNGURI,3,1739,1715,3454
KIAMBU,GITHUNGURI,4,1703,1693,3396
KIAMBU,GITHUNGURI,0 - 4,8416,8330,16746
KIAMBU,GITHUNGURI,5,1557,1546,3103
KIAMBU,GITHUNGURI,6,1597,1607,3204
KIAMBU,GITHUNGURI,7,1708,1634,3342
KIAMBU,GITHUNGURI,8,1634,1582,3216
KIAMBU,GITHUNGURI,9,1812,1881,3693
KIAMBU,GITHUNGURI,05-Sep,8308,8250,16558
KIAMBU,GITHUNGURI,10,1798,1788,3586
KIAMBU,GITHUNGURI,11,1640,1598,3238
KIAMBU,GITHUNGURI,12,1850,1812,3662
KIAMBU,GITHUNGURI,13,1861,1804,3665
KIAMBU,GITHUNGURI,14,1709,1712,3421
KIAMBU,GITHUNGURI,Oct-14,8858,8714,17572
KIAMBU,GITHUNGURI,15,1785,1674,3459
KIAMBU,GITHUNGURI,16,1684,1655,3339
KIAMBU,GITHUNGURI,17,1833,1629,3462
KIAMBU,GITHUNGURI,18,1526,1412,2938
KIAMBU,GITHUNGURI,19,1573,1448,3021
KIAMBU,GITHUNGURI,15-19,8401,7818,16219
KIAMBU,GITHUNGURI,20,1356,1343,2699
KIAMBU,GITHUNGURI,21,1427,1360,2787
KIAMBU,GITHUNGURI,22,1348,1288,2636
KIAMBU,GITHUNGURI,23,1448,1305,2753
KIAMBU,GITHUNGURI,24,1308,1211,2519
KIAMBU,GITHUNGURI,20-24,6887,6507,13394
KIAMBU,GITHUNGURI,25,1287,1210,2497
KIAMBU,GITHUNGURI,26,1095,1069,2164
KIAMBU,GITHUNGURI,27,1211,1053,2264
KIAMBU,GITHUNGURI,28,1045,1021,2066
KIAMBU,GITHUNGURI,29,1151,1152,2303
KIAMBU,GITHUNGURI,25-29,5789,5505,11294
KIAMBU,GITHUNGURI,30,1332,1369,2701
KIAMBU,GITHUNGURI,31,1043,1048,2091
KIAMBU,GITHUNGURI,32,1297,1337,2634
KIAMBU,GITHUNGURI,33,1035,1187,2222
KIAMBU,GITHUNGURI,34,1054,1180,2234
KIAMBU,GITHUNGURI,30-34,5761,6121,11882
KIAMBU,GITHUNGURI,35,1320,1423,2743
KIAMBU,GITHUNGURI,36,1052,1078,2130
KIAMBU,GITHUNGURI,37,1162,1159,2321
KIAMBU,GITHUNGURI,38,1027,1116,2143
KIAMBU,GITHUNGURI,39,1131,1211,2342
KIAMBU,GITHUNGURI,35-39,5692,5987,11679
KIAMBU,GITHUNGURI,40,1282,1269,2551
KIAMBU,GITHUNGURI,41,1051,1054,2105
KIAMBU,GITHUNGURI,42,1104,1056,2160
KIAMBU,GITHUNGURI,43,958,1014,1972
KIAMBU,GITHUNGURI,44,832,807,1639
KIAMBU,GITHUNGURI,40-44,5227,5200,10427
KIAMBU,GITHUNGURI,45,1174,1120,2294
KIAMBU,GITHUNGURI,46,963,898,1861
KIAMBU,GITHUNGURI,47,883,964,1847
KIAMBU,GITHUNGURI,48,753,775,1528
KIAMBU,GITHUNGURI,49,826,812,1638
KIAMBU,GITHUNGURI,45-49,4599,4569,9168
KIAMBU,GITHUNGURI,50,920,984,1904
KIAMBU,GITHUNGURI,51,718,694,1412
KIAMBU,GITHUNGURI,52,828,813,1641
KIAMBU,GITHUNGURI,53,547,538,1085
KIAMBU,GITHUNGURI,54,715,698,1413
KIAMBU,GITHUNGURI,50-54,3728,3727,7455
KIAMBU,GITHUNGURI,55,712,758,1470
KIAMBU,GITHUNGURI,56,708,719,1427
KIAMBU,GITHUNGURI,57,614,699,1313
KIAMBU,GITHUNGURI,58,518,487,1005
KIAMBU,GITHUNGURI,59,500,574,1074
KIAMBU,GITHUNGURI,55-59,3052,3237,6289
KIAMBU,GITHUNGURI,60,621,619,1240
KIAMBU,GITHUNGURI,61,507,521,1028
KIAMBU,GITHUNGURI,62,459,434,893
KIAMBU,GITHUNGURI,63,376,409,785
KIAMBU,GITHUNGURI,64,273,315,588
KIAMBU,GITHUNGURI,60-64,2236,2298,4534
KIAMBU,GITHUNGURI,65,440,457,897
KIAMBU,GITHUNGURI,66,312,343,655
KIAMBU,GITHUNGURI,67,502,564,1066
KIAMBU,GITHUNGURI,68,204,258,462
KIAMBU,GITHUNGURI,69,363,369,732
KIAMBU,GITHUNGURI,65-69,1821,1991,3812
KIAMBU,GITHUNGURI,70,402,507,909
KIAMBU,GITHUNGURI,71,272,350,622
KIAMBU,GITHUNGURI,72,314,296,610
KIAMBU,GITHUNGURI,73,250,278,528
KIAMBU,GITHUNGURI,74,225,270,495
KIAMBU,GITHUNGURI,70-74,1463,1701,3164
KIAMBU,GITHUNGURI,75,176,293,469
KIAMBU,GITHUNGURI,76,216,357,573
KIAMBU,GITHUNGURI,77,167,243,410
KIAMBU,GITHUNGURI,78,107,149,256
KIAMBU,GITHUNGURI,79,113,201,314
KIAMBU,GITHUNGURI,75-79,779,1243,2022
KIAMBU,GITHUNGURI,80,148,320,468
KIAMBU,GITHUNGURI,81,89,130,219
KIAMBU,GITHUNGURI,82,95,114,209
KIAMBU,GITHUNGURI,83,101,148,249
KIAMBU,GITHUNGURI,84,122,156,278
KIAMBU,GITHUNGURI,80-84,555,868,1423
KIAMBU,GITHUNGURI,85,61,163,224
KIAMBU,GITHUNGURI,86,59,105,164
KIAMBU,GITHUNGURI,87,61,102,163
KIAMBU,GITHUNGURI,88,38,56,94
KIAMBU,GITHUNGURI,89,51,130,181
KIAMBU,GITHUNGURI,85-89,270,556,826
KIAMBU,GITHUNGURI,90,30,92,122
KIAMBU,GITHUNGURI,91,43,58,101
KIAMBU,GITHUNGURI,92,23,43,66
KIAMBU,GITHUNGURI,93,20,29,49
KIAMBU,GITHUNGURI,94,9,41,50
KIAMBU,GITHUNGURI,90-94,125,263,388
KIAMBU,GITHUNGURI,95,17,55,72
KIAMBU,GITHUNGURI,96,11,40,51
KIAMBU,GITHUNGURI,97,15,45,60
KIAMBU,GITHUNGURI,98,6,21,27
KIAMBU,GITHUNGURI,99,9,35,44
KIAMBU,GITHUNGURI,95-99,58,196,254
KIAMBU,GITHUNGURI,100+,9,104,113
KIAMBU,GITHUNGURI,Not Stated,3,2,5
KIAMBU,JUJA,Total,148446,152480,300926
KIAMBU,JUJA,0,3923,3880,7803
KIAMBU,JUJA,1,3767,3780,7547
KIAMBU,JUJA,2,3574,3606,7180
KIAMBU,JUJA,3,3554,3491,7045
KIAMBU,JUJA,4,3322,3295,6617
KIAMBU,JUJA,0 - 4,18140,18052,36192
KIAMBU,JUJA,5,3205,3096,6301
KIAMBU,JUJA,6,3103,3069,6172
KIAMBU,JUJA,7,3138,3030,6168
KIAMBU,JUJA,8,2850,2996,5846
KIAMBU,JUJA,9,3086,3092,6178
KIAMBU,JUJA,05-Sep,15382,15283,30665
KIAMBU,JUJA,10,2902,2828,5730
KIAMBU,JUJA,11,2659,2697,5356
KIAMBU,JUJA,12,2686,2758,5444
KIAMBU,JUJA,13,2746,2781,5527
KIAMBU,JUJA,14,2515,2563,5078
KIAMBU,JUJA,Oct-14,13508,13627,27135
KIAMBU,JUJA,15,2388,2533,4921
KIAMBU,JUJA,16,2342,2542,4884
KIAMBU,JUJA,17,2362,2634,4996
KIAMBU,JUJA,18,2102,2600,4702
KIAMBU,JUJA,19,2553,3466,6019
KIAMBU,JUJA,15-19,11747,13775,25522
KIAMBU,JUJA,20,3000,4020,7020
KIAMBU,JUJA,21,3392,4227,7619
KIAMBU,JUJA,22,3765,4562,8327
KIAMBU,JUJA,23,4366,4815,9181
KIAMBU,JUJA,24,4141,4283,8424
KIAMBU,JUJA,20-24,18664,21907,40571
KIAMBU,JUJA,25,4117,4215,8332
KIAMBU,JUJA,26,3741,3635,7376
KIAMBU,JUJA,27,3573,3505,7078
KIAMBU,JUJA,28,3139,3171,6310
KIAMBU,JUJA,29,3310,3245,6555
KIAMBU,JUJA,25-29,17880,17771,35651
KIAMBU,JUJA,30,3544,3677,7221
KIAMBU,JUJA,31,2525,2558,5083
KIAMBU,JUJA,32,3171,3204,6375
KIAMBU,JUJA,33,2563,2673,5236
KIAMBU,JUJA,34,2409,2522,4931
KIAMBU,JUJA,30-34,14212,14634,28846
KIAMBU,JUJA,35,2937,2880,5817
KIAMBU,JUJA,36,2111,2312,4423
KIAMBU,JUJA,37,2113,2173,4286
KIAMBU,JUJA,38,1941,2026,3967
KIAMBU,JUJA,39,2034,2014,4048
KIAMBU,JUJA,35-39,11136,11405,22541
KIAMBU,JUJA,40,2411,2171,4582
KIAMBU,JUJA,41,1950,1863,3813
KIAMBU,JUJA,42,1913,1652,3565
KIAMBU,JUJA,43,1617,1557,3174
KIAMBU,JUJA,44,1317,1271,2588
KIAMBU,JUJA,40-44,9208,8514,17722
KIAMBU,JUJA,45,1890,1670,3560
KIAMBU,JUJA,46,1381,1290,2671
KIAMBU,JUJA,47,1475,1215,2690
KIAMBU,JUJA,48,1151,1020,2171
KIAMBU,JUJA,49,1139,1057,2196
KIAMBU,JUJA,45-49,7036,6252,13288
KIAMBU,JUJA,50,1322,1162,2484
KIAMBU,JUJA,51,902,865,1767
KIAMBU,JUJA,52,1012,822,1834
KIAMBU,JUJA,53,736,653,1389
KIAMBU,JUJA,54,782,725,1507
KIAMBU,JUJA,50-54,4754,4227,8981
KIAMBU,JUJA,55,818,607,1425
KIAMBU,JUJA,56,783,664,1447
KIAMBU,JUJA,57,596,592,1188
KIAMBU,JUJA,58,469,415,884
KIAMBU,JUJA,59,463,441,904
KIAMBU,JUJA,55-59,3129,2719,5848
KIAMBU,JUJA,60,506,491,997
KIAMBU,JUJA,61,337,327,664
KIAMBU,JUJA,62,299,286,585
KIAMBU,JUJA,63,280,224,504
KIAMBU,JUJA,64,191,188,379
KIAMBU,JUJA,60-64,1613,1516,3129
KIAMBU,JUJA,65,237,283,520
KIAMBU,JUJA,66,152,194,346
KIAMBU,JUJA,67,241,294,535
KIAMBU,JUJA,68,139,146,285
KIAMBU,JUJA,69,170,169,339
KIAMBU,JUJA,65-69,939,1086,2025
KIAMBU,JUJA,70,172,237,409
KIAMBU,JUJA,71,113,139,252
KIAMBU,JUJA,72,135,131,266
KIAMBU,JUJA,73,100,99,199
KIAMBU,JUJA,74,72,92,164
KIAMBU,JUJA,70-74,592,698,1290
KIAMBU,JUJA,75,67,95,162
KIAMBU,JUJA,76,49,117,166
KIAMBU,JUJA,77,54,83,137
KIAMBU,JUJA,78,41,54,95
KIAMBU,JUJA,79,34,65,99
KIAMBU,JUJA,75-79,245,414,659
KIAMBU,JUJA,80,46,76,122
KIAMBU,JUJA,81,19,45,64
KIAMBU,JUJA,82,30,38,68
KIAMBU,JUJA,83,21,35,56
KIAMBU,JUJA,84,25,47,72
KIAMBU,JUJA,80-84,141,241,382
KIAMBU,JUJA,85,18,52,70
KIAMBU,JUJA,86,24,30,54
KIAMBU,JUJA,87,16,29,45
KIAMBU,JUJA,88,6,14,20
KIAMBU,JUJA,89,9,48,57
KIAMBU,JUJA,85-89,73,173,246
KIAMBU,JUJA,90,8,40,48
KIAMBU,JUJA,91,9,18,27
KIAMBU,JUJA,92,-,24,24
KIAMBU,JUJA,93,5,10,15
KIAMBU,JUJA,94,4,16,20
KIAMBU,JUJA,90-94,26,108,134
KIAMBU,JUJA,95,-,13,13
KIAMBU,JUJA,96,3,8,11
KIAMBU,JUJA,97,6,9,15
KIAMBU,JUJA,98,1,7,8
KIAMBU,JUJA,99,1,11,12
KIAMBU,JUJA,95-99,11,48,59
KIAMBU,JUJA,100+,7,29,36
KIAMBU,JUJA,Not Stated,3,1,4
KIAMBU,KABETE,Total,97794,101845,199639
KIAMBU,KABETE,0,2509,2492,5001
KIAMBU,KABETE,1,2459,2431,4890
KIAMBU,KABETE,2,2354,2202,4556
KIAMBU,KABETE,3,2269,2138,4407
KIAMBU,KABETE,4,2080,2020,4100
KIAMBU,KABETE,0 - 4,11671,11283,22954
KIAMBU,KABETE,5,1932,1962,3894
KIAMBU,KABETE,6,1919,1941,3860
KIAMBU,KABETE,7,1920,1854,3774
KIAMBU,KABETE,8,1786,1907,3693
KIAMBU,KABETE,9,1977,1992,3969
KIAMBU,KABETE,05-Sep,9534,9656,19190
KIAMBU,KABETE,10,1858,1797,3655
KIAMBU,KABETE,11,1645,1760,3405
KIAMBU,KABETE,12,1859,1796,3655
KIAMBU,KABETE,13,1844,1831,3675
KIAMBU,KABETE,14,1747,1742,3489
KIAMBU,KABETE,Oct-14,8953,8926,17879
KIAMBU,KABETE,15,1621,1614,3235
KIAMBU,KABETE,16,1585,1674,3259
KIAMBU,KABETE,17,1583,1792,3375
KIAMBU,KABETE,18,1388,1612,3000
KIAMBU,KABETE,19,1692,1979,3671
KIAMBU,KABETE,15-19,7869,8671,16540
KIAMBU,KABETE,20,1628,2124,3752
KIAMBU,KABETE,21,1883,2219,4102
KIAMBU,KABETE,22,1860,2313,4173
KIAMBU,KABETE,23,2197,2682,4879
KIAMBU,KABETE,24,2292,2472,4764
KIAMBU,KABETE,20-24,9860,11810,21670
KIAMBU,KABETE,25,2331,2548,4879
KIAMBU,KABETE,26,2097,2482,4579
KIAMBU,KABETE,27,2323,2330,4653
KIAMBU,KABETE,28,1976,2087,4063
KIAMBU,KABETE,29,2191,2298,4489
KIAMBU,KABETE,25-29,10918,11745,22663
KIAMBU,KABETE,30,2380,2578,4958
KIAMBU,KABETE,31,1832,1811,3643
KIAMBU,KABETE,32,2063,2252,4315
KIAMBU,KABETE,33,1711,1851,3562
KIAMBU,KABETE,34,1682,1752,3434
KIAMBU,KABETE,30-34,9668,10244,19912
KIAMBU,KABETE,35,1943,1927,3870
KIAMBU,KABETE,36,1442,1567,3009
KIAMBU,KABETE,37,1485,1500,2985
KIAMBU,KABETE,38,1274,1315,2589
KIAMBU,KABETE,39,1424,1403,2827
KIAMBU,KABETE,35-39,7568,7712,15280
KIAMBU,KABETE,40,1553,1498,3051
KIAMBU,KABETE,41,1267,1221,2488
KIAMBU,KABETE,42,1258,1234,2492
KIAMBU,KABETE,43,1067,1064,2131
KIAMBU,KABETE,44,879,883,1762
KIAMBU,KABETE,40-44,6024,5900,11924
KIAMBU,KABETE,45,1342,1158,2500
KIAMBU,KABETE,46,957,946,1903
KIAMBU,KABETE,47,980,923,1903
KIAMBU,KABETE,48,820,735,1555
KIAMBU,KABETE,49,859,834,1693
KIAMBU,KABETE,45-49,4958,4596,9554
KIAMBU,KABETE,50,928,941,1869
KIAMBU,KABETE,51,720,626,1346
KIAMBU,KABETE,52,781,778,1559
KIAMBU,KABETE,53,531,565,1096
KIAMBU,KABETE,54,651,555,1206
KIAMBU,KABETE,50-54,3611,3465,7076
KIAMBU,KABETE,55,608,524,1132
KIAMBU,KABETE,56,614,578,1192
KIAMBU,KABETE,57,473,452,925
KIAMBU,KABETE,58,411,398,809
KIAMBU,KABETE,59,454,408,862
KIAMBU,KABETE,55-59,2560,2360,4920
KIAMBU,KABETE,60,455,454,909
KIAMBU,KABETE,61,347,364,711
KIAMBU,KABETE,62,303,308,611
KIAMBU,KABETE,63,265,256,521
KIAMBU,KABETE,64,191,189,380
KIAMBU,KABETE,60-64,1561,1571,3132
KIAMBU,KABETE,65,284,306,590
KIAMBU,KABETE,66,193,210,403
KIAMBU,KABETE,67,321,372,693
KIAMBU,KABETE,68,161,151,312
KIAMBU,KABETE,69,215,221,436
KIAMBU,KABETE,65-69,1174,1260,2434
KIAMBU,KABETE,70,261,325,586
KIAMBU,KABETE,71,181,210,391
KIAMBU,KABETE,72,183,204,387
KIAMBU,KABETE,73,161,169,330
KIAMBU,KABETE,74,137,157,294
KIAMBU,KABETE,70-74,923,1065,1988
KIAMBU,KABETE,75,111,141,252
KIAMBU,KABETE,76,129,186,315
KIAMBU,KABETE,77,83,114,197
KIAMBU,KABETE,78,56,64,120
KIAMBU,KABETE,79,64,115,179
KIAMBU,KABETE,75-79,443,620,1063
KIAMBU,KABETE,80,93,174,267
KIAMBU,KABETE,81,44,76,120
KIAMBU,KABETE,82,45,66,111
KIAMBU,KABETE,83,51,69,120
KIAMBU,KABETE,84,37,67,104
KIAMBU,KABETE,80-84,270,452,722
KIAMBU,KABETE,85,39,90,129
KIAMBU,KABETE,86,30,44,74
KIAMBU,KABETE,87,37,59,96
KIAMBU,KABETE,88,10,27,37
KIAMBU,KABETE,89,27,56,83
KIAMBU,KABETE,85-89,143,276,419
KIAMBU,KABETE,90,13,44,57
KIAMBU,KABETE,91,11,23,34
KIAMBU,KABETE,92,10,25,35
KIAMBU,KABETE,93,9,20,29
KIAMBU,KABETE,94,7,10,17
KIAMBU,KABETE,90-94,50,122,172
KIAMBU,KABETE,95,10,25,35
KIAMBU,KABETE,96,7,16,23
KIAMBU,KABETE,97,6,19,25
KIAMBU,KABETE,98,2,5,7
KIAMBU,KABETE,99,4,12,16
KIAMBU,KABETE,95-99,29,77,106
KIAMBU,KABETE,100+,5,33,38
KIAMBU,KABETE,Not Stated,2,1,3
KIAMBU,KIAMBAA,Total,115690,120695,236385
KIAMBU,KIAMBAA,0,3001,2955,5956
KIAMBU,KIAMBAA,1,3035,3042,6077
KIAMBU,KIAMBAA,2,2826,2838,5664
KIAMBU,KIAMBAA,3,2759,2820,5579
KIAMBU,KIAMBAA,4,2682,2485,5167
KIAMBU,KIAMBAA,0 - 4,14303,14140,28443
KIAMBU,KIAMBAA,5,2347,2432,4779
KIAMBU,KIAMBAA,6,2395,2341,4736
KIAMBU,KIAMBAA,7,2253,2285,4538
KIAMBU,KIAMBAA,8,2156,2249,4405
KIAMBU,KIAMBAA,9,2226,2392,4618
KIAMBU,KIAMBAA,05-Sep,11377,11699,23076
KIAMBU,KIAMBAA,10,2192,2241,4433
KIAMBU,KIAMBAA,11,1974,1983,3957
KIAMBU,KIAMBAA,12,2139,2124,4263
KIAMBU,KIAMBAA,13,2056,2088,4144
KIAMBU,KIAMBAA,14,1866,2014,3880
KIAMBU,KIAMBAA,Oct-14,10227,10450,20677
KIAMBU,KIAMBAA,15,1758,1912,3670
KIAMBU,KIAMBAA,16,1714,1868,3582
KIAMBU,KIAMBAA,17,1804,1948,3752
KIAMBU,KIAMBAA,18,1606,1901,3507
KIAMBU,KIAMBAA,19,1919,2279,4198
KIAMBU,KIAMBAA,15-19,8801,9908,18709
KIAMBU,KIAMBAA,20,1826,2520,4346
KIAMBU,KIAMBAA,21,2073,2643,4716
KIAMBU,KIAMBAA,22,2108,2922,5030
KIAMBU,KIAMBAA,23,2502,3236,5738
KIAMBU,KIAMBAA,24,2585,3163,5748
KIAMBU,KIAMBAA,20-24,11094,14484,25578
KIAMBU,KIAMBAA,25,2760,3220,5980
KIAMBU,KIAMBAA,26,2568,3032,5600
KIAMBU,KIAMBAA,27,2636,2977,5613
KIAMBU,KIAMBAA,28,2406,2660,5066
KIAMBU,KIAMBAA,29,2654,2799,5453
KIAMBU,KIAMBAA,25-29,13024,14688,27712
KIAMBU,KIAMBAA,30,3066,3259,6325
KIAMBU,KIAMBAA,31,2316,2364,4680
KIAMBU,KIAMBAA,32,2827,2816,5643
KIAMBU,KIAMBAA,33,2225,2305,4530
KIAMBU,KIAMBAA,34,2282,2182,4464
KIAMBU,KIAMBAA,30-34,12716,12926,25642
KIAMBU,KIAMBAA,35,2588,2408,4996
KIAMBU,KIAMBAA,36,1876,1903,3779
KIAMBU,KIAMBAA,37,1864,1667,3531
KIAMBU,KIAMBAA,38,1679,1616,3295
KIAMBU,KIAMBAA,39,1714,1607,3321
KIAMBU,KIAMBAA,35-39,9721,9201,18922
KIAMBU,KIAMBAA,40,1787,1692,3479
KIAMBU,KIAMBAA,41,1553,1440,2993
KIAMBU,KIAMBAA,42,1559,1393,2952
KIAMBU,KIAMBAA,43,1361,1228,2589
KIAMBU,KIAMBAA,44,1110,1006,2116
KIAMBU,KIAMBAA,40-44,7370,6759,14129
KIAMBU,KIAMBAA,45,1516,1252,2768
KIAMBU,KIAMBAA,46,1163,998,2161
KIAMBU,KIAMBAA,47,1182,1023,2205
KIAMBU,KIAMBAA,48,909,793,1702
KIAMBU,KIAMBAA,49,980,872,1852
KIAMBU,KIAMBAA,45-49,5750,4938,10688
KIAMBU,KIAMBAA,50,1055,921,1976
KIAMBU,KIAMBAA,51,827,641,1468
KIAMBU,KIAMBAA,52,880,709,1589
KIAMBU,KIAMBAA,53,594,554,1148
KIAMBU,KIAMBAA,54,711,570,1281
KIAMBU,KIAMBAA,50-54,4067,3395,7462
KIAMBU,KIAMBAA,55,706,557,1263
KIAMBU,KIAMBAA,56,665,584,1249
KIAMBU,KIAMBAA,57,488,525,1013
KIAMBU,KIAMBAA,58,423,385,808
KIAMBU,KIAMBAA,59,438,415,853
KIAMBU,KIAMBAA,55-59,2720,2466,5186
KIAMBU,KIAMBAA,60,421,450,871
KIAMBU,KIAMBAA,61,358,321,679
KIAMBU,KIAMBAA,62,344,329,673
KIAMBU,KIAMBAA,63,224,245,469
KIAMBU,KIAMBAA,64,189,206,395
KIAMBU,KIAMBAA,60-64,1536,1551,3087
KIAMBU,KIAMBAA,65,298,293,591
KIAMBU,KIAMBAA,66,202,237,439
KIAMBU,KIAMBAA,67,317,373,690
KIAMBU,KIAMBAA,68,133,147,280
KIAMBU,KIAMBAA,69,182,263,445
KIAMBU,KIAMBAA,65-69,1132,1313,2445
KIAMBU,KIAMBAA,70,260,355,615
KIAMBU,KIAMBAA,71,199,206,405
KIAMBU,KIAMBAA,72,187,172,359
KIAMBU,KIAMBAA,73,158,164,322
KIAMBU,KIAMBAA,74,114,151,265
KIAMBU,KIAMBAA,70-74,918,1048,1966
KIAMBU,KIAMBAA,75,119,171,290
KIAMBU,KIAMBAA,76,109,216,325
KIAMBU,KIAMBAA,77,92,142,234
KIAMBU,KIAMBAA,78,53,81,134
KIAMBU,KIAMBAA,79,47,131,178
KIAMBU,KIAMBAA,75-79,420,741,1161
KIAMBU,KIAMBAA,80,87,159,246
KIAMBU,KIAMBAA,81,42,102,144
KIAMBU,KIAMBAA,82,49,71,120
KIAMBU,KIAMBAA,83,50,53,103
KIAMBU,KIAMBAA,84,46,76,122
KIAMBU,KIAMBAA,80-84,274,461,735
KIAMBU,KIAMBAA,85,39,76,115
KIAMBU,KIAMBAA,86,37,63,100
KIAMBU,KIAMBAA,87,24,46,70
KIAMBU,KIAMBAA,88,22,30,52
KIAMBU,KIAMBAA,89,28,52,80
KIAMBU,KIAMBAA,85-89,150,267,417
KIAMBU,KIAMBAA,90,12,36,48
KIAMBU,KIAMBAA,91,13,40,53
KIAMBU,KIAMBAA,92,19,21,40
KIAMBU,KIAMBAA,93,4,18,22
KIAMBU,KIAMBAA,94,5,14,19
KIAMBU,KIAMBAA,90-94,53,129,182
KIAMBU,KIAMBAA,95,9,26,35
KIAMBU,KIAMBAA,96,7,17,24
KIAMBU,KIAMBAA,97,6,13,19
KIAMBU,KIAMBAA,98,2,9,11
KIAMBU,KIAMBAA,99,4,22,26
KIAMBU,KIAMBAA,95-99,28,87,115
KIAMBU,KIAMBAA,100+,6,43,49
KIAMBU,KIAMBAA,Not Stated,3,1,4
KIAMBU,KIAMBU,Total,69661,76225,145886
KIAMBU,KIAMBU,0,1799,1799,3598
KIAMBU,KIAMBU,1,1729,1727,3456
KIAMBU,KIAMBU,2,1711,1607,3318
KIAMBU,KIAMBU,3,1599,1647,3246
KIAMBU,KIAMBU,4,1501,1524,3025
KIAMBU,KIAMBU,0 - 4,8339,8304,16643
KIAMBU,KIAMBU,5,1555,1468,3023
KIAMBU,KIAMBU,6,1360,1465,2825
KIAMBU,KIAMBU,7,1426,1441,2867
KIAMBU,KIAMBU,8,1329,1341,2670
KIAMBU,KIAMBU,9,1403,1440,2843
KIAMBU,KIAMBU,05-Sep,7073,7155,14228
KIAMBU,KIAMBU,10,1327,1388,2715
KIAMBU,KIAMBU,11,1133,1245,2378
KIAMBU,KIAMBU,12,1292,1398,2690
KIAMBU,KIAMBU,13,1252,1294,2546
KIAMBU,KIAMBU,14,1180,1197,2377
KIAMBU,KIAMBU,Oct-14,6184,6522,12706
KIAMBU,KIAMBU,15,1084,1167,2251
KIAMBU,KIAMBU,16,1095,1195,2290
KIAMBU,KIAMBU,17,1080,1245,2325
KIAMBU,KIAMBU,18,924,1119,2043
KIAMBU,KIAMBU,19,1164,1444,2608
KIAMBU,KIAMBU,15-19,5347,6170,11517
KIAMBU,KIAMBU,20,1190,1654,2844
KIAMBU,KIAMBU,21,1305,1743,3048
KIAMBU,KIAMBU,22,1334,1870,3204
KIAMBU,KIAMBU,23,1527,1997,3524
KIAMBU,KIAMBU,24,1496,1867,3363
KIAMBU,KIAMBU,20-24,6852,9131,15983
KIAMBU,KIAMBU,25,1463,1783,3246
KIAMBU,KIAMBU,26,1447,1752,3199
KIAMBU,KIAMBU,27,1475,1694,3169
KIAMBU,KIAMBU,28,1348,1609,2957
KIAMBU,KIAMBU,29,1405,1716,3121
KIAMBU,KIAMBU,25-29,7138,8554,15692
KIAMBU,KIAMBU,30,1780,2036,3816
KIAMBU,KIAMBU,31,1313,1452,2765
KIAMBU,KIAMBU,32,1528,1757,3285
KIAMBU,KIAMBU,33,1279,1417,2696
KIAMBU,KIAMBU,34,1281,1385,2666
KIAMBU,KIAMBU,30-34,7181,8047,15228
KIAMBU,KIAMBU,35,1490,1618,3108
KIAMBU,KIAMBU,36,1159,1237,2396
KIAMBU,KIAMBU,37,1175,1231,2406
KIAMBU,KIAMBU,38,969,1135,2104
KIAMBU,KIAMBU,39,1037,1058,2095
KIAMBU,KIAMBU,35-39,5830,6279,12109
KIAMBU,KIAMBU,40,1166,1209,2375
KIAMBU,KIAMBU,41,936,932,1868
KIAMBU,KIAMBU,42,952,943,1895
KIAMBU,KIAMBU,43,785,788,1573
KIAMBU,KIAMBU,44,743,709,1452
KIAMBU,KIAMBU,40-44,4582,4581,9163
KIAMBU,KIAMBU,45,911,906,1817
KIAMBU,KIAMBU,46,705,671,1376
KIAMBU,KIAMBU,47,681,711,1392
KIAMBU,KIAMBU,48,554,563,1117
KIAMBU,KIAMBU,49,632,544,1176
KIAMBU,KIAMBU,45-49,3483,3395,6878
KIAMBU,KIAMBU,50,633,651,1284
KIAMBU,KIAMBU,51,524,468,992
KIAMBU,KIAMBU,52,535,548,1083
KIAMBU,KIAMBU,53,399,413,812
KIAMBU,KIAMBU,54,472,469,941
KIAMBU,KIAMBU,50-54,2563,2549,5112
KIAMBU,KIAMBU,55,496,424,920
KIAMBU,KIAMBU,56,455,433,888
KIAMBU,KIAMBU,57,339,337,676
KIAMBU,KIAMBU,58,322,319,641
KIAMBU,KIAMBU,59,357,307,664
KIAMBU,KIAMBU,55-59,1969,1820,3789
KIAMBU,KIAMBU,60,317,304,621
KIAMBU,KIAMBU,61,254,215,469
KIAMBU,KIAMBU,62,224,216,440
KIAMBU,KIAMBU,63,179,191,370
KIAMBU,KIAMBU,64,161,145,306
KIAMBU,KIAMBU,60-64,1135,1071,2206
KIAMBU,KIAMBU,65,215,226,441
KIAMBU,KIAMBU,66,153,143,296
KIAMBU,KIAMBU,67,234,232,466
KIAMBU,KIAMBU,68,98,101,199
KIAMBU,KIAMBU,69,144,156,300
KIAMBU,KIAMBU,65-69,844,858,1702
KIAMBU,KIAMBU,70,169,194,363
KIAMBU,KIAMBU,71,116,129,245
KIAMBU,KIAMBU,72,139,129,268
KIAMBU,KIAMBU,73,114,87,201
KIAMBU,KIAMBU,74,91,111,202
KIAMBU,KIAMBU,70-74,629,650,1279
KIAMBU,KIAMBU,75,70,84,154
KIAMBU,KIAMBU,76,58,128,186
KIAMBU,KIAMBU,77,47,65,112
KIAMBU,KIAMBU,78,31,36,67
KIAMBU,KIAMBU,79,35,72,107
KIAMBU,KIAMBU,75-79,241,385,626
KIAMBU,KIAMBU,80,44,101,145
KIAMBU,KIAMBU,81,25,45,70
KIAMBU,KIAMBU,82,35,54,89
KIAMBU,KIAMBU,83,21,45,66
KIAMBU,KIAMBU,84,27,51,78
KIAMBU,KIAMBU,80-84,152,296,448
KIAMBU,KIAMBU,85,24,51,75
KIAMBU,KIAMBU,86,13,45,58
KIAMBU,KIAMBU,87,14,48,62
KIAMBU,KIAMBU,88,11,18,29
KIAMBU,KIAMBU,89,9,53,62
KIAMBU,KIAMBU,85-89,71,215,286
KIAMBU,KIAMBU,90,7,40,47
KIAMBU,KIAMBU,91,10,27,37
KIAMBU,KIAMBU,92,8,18,26
KIAMBU,KIAMBU,93,-,23,23
KIAMBU,KIAMBU,94,2,14,16
KIAMBU,KIAMBU,90-94,27,122,149
KIAMBU,KIAMBU,95,5,25,30
KIAMBU,KIAMBU,96,5,16,21
KIAMBU,KIAMBU,97,2,14,16
KIAMBU,KIAMBU,98,2,10,12
KIAMBU,KIAMBU,99,3,17,20
KIAMBU,KIAMBU,95-99,17,82,99
KIAMBU,KIAMBU,100+,2,37,39
KIAMBU,KIAMBU,Not Stated,2,2,4
KIAMBU,KIKUYU,Total,90919,96198,187117
KIAMBU,KIKUYU,0,2362,2205,4567
KIAMBU,KIKUYU,1,2204,2160,4364
KIAMBU,KIKUYU,2,2178,2169,4347
KIAMBU,KIKUYU,3,2181,2066,4247
KIAMBU,KIKUYU,4,1968,1894,3862
KIAMBU,KIKUYU,0 - 4,10893,10494,21387
KIAMBU,KIKUYU,5,1878,1918,3796
KIAMBU,KIKUYU,6,1864,1810,3674
KIAMBU,KIKUYU,7,1866,1862,3728
KIAMBU,KIKUYU,8,1774,1752,3526
KIAMBU,KIKUYU,9,1950,1969,3919
KIAMBU,KIKUYU,05-Sep,9332,9311,18643
KIAMBU,KIKUYU,10,1806,1844,3650
KIAMBU,KIKUYU,11,1537,1642,3179
KIAMBU,KIKUYU,12,1721,1746,3467
KIAMBU,KIKUYU,13,1793,1760,3553
KIAMBU,KIKUYU,14,1619,1637,3256
KIAMBU,KIKUYU,Oct-14,8476,8629,17105
KIAMBU,KIKUYU,15,1534,1603,3137
KIAMBU,KIKUYU,16,1467,1570,3037
KIAMBU,KIKUYU,17,1586,1690,3276
KIAMBU,KIKUYU,18,1397,1553,2950
KIAMBU,KIKUYU,19,1536,1825,3361
KIAMBU,KIKUYU,15-19,7520,8241,15761
KIAMBU,KIKUYU,20,1426,1931,3357
KIAMBU,KIKUYU,21,1635,2023,3658
KIAMBU,KIKUYU,22,1714,2081,3795
KIAMBU,KIKUYU,23,1915,2508,4423
KIAMBU,KIKUYU,24,1858,2273,4131
KIAMBU,KIKUYU,20-24,8548,10816,19364
KIAMBU,KIKUYU,25,1917,2261,4178
KIAMBU,KIKUYU,26,1898,2253,4151
KIAMBU,KIKUYU,27,1935,2248,4183
KIAMBU,KIKUYU,28,1777,1995,3772
KIAMBU,KIKUYU,29,1916,2205,4121
KIAMBU,KIKUYU,25-29,9443,10962,20405
KIAMBU,KIKUYU,30,2134,2420,4554
KIAMBU,KIKUYU,31,1682,1808,3490
KIAMBU,KIKUYU,32,1941,2144,4085
KIAMBU,KIKUYU,33,1712,1817,3529
KIAMBU,KIKUYU,34,1559,1724,3283
KIAMBU,KIKUYU,30-34,9028,9913,18941
KIAMBU,KIKUYU,35,1847,1944,3791
KIAMBU,KIKUYU,36,1477,1470,2947
KIAMBU,KIKUYU,37,1424,1411,2835
KIAMBU,KIKUYU,38,1306,1300,2606
KIAMBU,KIKUYU,39,1391,1298,2689
KIAMBU,KIKUYU,35-39,7445,7423,14868
KIAMBU,KIKUYU,40,1441,1419,2860
KIAMBU,KIKUYU,41,1155,1139,2294
KIAMBU,KIKUYU,42,1139,1073,2212
KIAMBU,KIKUYU,43,995,996,1991
KIAMBU,KIKUYU,44,894,845,1739
KIAMBU,KIKUYU,40-44,5624,5472,11096
KIAMBU,KIKUYU,45,1162,1030,2192
KIAMBU,KIKUYU,46,886,832,1718
KIAMBU,KIKUYU,47,889,841,1730
KIAMBU,KIKUYU,48,737,725,1462
KIAMBU,KIKUYU,49,760,765,1525
KIAMBU,KIKUYU,45-49,4434,4193,8627
KIAMBU,KIKUYU,50,836,796,1632
KIAMBU,KIKUYU,51,625,613,1238
KIAMBU,KIKUYU,52,715,673,1388
KIAMBU,KIKUYU,53,531,552,1083
KIAMBU,KIKUYU,54,575,547,1122
KIAMBU,KIKUYU,50-54,3282,3181,6463
KIAMBU,KIKUYU,55,591,531,1122
KIAMBU,KIKUYU,56,569,514,1083
KIAMBU,KIKUYU,57,512,552,1064
KIAMBU,KIKUYU,58,398,407,805
KIAMBU,KIKUYU,59,412,381,793
KIAMBU,KIKUYU,55-59,2482,2385,4867
KIAMBU,KIKUYU,60,406,417,823
KIAMBU,KIKUYU,61,374,308,682
KIAMBU,KIKUYU,62,283,286,569
KIAMBU,KIKUYU,63,237,265,502
KIAMBU,KIKUYU,64,180,196,376
KIAMBU,KIKUYU,60-64,1480,1472,2952
KIAMBU,KIKUYU,65,281,298,579
KIAMBU,KIKUYU,66,171,209,380
KIAMBU,KIKUYU,67,298,302,600
KIAMBU,KIKUYU,68,143,150,293
KIAMBU,KIKUYU,69,219,235,454
KIAMBU,KIKUYU,65-69,1112,1194,2306
KIAMBU,KIKUYU,70,265,288,553
KIAMBU,KIKUYU,71,182,202,384
KIAMBU,KIKUYU,72,204,181,385
KIAMBU,KIKUYU,73,123,155,278
KIAMBU,KIKUYU,74,129,158,287
KIAMBU,KIKUYU,70-74,903,984,1887
KIAMBU,KIKUYU,75,97,152,249
KIAMBU,KIKUYU,76,127,171,298
KIAMBU,KIKUYU,77,89,116,205
KIAMBU,KIKUYU,78,44,62,106
KIAMBU,KIKUYU,79,67,115,182
KIAMBU,KIKUYU,75-79,424,616,1040
KIAMBU,KIKUYU,80,86,135,221
KIAMBU,KIKUYU,81,47,74,121
KIAMBU,KIKUYU,82,48,70,118
KIAMBU,KIKUYU,83,43,55,98
KIAMBU,KIKUYU,84,41,79,120
KIAMBU,KIKUYU,80-84,265,413,678
KIAMBU,KIKUYU,85,38,88,126
KIAMBU,KIKUYU,86,29,49,78
KIAMBU,KIKUYU,87,25,39,64
KIAMBU,KIKUYU,88,20,25,45
KIAMBU,KIKUYU,89,32,64,96
KIAMBU,KIKUYU,85-89,144,265,409
KIAMBU,KIKUYU,90,17,32,49
KIAMBU,KIKUYU,91,10,26,36
KIAMBU,KIKUYU,92,9,18,27
KIAMBU,KIKUYU,93,7,20,27
KIAMBU,KIKUYU,94,1,15,16
KIAMBU,KIKUYU,90-94,44,111,155
KIAMBU,KIKUYU,95,11,26,37
KIAMBU,KIKUYU,96,5,18,23
KIAMBU,KIKUYU,97,8,17,25
KIAMBU,KIKUYU,98,2,12,14
KIAMBU,KIKUYU,99,6,13,19
KIAMBU,KIKUYU,95-99,32,86,118
KIAMBU,KIKUYU,100+,8,35,43
KIAMBU,KIKUYU,Not Stated,-,2,2
KIAMBU,LARI,Total,67061,68238,135299
KIAMBU,LARI,0,1476,1523,2999
KIAMBU,LARI,1,1463,1428,2891
KIAMBU,LARI,2,1413,1507,2920
KIAMBU,LARI,3,1555,1500,3055
KIAMBU,LARI,4,1508,1496,3004
KIAMBU,LARI,0 - 4,7415,7454,14869
KIAMBU,LARI,5,1437,1330,2767
KIAMBU,LARI,6,1424,1469,2893
KIAMBU,LARI,7,1496,1451,2947
KIAMBU,LARI,8,1422,1410,2832
KIAMBU,LARI,9,1686,1616,3302
KIAMBU,LARI,05-Sep,7465,7276,14741
KIAMBU,LARI,10,1604,1530,3134
KIAMBU,LARI,11,1454,1499,2953
KIAMBU,LARI,12,1590,1610,3200
KIAMBU,LARI,13,1645,1623,3268
KIAMBU,LARI,14,1632,1585,3217
KIAMBU,LARI,Oct-14,7925,7847,15772
KIAMBU,LARI,15,1627,1561,3188
KIAMBU,LARI,16,1556,1497,3053
KIAMBU,LARI,17,1760,1431,3191
KIAMBU,LARI,18,1296,1231,2527
KIAMBU,LARI,19,1397,1235,2632
KIAMBU,LARI,15-19,7636,6955,14591
KIAMBU,LARI,20,1239,1218,2457
KIAMBU,LARI,21,1114,1049,2163
KIAMBU,LARI,22,1139,1035,2174
KIAMBU,LARI,23,1192,1137,2329
KIAMBU,LARI,24,1029,1053,2082
KIAMBU,LARI,20-24,5713,5492,11205
KIAMBU,LARI,25,981,990,1971
KIAMBU,LARI,26,894,918,1812
KIAMBU,LARI,27,987,908,1895
KIAMBU,LARI,28,819,853,1672
KIAMBU,LARI,29,888,968,1856
KIAMBU,LARI,25-29,4569,4637,9206
KIAMBU,LARI,30,1087,1141,2228
KIAMBU,LARI,31,891,825,1716
KIAMBU,LARI,32,978,1046,2024
KIAMBU,LARI,33,848,990,1838
KIAMBU,LARI,34,829,920,1749
KIAMBU,LARI,30-34,4633,4922,9555
KIAMBU,LARI,35,1077,1116,2193
KIAMBU,LARI,36,845,888,1733
KIAMBU,LARI,37,903,880,1783
KIAMBU,LARI,38,708,732,1440
KIAMBU,LARI,39,804,878,1682
KIAMBU,LARI,35-39,4337,4494,8831
KIAMBU,LARI,40,838,890,1728
KIAMBU,LARI,41,918,904,1822
KIAMBU,LARI,42,813,804,1617
KIAMBU,LARI,43,687,730,1417
KIAMBU,LARI,44,636,692,1328
KIAMBU,LARI,40-44,3892,4020,7912
KIAMBU,LARI,45,858,1034,1892
KIAMBU,LARI,46,666,725,1391
KIAMBU,LARI,47,791,745,1536
KIAMBU,LARI,48,535,566,1101
KIAMBU,LARI,49,590,559,1149
KIAMBU,LARI,45-49,3440,3629,7069
KIAMBU,LARI,50,632,758,1390
KIAMBU,LARI,51,534,548,1082
KIAMBU,LARI,52,597,635,1232
KIAMBU,LARI,53,459,481,940
KIAMBU,LARI,54,516,520,1036
KIAMBU,LARI,50-54,2738,2942,5680
KIAMBU,LARI,55,529,511,1040
KIAMBU,LARI,56,543,563,1106
KIAMBU,LARI,57,413,489,902
KIAMBU,LARI,58,338,413,751
KIAMBU,LARI,59,401,411,812
KIAMBU,LARI,55-59,2224,2387,4611
KIAMBU,LARI,60,409,432,841
KIAMBU,LARI,61,326,379,705
KIAMBU,LARI,62,301,301,602
KIAMBU,LARI,63,240,244,484
KIAMBU,LARI,64,203,217,420
KIAMBU,LARI,60-64,1479,1573,3052
KIAMBU,LARI,65,306,327,633
KIAMBU,LARI,66,221,250,471
KIAMBU,LARI,67,396,371,767
KIAMBU,LARI,68,159,170,329
KIAMBU,LARI,69,223,307,530
KIAMBU,LARI,65-69,1305,1425,2730
KIAMBU,LARI,70,278,355,633
KIAMBU,LARI,71,251,253,504
KIAMBU,LARI,72,238,241,479
KIAMBU,LARI,73,193,182,375
KIAMBU,LARI,74,152,181,333
KIAMBU,LARI,70-74,1112,1212,2324
KIAMBU,LARI,75,109,197,306
KIAMBU,LARI,76,144,250,394
KIAMBU,LARI,77,124,144,268
KIAMBU,LARI,78,57,86,143
KIAMBU,LARI,79,89,138,227
KIAMBU,LARI,75-79,523,815,1338
KIAMBU,LARI,80,93,187,280
KIAMBU,LARI,81,60,87,147
KIAMBU,LARI,82,59,68,127
KIAMBU,LARI,83,62,96,158
KIAMBU,LARI,84,63,108,171
KIAMBU,LARI,80-84,337,546,883
KIAMBU,LARI,85,47,107,154
KIAMBU,LARI,86,44,56,100
KIAMBU,LARI,87,31,55,86
KIAMBU,LARI,88,31,27,58
KIAMBU,LARI,89,48,79,127
KIAMBU,LARI,85-89,201,324,525
KIAMBU,LARI,90,13,48,61
KIAMBU,LARI,91,21,42,63
KIAMBU,LARI,92,16,20,36
KIAMBU,LARI,93,11,26,37
KIAMBU,LARI,94,11,22,33
KIAMBU,LARI,90-94,72,158,230
KIAMBU,LARI,95,9,24,33
KIAMBU,LARI,96,6,17,23
KIAMBU,LARI,97,13,22,35
KIAMBU,LARI,98,6,7,13
KIAMBU,LARI,99,5,11,16
KIAMBU,LARI,95-99,39,81,120
KIAMBU,LARI,100+,6,49,55
KIAMBU,LARI,Not Stated,-,-,-
KIAMBU,LIMURU,Total,79632,79682,159314
KIAMBU,LIMURU,0,1874,1925,3799
KIAMBU,LIMURU,1,1878,1754,3632
KIAMBU,LIMURU,2,1784,1733,3517
KIAMBU,LIMURU,3,1751,1763,3514
KIAMBU,LIMURU,4,1628,1742,3370
KIAMBU,LIMURU,0 - 4,8915,8917,17832
KIAMBU,LIMURU,5,1744,1623,3367
KIAMBU,LIMURU,6,1652,1577,3229
KIAMBU,LIMURU,7,1669,1683,3352
KIAMBU,LIMURU,8,1626,1570,3196
KIAMBU,LIMURU,9,1803,1809,3612
KIAMBU,LIMURU,05-Sep,8494,8262,16756
KIAMBU,LIMURU,10,1776,1670,3446
KIAMBU,LIMURU,11,1620,1573,3193
KIAMBU,LIMURU,12,1804,1721,3525
KIAMBU,LIMURU,13,1843,1747,3590
KIAMBU,LIMURU,14,1611,1704,3315
KIAMBU,LIMURU,Oct-14,8654,8415,17069
KIAMBU,LIMURU,15,1593,1601,3194
KIAMBU,LIMURU,16,1546,1589,3135
KIAMBU,LIMURU,17,1685,1580,3265
KIAMBU,LIMURU,18,1332,1435,2767
KIAMBU,LIMURU,19,1530,1522,3052
KIAMBU,LIMURU,15-19,7686,7727,15413
KIAMBU,LIMURU,20,1446,1532,2978
KIAMBU,LIMURU,21,1540,1487,3027
KIAMBU,LIMURU,22,1516,1604,3120
KIAMBU,LIMURU,23,1605,1680,3285
KIAMBU,LIMURU,24,1412,1505,2917
KIAMBU,LIMURU,20-24,7519,7808,15327
KIAMBU,LIMURU,25,1480,1422,2902
KIAMBU,LIMURU,26,1312,1440,2752
KIAMBU,LIMURU,27,1459,1428,2887
KIAMBU,LIMURU,28,1191,1241,2432
KIAMBU,LIMURU,29,1319,1334,2653
KIAMBU,LIMURU,25-29,6761,6865,13626
KIAMBU,LIMURU,30,1441,1606,3047
KIAMBU,LIMURU,31,1174,1204,2378
KIAMBU,LIMURU,32,1452,1434,2886
KIAMBU,LIMURU,33,1231,1246,2477
KIAMBU,LIMURU,34,1163,1188,2351
KIAMBU,LIMURU,30-34,6461,6678,13139
KIAMBU,LIMURU,35,1457,1397,2854
KIAMBU,LIMURU,36,1055,1114,2169
KIAMBU,LIMURU,37,1096,1031,2127
KIAMBU,LIMURU,38,995,997,1992
KIAMBU,LIMURU,39,1082,1099,2181
KIAMBU,LIMURU,35-39,5685,5638,11323
KIAMBU,LIMURU,40,1187,1097,2284
KIAMBU,LIMURU,41,1082,1066,2148
KIAMBU,LIMURU,42,1020,993,2013
KIAMBU,LIMURU,43,881,850,1731
KIAMBU,LIMURU,44,762,703,1465
KIAMBU,LIMURU,40-44,4932,4709,9641
KIAMBU,LIMURU,45,1075,924,1999
KIAMBU,LIMURU,46,924,826,1750
KIAMBU,LIMURU,47,911,719,1630
KIAMBU,LIMURU,48,650,570,1220
KIAMBU,LIMURU,49,744,692,1436
KIAMBU,LIMURU,45-49,4304,3731,8035
KIAMBU,LIMURU,50,821,758,1579
KIAMBU,LIMURU,51,615,542,1157
KIAMBU,LIMURU,52,703,587,1290
KIAMBU,LIMURU,53,466,448,914
KIAMBU,LIMURU,54,580,513,1093
KIAMBU,LIMURU,50-54,3185,2848,6033
KIAMBU,LIMURU,55,530,495,1025
KIAMBU,LIMURU,56,558,560,1118
KIAMBU,LIMURU,57,468,492,960
KIAMBU,LIMURU,58,365,365,730
KIAMBU,LIMURU,59,411,425,836
KIAMBU,LIMURU,55-59,2332,2337,4669
KIAMBU,LIMURU,60,435,453,888
KIAMBU,LIMURU,61,349,338,687
KIAMBU,LIMURU,62,305,267,572
KIAMBU,LIMURU,63,259,206,465
KIAMBU,LIMURU,64,208,211,419
KIAMBU,LIMURU,60-64,1556,1475,3031
KIAMBU,LIMURU,65,265,302,567
KIAMBU,LIMURU,66,193,204,397
KIAMBU,LIMURU,67,328,335,663
KIAMBU,LIMURU,68,164,144,308
KIAMBU,LIMURU,69,248,248,496
KIAMBU,LIMURU,65-69,1198,1233,2431
KIAMBU,LIMURU,70,283,350,633
KIAMBU,LIMURU,71,185,191,376
KIAMBU,LIMURU,72,232,257,489
KIAMBU,LIMURU,73,126,170,296
KIAMBU,LIMURU,74,123,181,304
KIAMBU,LIMURU,70-74,949,1149,2098
KIAMBU,LIMURU,75,102,164,266
KIAMBU,LIMURU,76,118,234,352
KIAMBU,LIMURU,77,83,120,203
KIAMBU,LIMURU,78,62,91,153
KIAMBU,LIMURU,79,60,137,197
KIAMBU,LIMURU,75-79,425,746,1171
KIAMBU,LIMURU,80,87,173,260
KIAMBU,LIMURU,81,67,104,171
KIAMBU,LIMURU,82,64,65,129
KIAMBU,LIMURU,83,56,79,135
KIAMBU,LIMURU,84,25,117,142
KIAMBU,LIMURU,80-84,299,538,837
KIAMBU,LIMURU,85,50,98,148
KIAMBU,LIMURU,86,31,67,98
KIAMBU,LIMURU,87,37,62,99
KIAMBU,LIMURU,88,16,42,58
KIAMBU,LIMURU,89,27,65,92
KIAMBU,LIMURU,85-89,161,334,495
KIAMBU,LIMURU,90,21,50,71
KIAMBU,LIMURU,91,19,39,58
KIAMBU,LIMURU,92,10,23,33
KIAMBU,LIMURU,93,9,20,29
KIAMBU,LIMURU,94,10,20,30
KIAMBU,LIMURU,90-94,69,152,221
KIAMBU,LIMURU,95,11,30,41
KIAMBU,LIMURU,96,9,16,25
KIAMBU,LIMURU,97,9,17,26
KIAMBU,LIMURU,98,2,7,9
KIAMBU,LIMURU,99,6,13,19
KIAMBU,LIMURU,95-99,37,83,120
KIAMBU,LIMURU,100+,6,37,43
KIAMBU,LIMURU,Not Stated,4,-,4
KIAMBU,RUIRU,Total,180947,190144,371091
KIAMBU,RUIRU,0,5102,5008,10110
KIAMBU,RUIRU,1,4971,4803,9774
KIAMBU,RUIRU,2,4619,4498,9117
KIAMBU,RUIRU,3,4362,4451,8813
KIAMBU,RUIRU,4,4078,3933,8011
KIAMBU,RUIRU,0 - 4,23132,22693,45825
KIAMBU,RUIRU,5,3916,3820,7736
KIAMBU,RUIRU,6,3655,3670,7325
KIAMBU,RUIRU,7,3663,3708,7371
KIAMBU,RUIRU,8,3312,3547,6859
KIAMBU,RUIRU,9,3617,3614,7231
KIAMBU,RUIRU,05-Sep,18163,18359,36522
KIAMBU,RUIRU,10,3405,3367,6772
KIAMBU,RUIRU,11,2948,3107,6055
KIAMBU,RUIRU,12,3123,3270,6393
KIAMBU,RUIRU,13,3070,3247,6317
KIAMBU,RUIRU,14,2902,2910,5812
KIAMBU,RUIRU,Oct-14,15448,15901,31349
KIAMBU,RUIRU,15,2635,2852,5487
KIAMBU,RUIRU,16,2441,2880,5321
KIAMBU,RUIRU,17,2674,3135,5809
KIAMBU,RUIRU,18,2305,2972,5277
KIAMBU,RUIRU,19,2886,4128,7014
KIAMBU,RUIRU,15-19,12941,15967,28908
KIAMBU,RUIRU,20,3163,4799,7962
KIAMBU,RUIRU,21,3652,5091,8743
KIAMBU,RUIRU,22,4028,5528,9556
KIAMBU,RUIRU,23,5020,6391,11411
KIAMBU,RUIRU,24,5088,6119,11207
KIAMBU,RUIRU,20-24,20951,27928,48879
KIAMBU,RUIRU,25,5412,5989,11401
KIAMBU,RUIRU,26,4698,5306,10004
KIAMBU,RUIRU,27,4846,5188,10034
KIAMBU,RUIRU,28,4254,4756,9010
KIAMBU,RUIRU,29,4617,4777,9394
KIAMBU,RUIRU,25-29,23827,26016,49843
KIAMBU,RUIRU,30,5335,5739,11074
KIAMBU,RUIRU,31,3718,3584,7302
KIAMBU,RUIRU,32,4535,4617,9152
KIAMBU,RUIRU,33,3544,3789,7333
KIAMBU,RUIRU,34,3310,3336,6646
KIAMBU,RUIRU,30-34,20442,21065,41507
KIAMBU,RUIRU,35,3911,3788,7699
KIAMBU,RUIRU,36,2897,2982,5879
KIAMBU,RUIRU,37,2648,2684,5332
KIAMBU,RUIRU,38,2516,2554,5070
KIAMBU,RUIRU,39,2462,2470,4932
KIAMBU,RUIRU,35-39,14434,14478,28912
KIAMBU,RUIRU,40,2883,2592,5475
KIAMBU,RUIRU,41,2299,2116,4415
KIAMBU,RUIRU,42,2232,1975,4207
KIAMBU,RUIRU,43,1826,1681,3507
KIAMBU,RUIRU,44,1580,1401,2981
KIAMBU,RUIRU,40-44,10820,9765,20585
KIAMBU,RUIRU,45,2234,1817,4051
KIAMBU,RUIRU,46,1534,1357,2891
KIAMBU,RUIRU,47,1632,1382,3014
KIAMBU,RUIRU,48,1168,1093,2261
KIAMBU,RUIRU,49,1384,1099,2483
KIAMBU,RUIRU,45-49,7952,6748,14700
KIAMBU,RUIRU,50,1488,1213,2701
KIAMBU,RUIRU,51,1030,817,1847
KIAMBU,RUIRU,52,1146,911,2057
KIAMBU,RUIRU,53,732,643,1375
KIAMBU,RUIRU,54,865,724,1589
KIAMBU,RUIRU,50-54,5261,4308,9569
KIAMBU,RUIRU,55,857,670,1527
KIAMBU,RUIRU,56,835,670,1505
KIAMBU,RUIRU,57,697,618,1315
KIAMBU,RUIRU,58,553,463,1016
KIAMBU,RUIRU,59,573,481,1054
KIAMBU,RUIRU,55-59,3515,2902,6417
KIAMBU,RUIRU,60,601,524,1125
KIAMBU,RUIRU,61,418,338,756
KIAMBU,RUIRU,62,378,287,665
KIAMBU,RUIRU,63,303,250,553
KIAMBU,RUIRU,64,223,185,408
KIAMBU,RUIRU,60-64,1923,1584,3507
KIAMBU,RUIRU,65,302,264,566
KIAMBU,RUIRU,66,203,183,386
KIAMBU,RUIRU,67,287,276,563
KIAMBU,RUIRU,68,145,119,264
KIAMBU,RUIRU,69,163,160,323
KIAMBU,RUIRU,65-69,1100,1002,2102
KIAMBU,RUIRU,70,194,211,405
KIAMBU,RUIRU,71,124,128,252
KIAMBU,RUIRU,72,119,113,232
KIAMBU,RUIRU,73,89,78,167
KIAMBU,RUIRU,74,97,74,171
KIAMBU,RUIRU,70-74,623,604,1227
KIAMBU,RUIRU,75,68,91,159
KIAMBU,RUIRU,76,45,96,141
KIAMBU,RUIRU,77,35,59,94
KIAMBU,RUIRU,78,34,36,70
KIAMBU,RUIRU,79,31,59,90
KIAMBU,RUIRU,75-79,213,341,554
KIAMBU,RUIRU,80,31,64,95
KIAMBU,RUIRU,81,14,45,59
KIAMBU,RUIRU,82,16,21,37
KIAMBU,RUIRU,83,18,38,56
KIAMBU,RUIRU,84,22,29,51
KIAMBU,RUIRU,80-84,101,197,298
KIAMBU,RUIRU,85,10,43,53
KIAMBU,RUIRU,86,10,30,40
KIAMBU,RUIRU,87,17,29,46
KIAMBU,RUIRU,88,5,11,16
KIAMBU,RUIRU,89,17,28,45
KIAMBU,RUIRU,85-89,59,141,200
KIAMBU,RUIRU,90,5,24,29
KIAMBU,RUIRU,91,6,15,21
KIAMBU,RUIRU,92,-,8,8
KIAMBU,RUIRU,93,7,8,15
KIAMBU,RUIRU,94,2,11,13
KIAMBU,RUIRU,90-94,20,66,86
KIAMBU,RUIRU,95,3,15,18
KIAMBU,RUIRU,96,2,11,13
KIAMBU,RUIRU,97,4,11,15
KIAMBU,RUIRU,98,1,8,9
KIAMBU,RUIRU,99,1,9,10
KIAMBU,RUIRU,95-99,11,54,65
KIAMBU,RUIRU,100+,6,24,30
KIAMBU,RUIRU,Not Stated,5,1,6
KIAMBU,THIKA EAST,Total,19688,19264,38952
KIAMBU,THIKA EAST,0,428,443,871
KIAMBU,THIKA EAST,1,481,439,920
KIAMBU,THIKA EAST,2,432,390,822
KIAMBU,THIKA EAST,3,421,450,871
KIAMBU,THIKA EAST,4,424,447,871
KIAMBU,THIKA EAST,0 - 4,2186,2169,4355
KIAMBU,THIKA EAST,5,425,402,827
KIAMBU,THIKA EAST,6,392,403,795
KIAMBU,THIKA EAST,7,409,422,831
KIAMBU,THIKA EAST,8,380,408,788
KIAMBU,THIKA EAST,9,449,455,904
KIAMBU,THIKA EAST,05-Sep,2055,2090,4145
KIAMBU,THIKA EAST,10,402,449,851
KIAMBU,THIKA EAST,11,386,412,798
KIAMBU,THIKA EAST,12,482,412,894
KIAMBU,THIKA EAST,13,430,451,881
KIAMBU,THIKA EAST,14,429,409,838
KIAMBU,THIKA EAST,Oct-14,2129,2133,4262
KIAMBU,THIKA EAST,15,422,431,853
KIAMBU,THIKA EAST,16,399,415,814
KIAMBU,THIKA EAST,17,414,404,818
KIAMBU,THIKA EAST,18,313,341,654
KIAMBU,THIKA EAST,19,350,339,689
KIAMBU,THIKA EAST,15-19,1898,1930,3828
KIAMBU,THIKA EAST,20,324,382,706
KIAMBU,THIKA EAST,21,359,325,684
KIAMBU,THIKA EAST,22,373,355,728
KIAMBU,THIKA EAST,23,433,420,853
KIAMBU,THIKA EAST,24,413,359,772
KIAMBU,THIKA EAST,20-24,1902,1841,3743
KIAMBU,THIKA EAST,25,362,336,698
KIAMBU,THIKA EAST,26,352,308,660
KIAMBU,THIKA EAST,27,343,320,663
KIAMBU,THIKA EAST,28,272,287,559
KIAMBU,THIKA EAST,29,375,332,707
KIAMBU,THIKA EAST,25-29,1704,1583,3287
KIAMBU,THIKA EAST,30,405,371,776
KIAMBU,THIKA EAST,31,279,280,559
KIAMBU,THIKA EAST,32,386,349,735
KIAMBU,THIKA EAST,33,296,297,593
KIAMBU,THIKA EAST,34,288,266,554
KIAMBU,THIKA EAST,30-34,1654,1563,3217
KIAMBU,THIKA EAST,35,314,323,637
KIAMBU,THIKA EAST,36,261,279,540
KIAMBU,THIKA EAST,37,275,266,541
KIAMBU,THIKA EAST,38,225,216,441
KIAMBU,THIKA EAST,39,239,223,462
KIAMBU,THIKA EAST,35-39,1314,1307,2621
KIAMBU,THIKA EAST,40,322,280,602
KIAMBU,THIKA EAST,41,264,248,512
KIAMBU,THIKA EAST,42,257,204,461
KIAMBU,THIKA EAST,43,244,205,449
KIAMBU,THIKA EAST,44,207,171,378
KIAMBU,THIKA EAST,40-44,1294,1108,2402
KIAMBU,THIKA EAST,45,277,239,516
KIAMBU,THIKA EAST,46,205,193,398
KIAMBU,THIKA EAST,47,212,174,386
KIAMBU,THIKA EAST,48,160,115,275
KIAMBU,THIKA EAST,49,179,189,368
KIAMBU,THIKA EAST,45-49,1033,910,1943
KIAMBU,THIKA EAST,50,167,188,355
KIAMBU,THIKA EAST,51,174,158,332
KIAMBU,THIKA EAST,52,164,156,320
KIAMBU,THIKA EAST,53,120,116,236
KIAMBU,THIKA EAST,54,138,138,276
KIAMBU,THIKA EAST,50-54,763,756,1519
KIAMBU,THIKA EAST,55,145,107,252
KIAMBU,THIKA EAST,56,182,138,320
KIAMBU,THIKA EAST,57,113,125,238
KIAMBU,THIKA EAST,58,98,91,189
KIAMBU,THIKA EAST,59,110,103,213
KIAMBU,THIKA EAST,55-59,648,564,1212
KIAMBU,THIKA EAST,60,119,113,232
KIAMBU,THIKA EAST,61,67,78,145
KIAMBU,THIKA EAST,62,71,71,142
KIAMBU,THIKA EAST,63,81,76,157
KIAMBU,THIKA EAST,64,44,53,97
KIAMBU,THIKA EAST,60-64,382,391,773
KIAMBU,THIKA EAST,65,71,72,143
KIAMBU,THIKA EAST,66,42,51,93
KIAMBU,THIKA EAST,67,83,90,173
KIAMBU,THIKA EAST,68,42,24,66
KIAMBU,THIKA EAST,69,42,51,93
KIAMBU,THIKA EAST,65-69,280,288,568
KIAMBU,THIKA EAST,70,55,57,112
KIAMBU,THIKA EAST,71,48,50,98
KIAMBU,THIKA EAST,72,48,30,78
KIAMBU,THIKA EAST,73,29,42,71
KIAMBU,THIKA EAST,74,42,40,82
KIAMBU,THIKA EAST,70-74,222,219,441
KIAMBU,THIKA EAST,75,26,32,58
KIAMBU,THIKA EAST,76,22,64,86
KIAMBU,THIKA EAST,77,23,27,50
KIAMBU,THIKA EAST,78,14,13,27
KIAMBU,THIKA EAST,79,14,32,46
KIAMBU,THIKA EAST,75-79,99,168,267
KIAMBU,THIKA EAST,80,23,28,51
KIAMBU,THIKA EAST,81,11,24,35
KIAMBU,THIKA EAST,82,8,15,23
KIAMBU,THIKA EAST,83,5,16,21
KIAMBU,THIKA EAST,84,10,17,27
KIAMBU,THIKA EAST,80-84,57,100,157
KIAMBU,THIKA EAST,85,8,10,18
KIAMBU,THIKA EAST,86,7,21,28
KIAMBU,THIKA EAST,87,8,14,22
KIAMBU,THIKA EAST,88,3,8,11
KIAMBU,THIKA EAST,89,4,14,18
KIAMBU,THIKA EAST,85-89,30,67,97
KIAMBU,THIKA EAST,90,3,21,24
KIAMBU,THIKA EAST,91,10,8,18
KIAMBU,THIKA EAST,92,1,4,5
KIAMBU,THIKA EAST,93,5,4,9
KIAMBU,THIKA EAST,94,2,2,4
KIAMBU,THIKA EAST,90-94,21,39,60
KIAMBU,THIKA EAST,95,5,3,8
KIAMBU,THIKA EAST,96,1,7,8
KIAMBU,THIKA EAST,97,1,5,6
KIAMBU,THIKA EAST,98,1,5,6
KIAMBU,THIKA EAST,99,3,4,7
KIAMBU,THIKA EAST,95-99,11,24,35
KIAMBU,THIKA EAST,100+,6,13,19
KIAMBU,THIKA EAST,Not Stated,-,1,1
KIAMBU,THIKA WEST,Total,120698,125104,245802
KIAMBU,THIKA WEST,0,3196,3217,6413
KIAMBU,THIKA WEST,1,3118,2951,6069
KIAMBU,THIKA WEST,2,2899,2889,5788
KIAMBU,THIKA WEST,3,2945,2866,5811
KIAMBU,THIKA WEST,4,2675,2539,5214
KIAMBU,THIKA WEST,0 - 4,14833,14462,29295
KIAMBU,THIKA WEST,5,2469,2410,4879
KIAMBU,THIKA WEST,6,2351,2338,4689
KIAMBU,THIKA WEST,7,2280,2365,4645
KIAMBU,THIKA WEST,8,2211,2149,4360
KIAMBU,THIKA WEST,9,2343,2293,4636
KIAMBU,THIKA WEST,05-Sep,11654,11555,23209
KIAMBU,THIKA WEST,10,2182,2239,4421
KIAMBU,THIKA WEST,11,1987,2047,4034
KIAMBU,THIKA WEST,12,2036,2072,4108
KIAMBU,THIKA WEST,13,1926,2049,3975
KIAMBU,THIKA WEST,14,1828,1924,3752
KIAMBU,THIKA WEST,Oct-14,9959,10331,20290
KIAMBU,THIKA WEST,15,1716,1855,3571
KIAMBU,THIKA WEST,16,1648,1914,3562
KIAMBU,THIKA WEST,17,1745,2066,3811
KIAMBU,THIKA WEST,18,1755,2303,4058
KIAMBU,THIKA WEST,19,2450,3168,5618
KIAMBU,THIKA WEST,15-19,9314,11306,20620
KIAMBU,THIKA WEST,20,2823,3709,6532
KIAMBU,THIKA WEST,21,3201,3768,6969
KIAMBU,THIKA WEST,22,3301,3863,7164
KIAMBU,THIKA WEST,23,3380,4027,7407
KIAMBU,THIKA WEST,24,3327,3710,7037
KIAMBU,THIKA WEST,20-24,16032,19077,35109
KIAMBU,THIKA WEST,25,3296,3503,6799
KIAMBU,THIKA WEST,26,2934,3234,6168
KIAMBU,THIKA WEST,27,3011,3171,6182
KIAMBU,THIKA WEST,28,2599,2846,5445
KIAMBU,THIKA WEST,29,2932,3007,5939
KIAMBU,THIKA WEST,25-29,14772,15761,30533
KIAMBU,THIKA WEST,30,3299,3488,6787
KIAMBU,THIKA WEST,31,2265,2375,4640
KIAMBU,THIKA WEST,32,2879,2938,5817
KIAMBU,THIKA WEST,33,2270,2384,4654
KIAMBU,THIKA WEST,34,2109,2143,4252
KIAMBU,THIKA WEST,30-34,12822,13328,26150
KIAMBU,THIKA WEST,35,2619,2427,5046
KIAMBU,THIKA WEST,36,1808,1907,3715
KIAMBU,THIKA WEST,37,1733,1803,3536
KIAMBU,THIKA WEST,38,1681,1659,3340
KIAMBU,THIKA WEST,39,1653,1543,3196
KIAMBU,THIKA WEST,35-39,9494,9339,18833
KIAMBU,THIKA WEST,40,1907,1711,3618
KIAMBU,THIKA WEST,41,1432,1420,2852
KIAMBU,THIKA WEST,42,1451,1343,2794
KIAMBU,THIKA WEST,43,1270,1153,2423
KIAMBU,THIKA WEST,44,1031,968,1999
KIAMBU,THIKA WEST,40-44,7091,6595,13686
KIAMBU,THIKA WEST,45,1460,1242,2702
KIAMBU,THIKA WEST,46,1037,936,1973
KIAMBU,THIKA WEST,47,1091,918,2009
KIAMBU,THIKA WEST,48,772,750,1522
KIAMBU,THIKA WEST,49,878,782,1660
KIAMBU,THIKA WEST,45-49,5238,4628,9866
KIAMBU,THIKA WEST,50,953,889,1842
KIAMBU,THIKA WEST,51,748,580,1328
KIAMBU,THIKA WEST,52,805,712,1517
KIAMBU,THIKA WEST,53,543,499,1042
KIAMBU,THIKA WEST,54,603,531,1134
KIAMBU,THIKA WEST,50-54,3652,3211,6863
KIAMBU,THIKA WEST,55,652,522,1174
KIAMBU,THIKA WEST,56,644,523,1167
KIAMBU,THIKA WEST,57,491,481,972
KIAMBU,THIKA WEST,58,417,376,793
KIAMBU,THIKA WEST,59,445,395,840
KIAMBU,THIKA WEST,55-59,2649,2297,4946
KIAMBU,THIKA WEST,60,445,429,874
KIAMBU,THIKA WEST,61,336,273,609
KIAMBU,THIKA WEST,62,308,253,561
KIAMBU,THIKA WEST,63,234,216,450
KIAMBU,THIKA WEST,64,171,148,319
KIAMBU,THIKA WEST,60-64,1494,1319,2813
KIAMBU,THIKA WEST,65,235,209,444
KIAMBU,THIKA WEST,66,141,134,275
KIAMBU,THIKA WEST,67,229,189,418
KIAMBU,THIKA WEST,68,117,81,198
KIAMBU,THIKA WEST,69,141,127,268
KIAMBU,THIKA WEST,65-69,863,740,1603
KIAMBU,THIKA WEST,70,154,181,335
KIAMBU,THIKA WEST,71,106,95,201
KIAMBU,THIKA WEST,72,99,65,164
KIAMBU,THIKA WEST,73,66,76,142
KIAMBU,THIKA WEST,74,77,68,145
KIAMBU,THIKA WEST,70-74,502,485,987
KIAMBU,THIKA WEST,75,50,66,116
KIAMBU,THIKA WEST,76,48,69,117
KIAMBU,THIKA WEST,77,33,44,77
KIAMBU,THIKA WEST,78,24,37,61
KIAMBU,THIKA WEST,79,21,41,62
KIAMBU,THIKA WEST,75-79,176,257,433
KIAMBU,THIKA WEST,80,25,59,84
KIAMBU,THIKA WEST,81,17,40,57
KIAMBU,THIKA WEST,82,22,24,46
KIAMBU,THIKA WEST,83,13,25,38
KIAMBU,THIKA WEST,84,11,24,35
KIAMBU,THIKA WEST,80-84,88,172,260
KIAMBU,THIKA WEST,85,10,34,44
KIAMBU,THIKA WEST,86,6,23,29
KIAMBU,THIKA WEST,87,11,20,31
KIAMBU,THIKA WEST,88,2,11,13
KIAMBU,THIKA WEST,89,9,31,40
KIAMBU,THIKA WEST,85-89,38,119,157
KIAMBU,THIKA WEST,90,8,25,33
KIAMBU,THIKA WEST,91,7,10,17
KIAMBU,THIKA WEST,92,2,4,6
KIAMBU,THIKA WEST,93,1,4,5
KIAMBU,THIKA WEST,94,-,13,13
KIAMBU,THIKA WEST,90-94,18,56,74
KIAMBU,THIKA WEST,95,-,12,12
KIAMBU,THIKA WEST,96,-,6,6
KIAMBU,THIKA WEST,97,1,5,6
KIAMBU,THIKA WEST,98,1,6,7
KIAMBU,THIKA WEST,99,1,9,10
KIAMBU,THIKA WEST,95-99,3,38,41
KIAMBU,THIKA WEST,100+,3,24,27
KIAMBU,THIKA WEST,Not Stated,3,4,7
KILIFI,ALL,Total,704089,749673,1453762
KILIFI,ALL,0,18963,18919,37882
KILIFI,ALL,1,19960,19550,39510
KILIFI,ALL,2,20266,20012,40278
KILIFI,ALL,3,20444,20564,41008
KILIFI,ALL,4,21286,20867,42153
KILIFI,ALL,0 - 4,100919,99912,200831
KILIFI,ALL,5,21905,21615,43520
KILIFI,ALL,6,20986,20916,41902
KILIFI,ALL,7,20268,19563,39831
KILIFI,ALL,8,19994,19962,39956
KILIFI,ALL,9,20574,20402,40976
KILIFI,ALL,05-Sep,103727,102458,206185
KILIFI,ALL,10,21539,21194,42733
KILIFI,ALL,11,20129,20468,40597
KILIFI,ALL,12,21370,20847,42217
KILIFI,ALL,13,21119,21465,42584
KILIFI,ALL,14,19422,19219,38641
KILIFI,ALL,Oct-14,103579,103193,206772
KILIFI,ALL,15,18877,18499,37376
KILIFI,ALL,16,17635,17708,35343
KILIFI,ALL,17,18177,17238,35415
KILIFI,ALL,18,15946,15246,31192
KILIFI,ALL,19,16630,16394,33024
KILIFI,ALL,15-19,87265,85085,172350
KILIFI,ALL,20,15251,16538,31789
KILIFI,ALL,21,12345,13391,25736
KILIFI,ALL,22,12528,14313,26841
KILIFI,ALL,23,12458,14519,26977
KILIFI,ALL,24,11105,12943,24048
KILIFI,ALL,20-24,63687,71704,135391
KILIFI,ALL,25,12505,13929,26434
KILIFI,ALL,26,10755,12754,23509
KILIFI,ALL,27,10502,12142,22644
KILIFI,ALL,28,8783,10932,19715
KILIFI,ALL,29,8790,10768,19558
KILIFI,ALL,25-29,51335,60525,111860
KILIFI,ALL,30,10807,13585,24392
KILIFI,ALL,31,7432,9691,17123
KILIFI,ALL,32,8964,11785,20749
KILIFI,ALL,33,7285,9771,17056
KILIFI,ALL,34,7089,9553,16642
KILIFI,ALL,30-34,41577,54385,95962
KILIFI,ALL,35,8945,9939,18884
KILIFI,ALL,36,6098,6647,12745
KILIFI,ALL,37,6239,6002,12241
KILIFI,ALL,38,4594,4711,9305
KILIFI,ALL,39,5150,4888,10038
KILIFI,ALL,35-39,31026,32187,63213
KILIFI,ALL,40,6678,6386,13064
KILIFI,ALL,41,6921,8336,15257
KILIFI,ALL,42,6150,7849,13999
KILIFI,ALL,43,4953,6421,11374
KILIFI,ALL,44,4544,4868,9412
KILIFI,ALL,40-44,29246,33860,63106
KILIFI,ALL,45,7011,6815,13826
KILIFI,ALL,46,4423,4432,8855
KILIFI,ALL,47,4951,4506,9457
KILIFI,ALL,48,3595,3245,6840
KILIFI,ALL,49,3928,3600,7528
KILIFI,ALL,45-49,23908,22598,46506
KILIFI,ALL,50,5451,6602,12053
KILIFI,ALL,51,3829,4140,7969
KILIFI,ALL,52,3266,3366,6632
KILIFI,ALL,53,2482,2027,4509
KILIFI,ALL,54,2781,2097,4878
KILIFI,ALL,50-54,17809,18232,36041
KILIFI,ALL,55,2705,1969,4674
KILIFI,ALL,56,3326,3046,6372
KILIFI,ALL,57,3048,3320,6368
KILIFI,ALL,58,2504,2772,5276
KILIFI,ALL,59,2747,4609,7356
KILIFI,ALL,55-59,14330,15716,30046
KILIFI,ALL,60,3207,5481,8688
KILIFI,ALL,61,2270,3754,6024
KILIFI,ALL,62,2161,2954,5115
KILIFI,ALL,63,2215,3455,5670
KILIFI,ALL,64,1859,2238,4097
KILIFI,ALL,60-64,11712,17882,29594
KILIFI,ALL,65,2701,3381,6082
KILIFI,ALL,66,1800,1567,3367
KILIFI,ALL,67,2334,2261,4595
KILIFI,ALL,68,1258,1224,2482
KILIFI,ALL,69,1807,3002,4809
KILIFI,ALL,65-69,9900,11435,21335
KILIFI,ALL,70,1985,3464,5449
KILIFI,ALL,71,1392,1791,3183
KILIFI,ALL,72,1052,1128,2180
KILIFI,ALL,73,950,1099,2049
KILIFI,ALL,74,1062,1378,2440
KILIFI,ALL,70-74,6441,8860,15301
KILIFI,ALL,75,1102,1631,2733
KILIFI,ALL,76,639,754,1393
KILIFI,ALL,77,737,821,1558
KILIFI,ALL,78,478,451,929
KILIFI,ALL,79,770,1343,2113
KILIFI,ALL,75-79,3726,5000,8726
KILIFI,ALL,80,693,1414,2107
KILIFI,ALL,81,377,604,981
KILIFI,ALL,82,291,374,665
KILIFI,ALL,83,317,450,767
KILIFI,ALL,84,321,495,816
KILIFI,ALL,80-84,1999,3337,5336
KILIFI,ALL,85,291,528,819
KILIFI,ALL,86,147,191,338
KILIFI,ALL,87,245,403,648
KILIFI,ALL,88,116,139,255
KILIFI,ALL,89,325,617,942
KILIFI,ALL,85-89,1124,1878,3002
KILIFI,ALL,90,149,338,487
KILIFI,ALL,91,100,148,248
KILIFI,ALL,92,49,91,140
KILIFI,ALL,93,50,86,136
KILIFI,ALL,94,58,89,147
KILIFI,ALL,90-94,406,752,1158
KILIFI,ALL,95,68,139,207
KILIFI,ALL,96,32,49,81
KILIFI,ALL,97,44,39,83
KILIFI,ALL,98,35,49,84
KILIFI,ALL,99,70,142,212
KILIFI,ALL,95-99,249,418,667
KILIFI,ALL,100+,118,245,363
KILIFI,ALL,Not Stated,6,11,17
KILIFI,CHONYI,Total,29527,32807,62334
KILIFI,CHONYI,0,847,851,1698
KILIFI,CHONYI,1,816,795,1611
KILIFI,CHONYI,2,937,826,1763
KILIFI,CHONYI,3,900,918,1818
KILIFI,CHONYI,4,929,883,1812
KILIFI,CHONYI,0 - 4,4429,4273,8702
KILIFI,CHONYI,5,1030,999,2029
KILIFI,CHONYI,6,999,962,1961
KILIFI,CHONYI,7,993,891,1884
KILIFI,CHONYI,8,971,996,1967
KILIFI,CHONYI,9,972,970,1942
KILIFI,CHONYI,05-Sep,4965,4818,9783
KILIFI,CHONYI,10,1078,1018,2096
KILIFI,CHONYI,11,967,958,1925
KILIFI,CHONYI,12,1025,990,2015
KILIFI,CHONYI,13,1007,1001,2008
KILIFI,CHONYI,14,943,933,1876
KILIFI,CHONYI,Oct-14,5020,4900,9920
KILIFI,CHONYI,15,886,909,1795
KILIFI,CHONYI,16,887,864,1751
KILIFI,CHONYI,17,900,818,1718
KILIFI,CHONYI,18,779,689,1468
KILIFI,CHONYI,19,750,744,1494
KILIFI,CHONYI,15-19,4202,4024,8226
KILIFI,CHONYI,20,673,686,1359
KILIFI,CHONYI,21,515,506,1021
KILIFI,CHONYI,22,443,468,911
KILIFI,CHONYI,23,412,514,926
KILIFI,CHONYI,24,372,429,801
KILIFI,CHONYI,20-24,2415,2603,5018
KILIFI,CHONYI,25,399,422,821
KILIFI,CHONYI,26,310,423,733
KILIFI,CHONYI,27,273,375,648
KILIFI,CHONYI,28,245,354,599
KILIFI,CHONYI,29,211,305,516
KILIFI,CHONYI,25-29,1438,1879,3317
KILIFI,CHONYI,30,276,458,734
KILIFI,CHONYI,31,196,330,526
KILIFI,CHONYI,32,248,459,707
KILIFI,CHONYI,33,186,379,565
KILIFI,CHONYI,34,195,353,548
KILIFI,CHONYI,30-34,1101,1979,3080
KILIFI,CHONYI,35,243,358,601
KILIFI,CHONYI,36,171,209,380
KILIFI,CHONYI,37,165,203,368
KILIFI,CHONYI,38,112,148,260
KILIFI,CHONYI,39,141,132,273
KILIFI,CHONYI,35-39,832,1050,1882
KILIFI,CHONYI,40,186,260,446
KILIFI,CHONYI,41,220,323,543
KILIFI,CHONYI,42,202,361,563
KILIFI,CHONYI,43,150,280,430
KILIFI,CHONYI,44,145,212,357
KILIFI,CHONYI,40-44,903,1436,2339
KILIFI,CHONYI,45,240,261,501
KILIFI,CHONYI,46,145,180,325
KILIFI,CHONYI,47,169,193,362
KILIFI,CHONYI,48,127,126,253
KILIFI,CHONYI,49,138,147,285
KILIFI,CHONYI,45-49,819,907,1726
KILIFI,CHONYI,50,207,395,602
KILIFI,CHONYI,51,180,261,441
KILIFI,CHONYI,52,147,197,344
KILIFI,CHONYI,53,100,86,186
KILIFI,CHONYI,54,103,75,178
KILIFI,CHONYI,50-54,737,1014,1751
KILIFI,CHONYI,55,145,93,238
KILIFI,CHONYI,56,172,180,352
KILIFI,CHONYI,57,132,151,283
KILIFI,CHONYI,58,109,137,246
KILIFI,CHONYI,59,124,236,360
KILIFI,CHONYI,55-59,682,797,1479
KILIFI,CHONYI,60,169,387,556
KILIFI,CHONYI,61,86,195,281
KILIFI,CHONYI,62,99,155,254
KILIFI,CHONYI,63,141,189,330
KILIFI,CHONYI,64,124,133,257
KILIFI,CHONYI,60-64,619,1059,1678
KILIFI,CHONYI,65,143,215,358
KILIFI,CHONYI,66,115,96,211
KILIFI,CHONYI,67,130,121,251
KILIFI,CHONYI,68,68,79,147
KILIFI,CHONYI,69,93,183,276
KILIFI,CHONYI,65-69,549,694,1243
KILIFI,CHONYI,70,118,243,361
KILIFI,CHONYI,71,63,96,159
KILIFI,CHONYI,72,78,74,152
KILIFI,CHONYI,73,59,66,125
KILIFI,CHONYI,74,71,101,172
KILIFI,CHONYI,70-74,389,580,969
KILIFI,CHONYI,75,72,138,210
KILIFI,CHONYI,76,29,59,88
KILIFI,CHONYI,77,61,51,112
KILIFI,CHONYI,78,23,31,54
KILIFI,CHONYI,79,35,86,121
KILIFI,CHONYI,75-79,220,365,585
KILIFI,CHONYI,80,42,116,158
KILIFI,CHONYI,81,22,49,71
KILIFI,CHONYI,82,15,23,38
KILIFI,CHONYI,83,20,21,41
KILIFI,CHONYI,84,19,37,56
KILIFI,CHONYI,80-84,118,246,364
KILIFI,CHONYI,85,15,34,49
KILIFI,CHONYI,86,8,14,22
KILIFI,CHONYI,87,14,15,29
KILIFI,CHONYI,88,6,5,11
KILIFI,CHONYI,89,13,34,47
KILIFI,CHONYI,85-89,56,102,158
KILIFI,CHONYI,90,10,24,34
KILIFI,CHONYI,91,3,6,9
KILIFI,CHONYI,92,1,3,4
KILIFI,CHONYI,93,2,6,8
KILIFI,CHONYI,94,2,8,10
KILIFI,CHONYI,90-94,18,47,65
KILIFI,CHONYI,95,2,8,10
KILIFI,CHONYI,96,3,7,10
KILIFI,CHONYI,97,2,3,5
KILIFI,CHONYI,98,2,-,2
KILIFI,CHONYI,99,1,9,10
KILIFI,CHONYI,95-99,10,27,37
KILIFI,CHONYI,100+,5,7,12
KILIFI,CHONYI,Not Stated,-,-,-
KILIFI,GANZE,Total,66921,76981,143902
KILIFI,GANZE,0,2003,1971,3974
KILIFI,GANZE,1,2043,2063,4106
KILIFI,GANZE,2,2151,2272,4423
KILIFI,GANZE,3,2306,2249,4555
KILIFI,GANZE,4,2442,2343,4785
KILIFI,GANZE,0 - 4,10945,10898,21843
KILIFI,GANZE,5,2461,2550,5011
KILIFI,GANZE,6,2425,2334,4759
KILIFI,GANZE,7,2216,2074,4290
KILIFI,GANZE,8,2377,2314,4691
KILIFI,GANZE,9,2293,2415,4708
KILIFI,GANZE,05-Sep,11772,11687,23459
KILIFI,GANZE,10,2379,2285,4664
KILIFI,GANZE,11,2449,2451,4900
KILIFI,GANZE,12,2502,2471,4973
KILIFI,GANZE,13,2490,2432,4922
KILIFI,GANZE,14,2255,2119,4374
KILIFI,GANZE,Oct-14,12075,11758,23833
KILIFI,GANZE,15,2276,2259,4535
KILIFI,GANZE,16,2012,2027,4039
KILIFI,GANZE,17,2050,1944,3994
KILIFI,GANZE,18,1732,1679,3411
KILIFI,GANZE,19,1624,1631,3255
KILIFI,GANZE,15-19,9694,9540,19234
KILIFI,GANZE,20,1445,1497,2942
KILIFI,GANZE,21,1112,1107,2219
KILIFI,GANZE,22,819,1049,1868
KILIFI,GANZE,23,790,1053,1843
KILIFI,GANZE,24,678,913,1591
KILIFI,GANZE,20-24,4844,5619,10463
KILIFI,GANZE,25,769,956,1725
KILIFI,GANZE,26,581,783,1364
KILIFI,GANZE,27,563,853,1416
KILIFI,GANZE,28,460,721,1181
KILIFI,GANZE,29,507,839,1346
KILIFI,GANZE,25-29,2880,4152,7032
KILIFI,GANZE,30,564,985,1549
KILIFI,GANZE,31,472,943,1415
KILIFI,GANZE,32,530,1117,1647
KILIFI,GANZE,33,481,1024,1505
KILIFI,GANZE,34,440,1009,1449
KILIFI,GANZE,30-34,2487,5078,7565
KILIFI,GANZE,35,571,964,1535
KILIFI,GANZE,36,395,648,1043
KILIFI,GANZE,37,360,523,883
KILIFI,GANZE,38,230,343,573
KILIFI,GANZE,39,299,348,647
KILIFI,GANZE,35-39,1855,2826,4681
KILIFI,GANZE,40,339,389,728
KILIFI,GANZE,41,558,854,1412
KILIFI,GANZE,42,420,724,1144
KILIFI,GANZE,43,354,682,1036
KILIFI,GANZE,44,304,456,760
KILIFI,GANZE,40-44,1975,3105,5080
KILIFI,GANZE,45,427,604,1031
KILIFI,GANZE,46,309,395,704
KILIFI,GANZE,47,323,365,688
KILIFI,GANZE,48,229,291,520
KILIFI,GANZE,49,272,348,620
KILIFI,GANZE,45-49,1560,2003,3563
KILIFI,GANZE,50,406,809,1215
KILIFI,GANZE,51,305,510,815
KILIFI,GANZE,52,240,401,641
KILIFI,GANZE,53,224,195,419
KILIFI,GANZE,54,202,170,372
KILIFI,GANZE,50-54,1377,2085,3462
KILIFI,GANZE,55,197,118,315
KILIFI,GANZE,56,246,228,474
KILIFI,GANZE,57,298,410,708
KILIFI,GANZE,58,216,405,621
KILIFI,GANZE,59,261,750,1011
KILIFI,GANZE,55-59,1218,1911,3129
KILIFI,GANZE,60,294,599,893
KILIFI,GANZE,61,263,516,779
KILIFI,GANZE,62,244,405,649
KILIFI,GANZE,63,251,492,743
KILIFI,GANZE,64,222,267,489
KILIFI,GANZE,60-64,1274,2279,3553
KILIFI,GANZE,65,255,442,697
KILIFI,GANZE,66,222,188,410
KILIFI,GANZE,67,275,236,511
KILIFI,GANZE,68,135,124,259
KILIFI,GANZE,69,222,493,715
KILIFI,GANZE,65-69,1109,1483,2592
KILIFI,GANZE,70,218,341,559
KILIFI,GANZE,71,156,220,376
KILIFI,GANZE,72,113,103,216
KILIFI,GANZE,73,102,118,220
KILIFI,GANZE,74,139,160,299
KILIFI,GANZE,70-74,728,942,1670
KILIFI,GANZE,75,207,309,516
KILIFI,GANZE,76,76,96,172
KILIFI,GANZE,77,100,94,194
KILIFI,GANZE,78,49,39,88
KILIFI,GANZE,79,124,204,328
KILIFI,GANZE,75-79,556,742,1298
KILIFI,GANZE,80,78,159,237
KILIFI,GANZE,81,61,70,131
KILIFI,GANZE,82,36,37,73
KILIFI,GANZE,83,45,81,126
KILIFI,GANZE,84,48,60,108
KILIFI,GANZE,80-84,268,407,675
KILIFI,GANZE,85,30,58,88
KILIFI,GANZE,86,27,25,52
KILIFI,GANZE,87,59,87,146
KILIFI,GANZE,88,10,26,36
KILIFI,GANZE,89,68,83,151
KILIFI,GANZE,85-89,194,279,473
KILIFI,GANZE,90,15,38,53
KILIFI,GANZE,91,21,29,50
KILIFI,GANZE,92,11,15,26
KILIFI,GANZE,93,6,9,15
KILIFI,GANZE,94,12,12,24
KILIFI,GANZE,90-94,65,103,168
KILIFI,GANZE,95,6,16,22
KILIFI,GANZE,96,4,4,8
KILIFI,GANZE,97,6,5,11
KILIFI,GANZE,98,3,8,11
KILIFI,GANZE,99,10,21,31
KILIFI,GANZE,95-99,29,54,83
KILIFI,GANZE,100+,15,27,42
KILIFI,GANZE,Not Stated,1,3,4
KILIFI,KALOLENI,Total,92614,101063,193677
KILIFI,KALOLENI,0,2512,2525,5037
KILIFI,KALOLENI,1,2628,2809,5437
KILIFI,KALOLENI,2,2874,2846,5720
KILIFI,KALOLENI,3,2863,2849,5712
KILIFI,KALOLENI,4,2903,2856,5759
KILIFI,KALOLENI,0 - 4,13780,13885,27665
KILIFI,KALOLENI,5,3048,3036,6084
KILIFI,KALOLENI,6,2885,2938,5823
KILIFI,KALOLENI,7,2781,2703,5484
KILIFI,KALOLENI,8,2833,2789,5622
KILIFI,KALOLENI,9,2913,2865,5778
KILIFI,KALOLENI,05-Sep,14460,14331,28791
KILIFI,KALOLENI,10,2967,3016,5983
KILIFI,KALOLENI,11,2833,2934,5767
KILIFI,KALOLENI,12,3064,2926,5990
KILIFI,KALOLENI,13,3000,3035,6035
KILIFI,KALOLENI,14,2723,2716,5439
KILIFI,KALOLENI,Oct-14,14587,14627,29214
KILIFI,KALOLENI,15,2637,2523,5160
KILIFI,KALOLENI,16,2468,2424,4892
KILIFI,KALOLENI,17,2435,2281,4716
KILIFI,KALOLENI,18,2215,1968,4183
KILIFI,KALOLENI,19,2091,2069,4160
KILIFI,KALOLENI,15-19,11846,11265,23111
KILIFI,KALOLENI,20,1854,2026,3880
KILIFI,KALOLENI,21,1417,1583,3000
KILIFI,KALOLENI,22,1431,1635,3066
KILIFI,KALOLENI,23,1409,1765,3174
KILIFI,KALOLENI,24,1277,1530,2807
KILIFI,KALOLENI,20-24,7388,8539,15927
KILIFI,KALOLENI,25,1377,1569,2946
KILIFI,KALOLENI,26,1208,1587,2795
KILIFI,KALOLENI,27,1218,1557,2775
KILIFI,KALOLENI,28,1053,1468,2521
KILIFI,KALOLENI,29,1008,1492,2500
KILIFI,KALOLENI,25-29,5864,7673,13537
KILIFI,KALOLENI,30,1303,1802,3105
KILIFI,KALOLENI,31,892,1300,2192
KILIFI,KALOLENI,32,1059,1412,2471
KILIFI,KALOLENI,33,834,1297,2131
KILIFI,KALOLENI,34,822,1164,1986
KILIFI,KALOLENI,30-34,4910,6975,11885
KILIFI,KALOLENI,35,1015,1241,2256
KILIFI,KALOLENI,36,704,799,1503
KILIFI,KALOLENI,37,773,767,1540
KILIFI,KALOLENI,38,554,603,1157
KILIFI,KALOLENI,39,618,603,1221
KILIFI,KALOLENI,35-39,3664,4013,7677
KILIFI,KALOLENI,40,802,758,1560
KILIFI,KALOLENI,41,915,932,1847
KILIFI,KALOLENI,42,725,896,1621
KILIFI,KALOLENI,43,636,725,1361
KILIFI,KALOLENI,44,530,570,1100
KILIFI,KALOLENI,40-44,3608,3881,7489
KILIFI,KALOLENI,45,856,935,1791
KILIFI,KALOLENI,46,580,661,1241
KILIFI,KALOLENI,47,609,669,1278
KILIFI,KALOLENI,48,433,433,866
KILIFI,KALOLENI,49,488,492,980
KILIFI,KALOLENI,45-49,2966,3190,6156
KILIFI,KALOLENI,50,724,907,1631
KILIFI,KALOLENI,51,540,563,1103
KILIFI,KALOLENI,52,426,469,895
KILIFI,KALOLENI,53,331,300,631
KILIFI,KALOLENI,54,322,276,598
KILIFI,KALOLENI,50-54,2343,2515,4858
KILIFI,KALOLENI,55,339,249,588
KILIFI,KALOLENI,56,520,540,1060
KILIFI,KALOLENI,57,415,521,936
KILIFI,KALOLENI,58,317,357,674
KILIFI,KALOLENI,59,373,676,1049
KILIFI,KALOLENI,55-59,1964,2343,4307
KILIFI,KALOLENI,60,473,807,1280
KILIFI,KALOLENI,61,326,578,904
KILIFI,KALOLENI,62,350,383,733
KILIFI,KALOLENI,63,303,485,788
KILIFI,KALOLENI,64,273,350,623
KILIFI,KALOLENI,60-64,1725,2603,4328
KILIFI,KALOLENI,65,396,477,873
KILIFI,KALOLENI,66,246,218,464
KILIFI,KALOLENI,67,325,307,632
KILIFI,KALOLENI,68,183,184,367
KILIFI,KALOLENI,69,273,486,759
KILIFI,KALOLENI,65-69,1423,1672,3095
KILIFI,KALOLENI,70,298,574,872
KILIFI,KALOLENI,71,196,306,502
KILIFI,KALOLENI,72,147,210,357
KILIFI,KALOLENI,73,136,205,341
KILIFI,KALOLENI,74,160,194,354
KILIFI,KALOLENI,70-74,937,1489,2426
KILIFI,KALOLENI,75,177,353,530
KILIFI,KALOLENI,76,93,123,216
KILIFI,KALOLENI,77,111,158,269
KILIFI,KALOLENI,78,78,69,147
KILIFI,KALOLENI,79,109,236,345
KILIFI,KALOLENI,75-79,568,939,1507
KILIFI,KALOLENI,80,104,206,310
KILIFI,KALOLENI,81,60,108,168
KILIFI,KALOLENI,82,50,71,121
KILIFI,KALOLENI,83,47,62,109
KILIFI,KALOLENI,84,32,80,112
KILIFI,KALOLENI,80-84,293,527,820
KILIFI,KALOLENI,85,52,119,171
KILIFI,KALOLENI,86,23,30,53
KILIFI,KALOLENI,87,34,67,101
KILIFI,KALOLENI,88,20,18,38
KILIFI,KALOLENI,89,42,112,154
KILIFI,KALOLENI,85-89,171,346,517
KILIFI,KALOLENI,90,22,60,82
KILIFI,KALOLENI,91,15,27,42
KILIFI,KALOLENI,92,6,16,22
KILIFI,KALOLENI,93,11,13,24
KILIFI,KALOLENI,94,8,19,27
KILIFI,KALOLENI,90-94,62,135,197
KILIFI,KALOLENI,95,11,22,33
KILIFI,KALOLENI,96,4,10,14
KILIFI,KALOLENI,97,8,10,18
KILIFI,KALOLENI,98,3,11,14
KILIFI,KALOLENI,99,13,17,30
KILIFI,KALOLENI,95-99,39,70,109
KILIFI,KALOLENI,100+,14,44,58
KILIFI,KALOLENI,Not Stated,2,1,3
KILIFI,KAUMA,Total,10965,11673,22638
KILIFI,KAUMA,0,283,281,564
KILIFI,KAUMA,1,301,307,608
KILIFI,KAUMA,2,313,307,620
KILIFI,KAUMA,3,284,337,621
KILIFI,KAUMA,4,306,312,618
KILIFI,KAUMA,0 - 4,1487,1544,3031
KILIFI,KAUMA,5,342,355,697
KILIFI,KAUMA,6,361,311,672
KILIFI,KAUMA,7,313,329,642
KILIFI,KAUMA,8,321,341,662
KILIFI,KAUMA,9,363,345,708
KILIFI,KAUMA,05-Sep,1700,1681,3381
KILIFI,KAUMA,10,342,399,741
KILIFI,KAUMA,11,355,358,713
KILIFI,KAUMA,12,374,393,767
KILIFI,KAUMA,13,349,360,709
KILIFI,KAUMA,14,365,344,709
KILIFI,KAUMA,Oct-14,1785,1854,3639
KILIFI,KAUMA,15,342,340,682
KILIFI,KAUMA,16,345,334,679
KILIFI,KAUMA,17,338,303,641
KILIFI,KAUMA,18,270,247,517
KILIFI,KAUMA,19,331,261,592
KILIFI,KAUMA,15-19,1626,1485,3111
KILIFI,KAUMA,20,276,268,544
KILIFI,KAUMA,21,224,200,424
KILIFI,KAUMA,22,178,182,360
KILIFI,KAUMA,23,176,182,358
KILIFI,KAUMA,24,171,143,314
KILIFI,KAUMA,20-24,1025,975,2000
KILIFI,KAUMA,25,171,139,310
KILIFI,KAUMA,26,143,178,321
KILIFI,KAUMA,27,131,147,278
KILIFI,KAUMA,28,96,125,221
KILIFI,KAUMA,29,91,123,214
KILIFI,KAUMA,25-29,632,712,1344
KILIFI,KAUMA,30,111,161,272
KILIFI,KAUMA,31,74,127,201
KILIFI,KAUMA,32,89,156,245
KILIFI,KAUMA,33,100,132,232
KILIFI,KAUMA,34,87,118,205
KILIFI,KAUMA,30-34,461,694,1155
KILIFI,KAUMA,35,112,147,259
KILIFI,KAUMA,36,62,98,160
KILIFI,KAUMA,37,70,60,130
KILIFI,KAUMA,38,42,66,108
KILIFI,KAUMA,39,62,57,119
KILIFI,KAUMA,35-39,348,428,776
KILIFI,KAUMA,40,88,82,170
KILIFI,KAUMA,41,103,135,238
KILIFI,KAUMA,42,98,130,228
KILIFI,KAUMA,43,64,100,164
KILIFI,KAUMA,44,62,65,127
KILIFI,KAUMA,40-44,415,512,927
KILIFI,KAUMA,45,103,124,227
KILIFI,KAUMA,46,50,61,111
KILIFI,KAUMA,47,61,70,131
KILIFI,KAUMA,48,37,33,70
KILIFI,KAUMA,49,60,49,109
KILIFI,KAUMA,45-49,311,337,648
KILIFI,KAUMA,50,66,91,157
KILIFI,KAUMA,51,56,83,139
KILIFI,KAUMA,52,51,47,98
KILIFI,KAUMA,53,44,35,79
KILIFI,KAUMA,54,37,38,75
KILIFI,KAUMA,50-54,254,294,548
KILIFI,KAUMA,55,36,18,54
KILIFI,KAUMA,56,56,45,101
KILIFI,KAUMA,57,54,56,110
KILIFI,KAUMA,58,61,76,137
KILIFI,KAUMA,59,50,111,161
KILIFI,KAUMA,55-59,257,306,563
KILIFI,KAUMA,60,44,102,146
KILIFI,KAUMA,61,34,86,120
KILIFI,KAUMA,62,39,48,87
KILIFI,KAUMA,63,33,57,90
KILIFI,KAUMA,64,33,27,60
KILIFI,KAUMA,60-64,183,320,503
KILIFI,KAUMA,65,46,55,101
KILIFI,KAUMA,66,42,12,54
KILIFI,KAUMA,67,50,43,93
KILIFI,KAUMA,68,30,14,44
KILIFI,KAUMA,69,21,37,58
KILIFI,KAUMA,65-69,189,161,350
KILIFI,KAUMA,70,36,52,88
KILIFI,KAUMA,71,40,28,68
KILIFI,KAUMA,72,19,16,35
KILIFI,KAUMA,73,27,16,43
KILIFI,KAUMA,74,32,19,51
KILIFI,KAUMA,70-74,154,131,285
KILIFI,KAUMA,75,20,46,66
KILIFI,KAUMA,76,13,17,30
KILIFI,KAUMA,77,10,15,25
KILIFI,KAUMA,78,5,9,14
KILIFI,KAUMA,79,19,26,45
KILIFI,KAUMA,75-79,67,113,180
KILIFI,KAUMA,80,7,28,35
KILIFI,KAUMA,81,6,11,17
KILIFI,KAUMA,82,5,4,9
KILIFI,KAUMA,83,5,3,8
KILIFI,KAUMA,84,8,8,16
KILIFI,KAUMA,80-84,31,54,85
KILIFI,KAUMA,85,6,10,16
KILIFI,KAUMA,86,1,3,4
KILIFI,KAUMA,87,6,18,24
KILIFI,KAUMA,88,3,1,4
KILIFI,KAUMA,89,5,17,22
KILIFI,KAUMA,85-89,21,49,70
KILIFI,KAUMA,90,4,7,11
KILIFI,KAUMA,91,3,4,7
KILIFI,KAUMA,92,-,4,4
KILIFI,KAUMA,93,-,2,2
KILIFI,KAUMA,94,3,-,3
KILIFI,KAUMA,90-94,10,17,27
KILIFI,KAUMA,95,3,1,4
KILIFI,KAUMA,96,-,1,1
KILIFI,KAUMA,97,-,1,1
KILIFI,KAUMA,98,2,-,2
KILIFI,KAUMA,99,1,2,3
KILIFI,KAUMA,95-99,6,5,11
KILIFI,KAUMA,100+,3,1,4
KILIFI,KAUMA,Not Stated,-,-,-
KILIFI,KILIFI NORTH,Total,86986,91836,178822
KILIFI,KILIFI NORTH,0,2392,2349,4741
KILIFI,KILIFI NORTH,1,2509,2331,4840
KILIFI,KILIFI NORTH,2,2474,2549,5023
KILIFI,KILIFI NORTH,3,2377,2409,4786
KILIFI,KILIFI NORTH,4,2455,2403,4858
KILIFI,KILIFI NORTH,0 - 4,12207,12041,24248
KILIFI,KILIFI NORTH,5,2510,2413,4923
KILIFI,KILIFI NORTH,6,2371,2399,4770
KILIFI,KILIFI NORTH,7,2337,2243,4580
KILIFI,KILIFI NORTH,8,2296,2306,4602
KILIFI,KILIFI NORTH,9,2362,2290,4652
KILIFI,KILIFI NORTH,05-Sep,11876,11651,23527
KILIFI,KILIFI NORTH,10,2440,2461,4901
KILIFI,KILIFI NORTH,11,2394,2375,4769
KILIFI,KILIFI NORTH,12,2416,2413,4829
KILIFI,KILIFI NORTH,13,2423,2420,4843
KILIFI,KILIFI NORTH,14,2171,2254,4425
KILIFI,KILIFI NORTH,Oct-14,11844,11923,23767
KILIFI,KILIFI NORTH,15,2160,2115,4275
KILIFI,KILIFI NORTH,16,1987,1957,3944
KILIFI,KILIFI NORTH,17,2145,2066,4211
KILIFI,KILIFI NORTH,18,1877,1860,3737
KILIFI,KILIFI NORTH,19,2095,2147,4242
KILIFI,KILIFI NORTH,15-19,10264,10145,20409
KILIFI,KILIFI NORTH,20,1907,2202,4109
KILIFI,KILIFI NORTH,21,1723,1830,3553
KILIFI,KILIFI NORTH,22,1843,2142,3985
KILIFI,KILIFI NORTH,23,1826,2004,3830
KILIFI,KILIFI NORTH,24,1550,1828,3378
KILIFI,KILIFI NORTH,20-24,8849,10006,18855
KILIFI,KILIFI NORTH,25,1790,1968,3758
KILIFI,KILIFI NORTH,26,1645,1788,3433
KILIFI,KILIFI NORTH,27,1565,1657,3222
KILIFI,KILIFI NORTH,28,1234,1402,2636
KILIFI,KILIFI NORTH,29,1310,1436,2746
KILIFI,KILIFI NORTH,25-29,7544,8251,15795
KILIFI,KILIFI NORTH,30,1473,1785,3258
KILIFI,KILIFI NORTH,31,1071,1187,2258
KILIFI,KILIFI NORTH,32,1247,1478,2725
KILIFI,KILIFI NORTH,33,1003,1282,2285
KILIFI,KILIFI NORTH,34,1001,1130,2131
KILIFI,KILIFI NORTH,30-34,5795,6862,12657
KILIFI,KILIFI NORTH,35,1214,1249,2463
KILIFI,KILIFI NORTH,36,828,881,1709
KILIFI,KILIFI NORTH,37,880,824,1704
KILIFI,KILIFI NORTH,38,600,635,1235
KILIFI,KILIFI NORTH,39,758,708,1466
KILIFI,KILIFI NORTH,35-39,4280,4297,8577
KILIFI,KILIFI NORTH,40,872,897,1769
KILIFI,KILIFI NORTH,41,901,1053,1954
KILIFI,KILIFI NORTH,42,785,989,1774
KILIFI,KILIFI NORTH,43,662,801,1463
KILIFI,KILIFI NORTH,44,601,588,1189
KILIFI,KILIFI NORTH,40-44,3821,4328,8149
KILIFI,KILIFI NORTH,45,856,801,1657
KILIFI,KILIFI NORTH,46,564,574,1138
KILIFI,KILIFI NORTH,47,635,609,1244
KILIFI,KILIFI NORTH,48,441,417,858
KILIFI,KILIFI NORTH,49,472,528,1000
KILIFI,KILIFI NORTH,45-49,2968,2929,5897
KILIFI,KILIFI NORTH,50,657,829,1486
KILIFI,KILIFI NORTH,51,445,513,958
KILIFI,KILIFI NORTH,52,405,403,808
KILIFI,KILIFI NORTH,53,299,253,552
KILIFI,KILIFI NORTH,54,382,292,674
KILIFI,KILIFI NORTH,50-54,2188,2290,4478
KILIFI,KILIFI NORTH,55,351,255,606
KILIFI,KILIFI NORTH,56,399,362,761
KILIFI,KILIFI NORTH,57,376,394,770
KILIFI,KILIFI NORTH,58,255,344,599
KILIFI,KILIFI NORTH,59,303,534,837
KILIFI,KILIFI NORTH,55-59,1684,1889,3573
KILIFI,KILIFI NORTH,60,354,594,948
KILIFI,KILIFI NORTH,61,255,432,687
KILIFI,KILIFI NORTH,62,229,304,533
KILIFI,KILIFI NORTH,63,241,338,579
KILIFI,KILIFI NORTH,64,199,253,452
KILIFI,KILIFI NORTH,60-64,1278,1921,3199
KILIFI,KILIFI NORTH,65,287,347,634
KILIFI,KILIFI NORTH,66,193,165,358
KILIFI,KILIFI NORTH,67,258,237,495
KILIFI,KILIFI NORTH,68,118,136,254
KILIFI,KILIFI NORTH,69,164,261,425
KILIFI,KILIFI NORTH,65-69,1020,1146,2166
KILIFI,KILIFI NORTH,70,175,357,532
KILIFI,KILIFI NORTH,71,138,181,319
KILIFI,KILIFI NORTH,72,90,145,235
KILIFI,KILIFI NORTH,73,110,114,224
KILIFI,KILIFI NORTH,74,96,172,268
KILIFI,KILIFI NORTH,70-74,609,969,1578
KILIFI,KILIFI NORTH,75,112,155,267
KILIFI,KILIFI NORTH,76,58,105,163
KILIFI,KILIFI NORTH,77,71,92,163
KILIFI,KILIFI NORTH,78,57,69,126
KILIFI,KILIFI NORTH,79,55,139,194
KILIFI,KILIFI NORTH,75-79,353,560,913
KILIFI,KILIFI NORTH,80,63,129,192
KILIFI,KILIFI NORTH,81,46,45,91
KILIFI,KILIFI NORTH,82,34,46,80
KILIFI,KILIFI NORTH,83,27,44,71
KILIFI,KILIFI NORTH,84,33,41,74
KILIFI,KILIFI NORTH,80-84,203,305,508
KILIFI,KILIFI NORTH,85,34,55,89
KILIFI,KILIFI NORTH,86,22,26,48
KILIFI,KILIFI NORTH,87,17,39,56
KILIFI,KILIFI NORTH,88,18,17,35
KILIFI,KILIFI NORTH,89,34,49,83
KILIFI,KILIFI NORTH,85-89,125,186,311
KILIFI,KILIFI NORTH,90,16,35,51
KILIFI,KILIFI NORTH,91,12,19,31
KILIFI,KILIFI NORTH,92,5,6,11
KILIFI,KILIFI NORTH,93,10,7,17
KILIFI,KILIFI NORTH,94,4,8,12
KILIFI,KILIFI NORTH,90-94,47,75,122
KILIFI,KILIFI NORTH,95,4,19,23
KILIFI,KILIFI NORTH,96,4,6,10
KILIFI,KILIFI NORTH,97,2,3,5
KILIFI,KILIFI NORTH,98,3,2,5
KILIFI,KILIFI NORTH,99,5,9,14
KILIFI,KILIFI NORTH,95-99,18,39,57
KILIFI,KILIFI NORTH,100+,13,23,36
KILIFI,KILIFI NORTH,Not Stated,-,-,-
KILIFI,KILIFI SOUTH,Total,101852,104897,206749
KILIFI,KILIFI SOUTH,0,2663,2752,5415
KILIFI,KILIFI SOUTH,1,2815,2749,5564
KILIFI,KILIFI SOUTH,2,2713,2601,5314
KILIFI,KILIFI SOUTH,3,2564,2600,5164
KILIFI,KILIFI SOUTH,4,2643,2602,5245
KILIFI,KILIFI SOUTH,0 - 4,13398,13304,26702
KILIFI,KILIFI SOUTH,5,2829,2645,5474
KILIFI,KILIFI SOUTH,6,2677,2669,5346
KILIFI,KILIFI SOUTH,7,2678,2564,5242
KILIFI,KILIFI SOUTH,8,2465,2486,4951
KILIFI,KILIFI SOUTH,9,2612,2653,5265
KILIFI,KILIFI SOUTH,05-Sep,13261,13017,26278
KILIFI,KILIFI SOUTH,10,2617,2609,5226
KILIFI,KILIFI SOUTH,11,2402,2411,4813
KILIFI,KILIFI SOUTH,12,2595,2483,5078
KILIFI,KILIFI SOUTH,13,2617,2710,5327
KILIFI,KILIFI SOUTH,14,2459,2389,4848
KILIFI,KILIFI SOUTH,Oct-14,12690,12602,25292
KILIFI,KILIFI SOUTH,15,2323,2228,4551
KILIFI,KILIFI SOUTH,16,2142,2226,4368
KILIFI,KILIFI SOUTH,17,2234,2233,4467
KILIFI,KILIFI SOUTH,18,1980,1985,3965
KILIFI,KILIFI SOUTH,19,2177,2291,4468
KILIFI,KILIFI SOUTH,15-19,10856,10963,21819
KILIFI,KILIFI SOUTH,20,2204,2532,4736
KILIFI,KILIFI SOUTH,21,1913,2262,4175
KILIFI,KILIFI SOUTH,22,2151,2558,4709
KILIFI,KILIFI SOUTH,23,2237,2608,4845
KILIFI,KILIFI SOUTH,24,2142,2474,4616
KILIFI,KILIFI SOUTH,20-24,10647,12434,23081
KILIFI,KILIFI SOUTH,25,2375,2644,5019
KILIFI,KILIFI SOUTH,26,2114,2373,4487
KILIFI,KILIFI SOUTH,27,2157,2202,4359
KILIFI,KILIFI SOUTH,28,1746,2000,3746
KILIFI,KILIFI SOUTH,29,1686,1832,3518
KILIFI,KILIFI SOUTH,25-29,10078,11051,21129
KILIFI,KILIFI SOUTH,30,2124,2388,4512
KILIFI,KILIFI SOUTH,31,1420,1420,2840
KILIFI,KILIFI SOUTH,32,1695,1893,3588
KILIFI,KILIFI SOUTH,33,1291,1493,2784
KILIFI,KILIFI SOUTH,34,1270,1515,2785
KILIFI,KILIFI SOUTH,30-34,7800,8709,16509
KILIFI,KILIFI SOUTH,35,1650,1692,3342
KILIFI,KILIFI SOUTH,36,1173,1072,2245
KILIFI,KILIFI SOUTH,37,1136,1027,2163
KILIFI,KILIFI SOUTH,38,931,858,1789
KILIFI,KILIFI SOUTH,39,874,889,1763
KILIFI,KILIFI SOUTH,35-39,5764,5538,11302
KILIFI,KILIFI SOUTH,40,1201,1116,2317
KILIFI,KILIFI SOUTH,41,1088,1104,2192
KILIFI,KILIFI SOUTH,42,1116,1176,2292
KILIFI,KILIFI SOUTH,43,826,832,1658
KILIFI,KILIFI SOUTH,44,737,676,1413
KILIFI,KILIFI SOUTH,40-44,4968,4904,9872
KILIFI,KILIFI SOUTH,45,1220,983,2203
KILIFI,KILIFI SOUTH,46,727,648,1375
KILIFI,KILIFI SOUTH,47,787,651,1438
KILIFI,KILIFI SOUTH,48,601,468,1069
KILIFI,KILIFI SOUTH,49,604,478,1082
KILIFI,KILIFI SOUTH,45-49,3939,3228,7167
KILIFI,KILIFI SOUTH,50,856,872,1728
KILIFI,KILIFI SOUTH,51,508,456,964
KILIFI,KILIFI SOUTH,52,483,405,888
KILIFI,KILIFI SOUTH,53,358,295,653
KILIFI,KILIFI SOUTH,54,379,272,651
KILIFI,KILIFI SOUTH,50-54,2584,2300,4884
KILIFI,KILIFI SOUTH,55,395,300,695
KILIFI,KILIFI SOUTH,56,463,401,864
KILIFI,KILIFI SOUTH,57,399,383,782
KILIFI,KILIFI SOUTH,58,354,321,675
KILIFI,KILIFI SOUTH,59,379,432,811
KILIFI,KILIFI SOUTH,55-59,1990,1837,3827
KILIFI,KILIFI SOUTH,60,400,652,1052
KILIFI,KILIFI SOUTH,61,272,370,642
KILIFI,KILIFI SOUTH,62,265,303,568
KILIFI,KILIFI SOUTH,63,268,374,642
KILIFI,KILIFI SOUTH,64,215,205,420
KILIFI,KILIFI SOUTH,60-64,1420,1904,3324
KILIFI,KILIFI SOUTH,65,310,368,678
KILIFI,KILIFI SOUTH,66,214,180,394
KILIFI,KILIFI SOUTH,67,252,271,523
KILIFI,KILIFI SOUTH,68,139,148,287
KILIFI,KILIFI SOUTH,69,173,265,438
KILIFI,KILIFI SOUTH,65-69,1088,1232,2320
KILIFI,KILIFI SOUTH,70,216,340,556
KILIFI,KILIFI SOUTH,71,139,172,311
KILIFI,KILIFI SOUTH,72,104,87,191
KILIFI,KILIFI SOUTH,73,106,103,209
KILIFI,KILIFI SOUTH,74,109,137,246
KILIFI,KILIFI SOUTH,70-74,674,839,1513
KILIFI,KILIFI SOUTH,75,101,132,233
KILIFI,KILIFI SOUTH,76,93,77,170
KILIFI,KILIFI SOUTH,77,79,85,164
KILIFI,KILIFI SOUTH,78,46,59,105
KILIFI,KILIFI SOUTH,79,52,102,154
KILIFI,KILIFI SOUTH,75-79,371,455,826
KILIFI,KILIFI SOUTH,80,75,128,203
KILIFI,KILIFI SOUTH,81,30,53,83
KILIFI,KILIFI SOUTH,82,28,36,64
KILIFI,KILIFI SOUTH,83,31,41,72
KILIFI,KILIFI SOUTH,84,30,40,70
KILIFI,KILIFI SOUTH,80-84,194,298,492
KILIFI,KILIFI SOUTH,85,25,42,67
KILIFI,KILIFI SOUTH,86,10,13,23
KILIFI,KILIFI SOUTH,87,22,32,54
KILIFI,KILIFI SOUTH,88,8,9,17
KILIFI,KILIFI SOUTH,89,20,34,54
KILIFI,KILIFI SOUTH,85-89,85,130,215
KILIFI,KILIFI SOUTH,90,7,35,42
KILIFI,KILIFI SOUTH,91,4,11,15
KILIFI,KILIFI SOUTH,92,1,7,8
KILIFI,KILIFI SOUTH,93,-,8,8
KILIFI,KILIFI SOUTH,94,5,10,15
KILIFI,KILIFI SOUTH,90-94,17,71,88
KILIFI,KILIFI SOUTH,95,4,16,20
KILIFI,KILIFI SOUTH,96,4,6,10
KILIFI,KILIFI SOUTH,97,3,4,7
KILIFI,KILIFI SOUTH,98,4,7,11
KILIFI,KILIFI SOUTH,99,4,19,23
KILIFI,KILIFI SOUTH,95-99,19,52,71
KILIFI,KILIFI SOUTH,100+,8,28,36
KILIFI,KILIFI SOUTH,Not Stated,1,1,2
KILIFI,MAGARINI,Total,93302,98308,191610
KILIFI,MAGARINI,0,2474,2405,4879
KILIFI,MAGARINI,1,2894,2728,5622
KILIFI,MAGARINI,2,2801,2803,5604
KILIFI,MAGARINI,3,3014,3054,6068
KILIFI,MAGARINI,4,3219,3143,6362
KILIFI,MAGARINI,0 - 4,14402,14133,28535
KILIFI,MAGARINI,5,3233,3240,6473
KILIFI,MAGARINI,6,3157,3184,6341
KILIFI,MAGARINI,7,2863,2938,5801
KILIFI,MAGARINI,8,3028,3019,6047
KILIFI,MAGARINI,9,3061,2988,6049
KILIFI,MAGARINI,05-Sep,15342,15369,30711
KILIFI,MAGARINI,10,3282,3163,6445
KILIFI,MAGARINI,11,2974,3054,6028
KILIFI,MAGARINI,12,3198,3159,6357
KILIFI,MAGARINI,13,3085,3094,6179
KILIFI,MAGARINI,14,2841,2849,5690
KILIFI,MAGARINI,Oct-14,15380,15319,30699
KILIFI,MAGARINI,15,2759,2720,5479
KILIFI,MAGARINI,16,2588,2548,5136
KILIFI,MAGARINI,17,2675,2290,4965
KILIFI,MAGARINI,18,2353,2105,4458
KILIFI,MAGARINI,19,2292,2122,4414
KILIFI,MAGARINI,15-19,12667,11785,24452
KILIFI,MAGARINI,20,2115,2028,4143
KILIFI,MAGARINI,21,1560,1621,3181
KILIFI,MAGARINI,22,1548,1596,3144
KILIFI,MAGARINI,23,1488,1606,3094
KILIFI,MAGARINI,24,1186,1348,2534
KILIFI,MAGARINI,20-24,7897,8199,16096
KILIFI,MAGARINI,25,1409,1552,2961
KILIFI,MAGARINI,26,1108,1368,2476
KILIFI,MAGARINI,27,1050,1258,2308
KILIFI,MAGARINI,28,854,1186,2040
KILIFI,MAGARINI,29,855,1091,1946
KILIFI,MAGARINI,25-29,5276,6455,11731
KILIFI,MAGARINI,30,1056,1417,2473
KILIFI,MAGARINI,31,767,1131,1898
KILIFI,MAGARINI,32,922,1407,2329
KILIFI,MAGARINI,33,776,1065,1841
KILIFI,MAGARINI,34,775,1217,1992
KILIFI,MAGARINI,30-34,4296,6237,10533
KILIFI,MAGARINI,35,925,980,1905
KILIFI,MAGARINI,36,606,627,1233
KILIFI,MAGARINI,37,605,536,1141
KILIFI,MAGARINI,38,397,408,805
KILIFI,MAGARINI,39,521,482,1003
KILIFI,MAGARINI,35-39,3054,3033,6087
KILIFI,MAGARINI,40,728,749,1477
KILIFI,MAGARINI,41,785,1196,1981
KILIFI,MAGARINI,42,640,993,1633
KILIFI,MAGARINI,43,514,846,1360
KILIFI,MAGARINI,44,570,680,1250
KILIFI,MAGARINI,40-44,3237,4464,7701
KILIFI,MAGARINI,45,816,897,1713
KILIFI,MAGARINI,46,517,504,1021
KILIFI,MAGARINI,47,512,482,994
KILIFI,MAGARINI,48,454,394,848
KILIFI,MAGARINI,49,452,439,891
KILIFI,MAGARINI,45-49,2751,2716,5467
KILIFI,MAGARINI,50,689,790,1479
KILIFI,MAGARINI,51,465,521,986
KILIFI,MAGARINI,52,424,396,820
KILIFI,MAGARINI,53,313,248,561
KILIFI,MAGARINI,54,347,241,588
KILIFI,MAGARINI,50-54,2238,2196,4434
KILIFI,MAGARINI,55,360,237,597
KILIFI,MAGARINI,56,335,287,622
KILIFI,MAGARINI,57,340,401,741
KILIFI,MAGARINI,58,338,349,687
KILIFI,MAGARINI,59,359,532,891
KILIFI,MAGARINI,55-59,1732,1806,3538
KILIFI,MAGARINI,60,399,706,1105
KILIFI,MAGARINI,61,299,491,790
KILIFI,MAGARINI,62,278,405,683
KILIFI,MAGARINI,63,269,447,716
KILIFI,MAGARINI,64,219,277,496
KILIFI,MAGARINI,60-64,1464,2326,3790
KILIFI,MAGARINI,65,378,464,842
KILIFI,MAGARINI,66,241,202,443
KILIFI,MAGARINI,67,326,334,660
KILIFI,MAGARINI,68,203,170,373
KILIFI,MAGARINI,69,287,427,714
KILIFI,MAGARINI,65-69,1435,1597,3032
KILIFI,MAGARINI,70,316,525,841
KILIFI,MAGARINI,71,232,231,463
KILIFI,MAGARINI,72,174,139,313
KILIFI,MAGARINI,73,108,109,217
KILIFI,MAGARINI,74,124,176,300
KILIFI,MAGARINI,70-74,954,1180,2134
KILIFI,MAGARINI,75,134,129,263
KILIFI,MAGARINI,76,79,75,154
KILIFI,MAGARINI,77,97,93,190
KILIFI,MAGARINI,78,62,51,113
KILIFI,MAGARINI,79,146,206,352
KILIFI,MAGARINI,75-79,518,554,1072
KILIFI,MAGARINI,80,116,208,324
KILIFI,MAGARINI,81,47,86,133
KILIFI,MAGARINI,82,38,46,84
KILIFI,MAGARINI,83,64,72,136
KILIFI,MAGARINI,84,60,74,134
KILIFI,MAGARINI,80-84,325,486,811
KILIFI,MAGARINI,85,53,69,122
KILIFI,MAGARINI,86,18,26,44
KILIFI,MAGARINI,87,42,53,95
KILIFI,MAGARINI,88,14,18,32
KILIFI,MAGARINI,89,67,97,164
KILIFI,MAGARINI,85-89,194,263,457
KILIFI,MAGARINI,90,30,40,70
KILIFI,MAGARINI,91,13,12,25
KILIFI,MAGARINI,92,5,9,14
KILIFI,MAGARINI,93,7,10,17
KILIFI,MAGARINI,94,11,13,24
KILIFI,MAGARINI,90-94,66,84,150
KILIFI,MAGARINI,95,11,23,34
KILIFI,MAGARINI,96,3,3,6
KILIFI,MAGARINI,97,9,4,13
KILIFI,MAGARINI,98,9,5,14
KILIFI,MAGARINI,99,14,29,43
KILIFI,MAGARINI,95-99,46,64,110
KILIFI,MAGARINI,100+,28,41,69
KILIFI,MAGARINI,Not Stated,-,1,1
KILIFI,MALINDI,Total,163351,169866,333217
KILIFI,MALINDI,0,4335,4374,8709
KILIFI,MALINDI,1,4338,4202,8540
KILIFI,MALINDI,2,4466,4259,8725
KILIFI,MALINDI,3,4550,4567,9117
KILIFI,MALINDI,4,4793,4702,9495
KILIFI,MALINDI,0 - 4,22482,22104,44586
KILIFI,MALINDI,5,4714,4668,9382
KILIFI,MALINDI,6,4521,4597,9118
KILIFI,MALINDI,7,4404,4260,8664
KILIFI,MALINDI,8,4138,4140,8278
KILIFI,MALINDI,9,4408,4326,8734
KILIFI,MALINDI,05-Sep,22185,21991,44176
KILIFI,MALINDI,10,4700,4549,9249
KILIFI,MALINDI,11,4188,4341,8529
KILIFI,MALINDI,12,4553,4352,8905
KILIFI,MALINDI,13,4411,4585,8996
KILIFI,MALINDI,14,4073,4019,8092
KILIFI,MALINDI,Oct-14,21925,21846,43771
KILIFI,MALINDI,15,3969,3938,7907
KILIFI,MALINDI,16,3775,3845,7620
KILIFI,MALINDI,17,3891,3884,7775
KILIFI,MALINDI,18,3435,3478,6913
KILIFI,MALINDI,19,3863,3773,7636
KILIFI,MALINDI,15-19,18933,18918,37851
KILIFI,MALINDI,20,3495,3974,7469
KILIFI,MALINDI,21,2848,3269,6117
KILIFI,MALINDI,22,3078,3562,6640
KILIFI,MALINDI,23,3096,3632,6728
KILIFI,MALINDI,24,2862,3298,6160
KILIFI,MALINDI,20-24,15379,17735,33114
KILIFI,MALINDI,25,3256,3555,6811
KILIFI,MALINDI,26,2758,3200,5958
KILIFI,MALINDI,27,2695,3066,5761
KILIFI,MALINDI,28,2400,2805,5205
KILIFI,MALINDI,29,2356,2706,5062
KILIFI,MALINDI,25-29,13465,15332,28797
KILIFI,MALINDI,30,2977,3407,6384
KILIFI,MALINDI,31,1931,2450,4381
KILIFI,MALINDI,32,2468,2983,5451
KILIFI,MALINDI,33,1954,2360,4314
KILIFI,MALINDI,34,1935,2355,4290
KILIFI,MALINDI,30-34,11265,13555,24820
KILIFI,MALINDI,35,2488,2454,4942
KILIFI,MALINDI,36,1583,1662,3245
KILIFI,MALINDI,37,1666,1459,3125
KILIFI,MALINDI,38,1297,1239,2536
KILIFI,MALINDI,39,1403,1177,2580
KILIFI,MALINDI,35-39,8437,7991,16428
KILIFI,MALINDI,40,1872,1582,3454
KILIFI,MALINDI,41,1753,2022,3775
KILIFI,MALINDI,42,1580,1905,3485
KILIFI,MALINDI,43,1276,1618,2894
KILIFI,MALINDI,44,1180,1201,2381
KILIFI,MALINDI,40-44,7661,8328,15989
KILIFI,MALINDI,45,1834,1612,3446
KILIFI,MALINDI,46,1124,949,2073
KILIFI,MALINDI,47,1350,1035,2385
KILIFI,MALINDI,48,968,810,1778
KILIFI,MALINDI,49,1078,841,1919
KILIFI,MALINDI,45-49,6354,5247,11601
KILIFI,MALINDI,50,1374,1364,2738
KILIFI,MALINDI,51,979,846,1825
KILIFI,MALINDI,52,836,765,1601
KILIFI,MALINDI,53,598,446,1044
KILIFI,MALINDI,54,772,556,1328
KILIFI,MALINDI,50-54,4559,3977,8536
KILIFI,MALINDI,55,646,537,1183
KILIFI,MALINDI,56,793,662,1455
KILIFI,MALINDI,57,657,666,1323
KILIFI,MALINDI,58,611,542,1153
KILIFI,MALINDI,59,631,825,1456
KILIFI,MALINDI,55-59,3338,3232,6570
KILIFI,MALINDI,60,750,1055,1805
KILIFI,MALINDI,61,486,726,1212
KILIFI,MALINDI,62,466,623,1089
KILIFI,MALINDI,63,500,657,1157
KILIFI,MALINDI,64,365,490,855
KILIFI,MALINDI,60-64,2567,3551,6118
KILIFI,MALINDI,65,576,653,1229
KILIFI,MALINDI,66,341,338,679
KILIFI,MALINDI,67,476,466,942
KILIFI,MALINDI,68,256,240,496
KILIFI,MALINDI,69,361,545,906
KILIFI,MALINDI,65-69,2010,2242,4252
KILIFI,MALINDI,70,400,620,1020
KILIFI,MALINDI,71,291,357,648
KILIFI,MALINDI,72,217,214,431
KILIFI,MALINDI,73,200,224,424
KILIFI,MALINDI,74,214,265,479
KILIFI,MALINDI,70-74,1322,1680,3002
KILIFI,MALINDI,75,184,216,400
KILIFI,MALINDI,76,137,130,267
KILIFI,MALINDI,77,124,155,279
KILIFI,MALINDI,78,114,70,184
KILIFI,MALINDI,79,145,245,390
KILIFI,MALINDI,75-79,704,816,1520
KILIFI,MALINDI,80,146,285,431
KILIFI,MALINDI,81,75,127,202
KILIFI,MALINDI,82,54,72,126
KILIFI,MALINDI,83,58,96,154
KILIFI,MALINDI,84,58,100,158
KILIFI,MALINDI,80-84,391,680,1071
KILIFI,MALINDI,85,58,100,158
KILIFI,MALINDI,86,24,40,64
KILIFI,MALINDI,87,31,69,100
KILIFI,MALINDI,88,30,27,57
KILIFI,MALINDI,89,49,115,164
KILIFI,MALINDI,85-89,192,351,543
KILIFI,MALINDI,90,39,71,110
KILIFI,MALINDI,91,23,31,54
KILIFI,MALINDI,92,10,22,32
KILIFI,MALINDI,93,10,22,32
KILIFI,MALINDI,94,9,13,22
KILIFI,MALINDI,90-94,91,159,250
KILIFI,MALINDI,95,20,20,40
KILIFI,MALINDI,96,8,7,15
KILIFI,MALINDI,97,10,7,17
KILIFI,MALINDI,98,5,11,16
KILIFI,MALINDI,99,19,22,41
KILIFI,MALINDI,95-99,62,67,129
KILIFI,MALINDI,100+,28,59,87
KILIFI,MALINDI,Not Stated,1,5,6
KILIFI,RABAI,Total,58571,62242,120813
KILIFI,RABAI,0,1454,1411,2865
KILIFI,RABAI,1,1616,1566,3182
KILIFI,RABAI,2,1537,1549,3086
KILIFI,RABAI,3,1586,1581,3167
KILIFI,RABAI,4,1596,1623,3219
KILIFI,RABAI,0 - 4,7789,7730,15519
KILIFI,RABAI,5,1738,1709,3447
KILIFI,RABAI,6,1590,1522,3112
KILIFI,RABAI,7,1683,1561,3244
KILIFI,RABAI,8,1565,1571,3136
KILIFI,RABAI,9,1590,1550,3140
KILIFI,RABAI,05-Sep,8166,7913,16079
KILIFI,RABAI,10,1734,1694,3428
KILIFI,RABAI,11,1567,1586,3153
KILIFI,RABAI,12,1643,1660,3303
KILIFI,RABAI,13,1737,1828,3565
KILIFI,RABAI,14,1592,1596,3188
KILIFI,RABAI,Oct-14,8273,8364,16637
KILIFI,RABAI,15,1525,1467,2992
KILIFI,RABAI,16,1431,1483,2914
KILIFI,RABAI,17,1509,1419,2928
KILIFI,RABAI,18,1305,1235,2540
KILIFI,RABAI,19,1407,1356,2763
KILIFI,RABAI,15-19,7177,6960,14137
KILIFI,RABAI,20,1282,1325,2607
KILIFI,RABAI,21,1033,1013,2046
KILIFI,RABAI,22,1037,1121,2158
KILIFI,RABAI,23,1024,1155,2179
KILIFI,RABAI,24,867,980,1847
KILIFI,RABAI,20-24,5243,5594,10837
KILIFI,RABAI,25,959,1124,2083
KILIFI,RABAI,26,888,1054,1942
KILIFI,RABAI,27,850,1027,1877
KILIFI,RABAI,28,695,871,1566
KILIFI,RABAI,29,766,944,1710
KILIFI,RABAI,25-29,4158,5020,9178
KILIFI,RABAI,30,923,1182,2105
KILIFI,RABAI,31,609,803,1412
KILIFI,RABAI,32,706,880,1586
KILIFI,RABAI,33,660,739,1399
KILIFI,RABAI,34,564,692,1256
KILIFI,RABAI,30-34,3462,4296,7758
KILIFI,RABAI,35,727,854,1581
KILIFI,RABAI,36,576,651,1227
KILIFI,RABAI,37,584,603,1187
KILIFI,RABAI,38,431,411,842
KILIFI,RABAI,39,474,492,966
KILIFI,RABAI,35-39,2792,3011,5803
KILIFI,RABAI,40,590,553,1143
KILIFI,RABAI,41,598,717,1315
KILIFI,RABAI,42,584,675,1259
KILIFI,RABAI,43,471,537,1008
KILIFI,RABAI,44,415,420,835
KILIFI,RABAI,40-44,2658,2902,5560
KILIFI,RABAI,45,659,598,1257
KILIFI,RABAI,46,407,460,867
KILIFI,RABAI,47,505,432,937
KILIFI,RABAI,48,305,273,578
KILIFI,RABAI,49,364,278,642
KILIFI,RABAI,45-49,2240,2041,4281
KILIFI,RABAI,50,472,545,1017
KILIFI,RABAI,51,351,387,738
KILIFI,RABAI,52,254,283,537
KILIFI,RABAI,53,215,169,384
KILIFI,RABAI,54,237,177,414
KILIFI,RABAI,50-54,1529,1561,3090
KILIFI,RABAI,55,236,162,398
KILIFI,RABAI,56,342,341,683
KILIFI,RABAI,57,377,338,715
KILIFI,RABAI,58,243,241,484
KILIFI,RABAI,59,267,513,780
KILIFI,RABAI,55-59,1465,1595,3060
KILIFI,RABAI,60,324,579,903
KILIFI,RABAI,61,249,360,609
KILIFI,RABAI,62,191,328,519
KILIFI,RABAI,63,209,416,625
KILIFI,RABAI,64,209,236,445
KILIFI,RABAI,60-64,1182,1919,3101
KILIFI,RABAI,65,310,360,670
KILIFI,RABAI,66,186,168,354
KILIFI,RABAI,67,242,246,488
KILIFI,RABAI,68,126,129,255
KILIFI,RABAI,69,213,305,518
KILIFI,RABAI,65-69,1077,1208,2285
KILIFI,RABAI,70,208,412,620
KILIFI,RABAI,71,137,200,337
KILIFI,RABAI,72,110,140,250
KILIFI,RABAI,73,102,144,246
KILIFI,RABAI,74,117,154,271
KILIFI,RABAI,70-74,674,1050,1724
KILIFI,RABAI,75,95,153,248
KILIFI,RABAI,76,61,72,133
KILIFI,RABAI,77,84,78,162
KILIFI,RABAI,78,44,54,98
KILIFI,RABAI,79,85,99,184
KILIFI,RABAI,75-79,369,456,825
KILIFI,RABAI,80,62,155,217
KILIFI,RABAI,81,30,55,85
KILIFI,RABAI,82,31,39,70
KILIFI,RABAI,83,20,30,50
KILIFI,RABAI,84,33,55,88
KILIFI,RABAI,80-84,176,334,510
KILIFI,RABAI,85,18,41,59
KILIFI,RABAI,86,14,14,28
KILIFI,RABAI,87,20,23,43
KILIFI,RABAI,88,7,18,25
KILIFI,RABAI,89,27,76,103
KILIFI,RABAI,85-89,86,172,258
KILIFI,RABAI,90,6,28,34
KILIFI,RABAI,91,6,9,15
KILIFI,RABAI,92,10,9,19
KILIFI,RABAI,93,4,9,13
KILIFI,RABAI,94,4,6,10
KILIFI,RABAI,90-94,30,61,91
KILIFI,RABAI,95,7,14,21
KILIFI,RABAI,96,2,5,7
KILIFI,RABAI,97,4,2,6
KILIFI,RABAI,98,4,5,9
KILIFI,RABAI,99,3,14,17
KILIFI,RABAI,95-99,20,40,60
KILIFI,RABAI,100+,4,15,19
KILIFI,RABAI,Not Stated,1,-,1
KIRINYAGA,ALL,Total,302011,308369,610380
KIRINYAGA,ALL,0,6108,5865,11973
KIRINYAGA,ALL,1,5654,5623,11277
KIRINYAGA,ALL,2,5622,5637,11259
KIRINYAGA,ALL,3,5898,5835,11733
KIRINYAGA,ALL,4,5554,5695,11249
KIRINYAGA,ALL,0 - 4,28836,28655,57491
KIRINYAGA,ALL,5,5620,5427,11047
KIRINYAGA,ALL,6,5404,5575,10979
KIRINYAGA,ALL,7,5877,5886,11763
KIRINYAGA,ALL,8,5669,5538,11207
KIRINYAGA,ALL,9,6179,6110,12289
KIRINYAGA,ALL,05-Sep,28749,28536,57285
KIRINYAGA,ALL,10,6057,6010,12067
KIRINYAGA,ALL,11,5654,5816,11470
KIRINYAGA,ALL,12,6269,6035,12304
KIRINYAGA,ALL,13,6471,6379,12850
KIRINYAGA,ALL,14,6150,6155,12305
KIRINYAGA,ALL,Oct-14,30601,30395,60996
KIRINYAGA,ALL,15,6229,6256,12485
KIRINYAGA,ALL,16,6236,6114,12350
KIRINYAGA,ALL,17,6418,6044,12462
KIRINYAGA,ALL,18,5373,4971,10344
KIRINYAGA,ALL,19,5381,5047,10428
KIRINYAGA,ALL,15-19,29637,28432,58069
KIRINYAGA,ALL,20,4932,4940,9872
KIRINYAGA,ALL,21,4465,4517,8982
KIRINYAGA,ALL,22,4580,4655,9235
KIRINYAGA,ALL,23,4637,5007,9644
KIRINYAGA,ALL,24,4428,4467,8895
KIRINYAGA,ALL,20-24,23042,23586,46628
KIRINYAGA,ALL,25,4649,4619,9268
KIRINYAGA,ALL,26,3812,4032,7844
KIRINYAGA,ALL,27,4191,4241,8432
KIRINYAGA,ALL,28,3863,4093,7956
KIRINYAGA,ALL,29,4206,4448,8654
KIRINYAGA,ALL,25-29,20721,21433,42154
KIRINYAGA,ALL,30,5565,5765,11330
KIRINYAGA,ALL,31,4122,4243,8365
KIRINYAGA,ALL,32,5195,5658,10853
KIRINYAGA,ALL,33,4897,5227,10124
KIRINYAGA,ALL,34,4335,4741,9076
KIRINYAGA,ALL,30-34,24114,25634,49748
KIRINYAGA,ALL,35,6160,6170,12330
KIRINYAGA,ALL,36,4643,4761,9404
KIRINYAGA,ALL,37,4865,4583,9448
KIRINYAGA,ALL,38,4237,4425,8662
KIRINYAGA,ALL,39,4617,4759,9376
KIRINYAGA,ALL,35-39,24522,24698,49220
KIRINYAGA,ALL,40,5482,5435,10917
KIRINYAGA,ALL,41,4440,4235,8675
KIRINYAGA,ALL,42,4253,4177,8430
KIRINYAGA,ALL,43,3803,3830,7633
KIRINYAGA,ALL,44,3643,3477,7120
KIRINYAGA,ALL,40-44,21621,21154,42775
KIRINYAGA,ALL,45,4775,4797,9572
KIRINYAGA,ALL,46,3679,3503,7182
KIRINYAGA,ALL,47,3704,3407,7111
KIRINYAGA,ALL,48,2891,2860,5751
KIRINYAGA,ALL,49,3204,3147,6351
KIRINYAGA,ALL,45-49,18253,17714,35967
KIRINYAGA,ALL,50,3912,4013,7925
KIRINYAGA,ALL,51,3081,2920,6001
KIRINYAGA,ALL,52,3018,2843,5861
KIRINYAGA,ALL,53,2199,2352,4551
KIRINYAGA,ALL,54,2729,2445,5174
KIRINYAGA,ALL,50-54,14939,14573,29512
KIRINYAGA,ALL,55,2886,2783,5669
KIRINYAGA,ALL,56,3084,2844,5928
KIRINYAGA,ALL,57,2288,2524,4812
KIRINYAGA,ALL,58,1960,1977,3937
KIRINYAGA,ALL,59,2278,2357,4635
KIRINYAGA,ALL,55-59,12496,12485,24981
KIRINYAGA,ALL,60,2385,2434,4819
KIRINYAGA,ALL,61,1807,1845,3652
KIRINYAGA,ALL,62,1533,1413,2946
KIRINYAGA,ALL,63,1301,1361,2662
KIRINYAGA,ALL,64,892,903,1795
KIRINYAGA,ALL,60-64,7918,7956,15874
KIRINYAGA,ALL,65,1508,1882,3390
KIRINYAGA,ALL,66,1032,1037,2069
KIRINYAGA,ALL,67,1776,1845,3621
KIRINYAGA,ALL,68,947,880,1827
KIRINYAGA,ALL,69,1182,1338,2520
KIRINYAGA,ALL,65-69,6445,6982,13427
KIRINYAGA,ALL,70,1427,2271,3698
KIRINYAGA,ALL,71,980,1313,2293
KIRINYAGA,ALL,72,868,902,1770
KIRINYAGA,ALL,73,694,705,1399
KIRINYAGA,ALL,74,662,862,1524
KIRINYAGA,ALL,70-74,4631,6053,10684
KIRINYAGA,ALL,75,536,860,1396
KIRINYAGA,ALL,76,436,632,1068
KIRINYAGA,ALL,77,485,626,1111
KIRINYAGA,ALL,78,359,370,729
KIRINYAGA,ALL,79,409,751,1160
KIRINYAGA,ALL,75-79,2225,3239,5464
KIRINYAGA,ALL,80,588,1186,1774
KIRINYAGA,ALL,81,223,536,759
KIRINYAGA,ALL,82,231,300,531
KIRINYAGA,ALL,83,253,389,642
KIRINYAGA,ALL,84,252,481,733
KIRINYAGA,ALL,80-84,1547,2892,4439
KIRINYAGA,ALL,85,240,418,658
KIRINYAGA,ALL,86,184,248,432
KIRINYAGA,ALL,87,178,238,416
KIRINYAGA,ALL,88,105,142,247
KIRINYAGA,ALL,89,209,564,773
KIRINYAGA,ALL,85-89,916,1610,2526
KIRINYAGA,ALL,90,132,435,567
KIRINYAGA,ALL,91,161,384,545
KIRINYAGA,ALL,92,55,133,188
KIRINYAGA,ALL,93,63,122,185
KIRINYAGA,ALL,94,48,149,197
KIRINYAGA,ALL,90-94,459,1223,1682
KIRINYAGA,ALL,95,64,208,272
KIRINYAGA,ALL,96,39,84,123
KIRINYAGA,ALL,97,49,85,134
KIRINYAGA,ALL,98,28,59,87
KIRINYAGA,ALL,99,40,188,228
KIRINYAGA,ALL,95-99,220,624,844
KIRINYAGA,ALL,100+,115,490,605
KIRINYAGA,ALL,Not Stated,4,5,9
KIRINYAGA,KIRINYAGA CENTRAL,Total,60118,62617,122735
KIRINYAGA,KIRINYAGA CENTRAL,0,1161,1143,2304
KIRINYAGA,KIRINYAGA CENTRAL,1,1096,1139,2235
KIRINYAGA,KIRINYAGA CENTRAL,2,1065,1096,2161
KIRINYAGA,KIRINYAGA CENTRAL,3,1155,1148,2303
KIRINYAGA,KIRINYAGA CENTRAL,4,1102,1152,2254
KIRINYAGA,KIRINYAGA CENTRAL,0 - 4,5579,5678,11257
KIRINYAGA,KIRINYAGA CENTRAL,5,1117,1024,2141
KIRINYAGA,KIRINYAGA CENTRAL,6,1030,1039,2069
KIRINYAGA,KIRINYAGA CENTRAL,7,1105,1105,2210
KIRINYAGA,KIRINYAGA CENTRAL,8,1099,1048,2147
KIRINYAGA,KIRINYAGA CENTRAL,9,1043,1123,2166
KIRINYAGA,KIRINYAGA CENTRAL,05-Sep,5394,5339,10733
KIRINYAGA,KIRINYAGA CENTRAL,10,1120,1111,2231
KIRINYAGA,KIRINYAGA CENTRAL,11,1110,1125,2235
KIRINYAGA,KIRINYAGA CENTRAL,12,1203,1172,2375
KIRINYAGA,KIRINYAGA CENTRAL,13,1198,1211,2409
KIRINYAGA,KIRINYAGA CENTRAL,14,1172,1219,2391
KIRINYAGA,KIRINYAGA CENTRAL,Oct-14,5803,5838,11641
KIRINYAGA,KIRINYAGA CENTRAL,15,1208,1237,2445
KIRINYAGA,KIRINYAGA CENTRAL,16,1254,1193,2447
KIRINYAGA,KIRINYAGA CENTRAL,17,1317,1283,2600
KIRINYAGA,KIRINYAGA CENTRAL,18,1044,1019,2063
KIRINYAGA,KIRINYAGA CENTRAL,19,1073,978,2051
KIRINYAGA,KIRINYAGA CENTRAL,15-19,5896,5710,11606
KIRINYAGA,KIRINYAGA CENTRAL,20,964,985,1949
KIRINYAGA,KIRINYAGA CENTRAL,21,914,928,1842
KIRINYAGA,KIRINYAGA CENTRAL,22,937,978,1915
KIRINYAGA,KIRINYAGA CENTRAL,23,894,986,1880
KIRINYAGA,KIRINYAGA CENTRAL,24,904,936,1840
KIRINYAGA,KIRINYAGA CENTRAL,20-24,4613,4813,9426
KIRINYAGA,KIRINYAGA CENTRAL,25,896,959,1855
KIRINYAGA,KIRINYAGA CENTRAL,26,779,790,1569
KIRINYAGA,KIRINYAGA CENTRAL,27,826,807,1633
KIRINYAGA,KIRINYAGA CENTRAL,28,768,817,1585
KIRINYAGA,KIRINYAGA CENTRAL,29,861,851,1712
KIRINYAGA,KIRINYAGA CENTRAL,25-29,4130,4224,8354
KIRINYAGA,KIRINYAGA CENTRAL,30,1067,1132,2199
KIRINYAGA,KIRINYAGA CENTRAL,31,814,856,1670
KIRINYAGA,KIRINYAGA CENTRAL,32,1040,1130,2170
KIRINYAGA,KIRINYAGA CENTRAL,33,975,1077,2052
KIRINYAGA,KIRINYAGA CENTRAL,34,868,930,1798
KIRINYAGA,KIRINYAGA CENTRAL,30-34,4764,5125,9889
KIRINYAGA,KIRINYAGA CENTRAL,35,1147,1217,2364
KIRINYAGA,KIRINYAGA CENTRAL,36,896,978,1874
KIRINYAGA,KIRINYAGA CENTRAL,37,1064,948,2012
KIRINYAGA,KIRINYAGA CENTRAL,38,924,923,1847
KIRINYAGA,KIRINYAGA CENTRAL,39,919,998,1917
KIRINYAGA,KIRINYAGA CENTRAL,35-39,4950,5064,10014
KIRINYAGA,KIRINYAGA CENTRAL,40,1120,1118,2238
KIRINYAGA,KIRINYAGA CENTRAL,41,910,873,1783
KIRINYAGA,KIRINYAGA CENTRAL,42,822,845,1667
KIRINYAGA,KIRINYAGA CENTRAL,43,737,814,1551
KIRINYAGA,KIRINYAGA CENTRAL,44,726,681,1407
KIRINYAGA,KIRINYAGA CENTRAL,40-44,4315,4331,8646
KIRINYAGA,KIRINYAGA CENTRAL,45,995,979,1974
KIRINYAGA,KIRINYAGA CENTRAL,46,721,696,1417
KIRINYAGA,KIRINYAGA CENTRAL,47,702,737,1439
KIRINYAGA,KIRINYAGA CENTRAL,48,596,573,1169
KIRINYAGA,KIRINYAGA CENTRAL,49,646,639,1285
KIRINYAGA,KIRINYAGA CENTRAL,45-49,3660,3624,7284
KIRINYAGA,KIRINYAGA CENTRAL,50,847,838,1685
KIRINYAGA,KIRINYAGA CENTRAL,51,641,630,1271
KIRINYAGA,KIRINYAGA CENTRAL,52,590,582,1172
KIRINYAGA,KIRINYAGA CENTRAL,53,472,563,1035
KIRINYAGA,KIRINYAGA CENTRAL,54,528,565,1093
KIRINYAGA,KIRINYAGA CENTRAL,50-54,3078,3178,6256
KIRINYAGA,KIRINYAGA CENTRAL,55,579,629,1208
KIRINYAGA,KIRINYAGA CENTRAL,56,603,598,1201
KIRINYAGA,KIRINYAGA CENTRAL,57,469,579,1048
KIRINYAGA,KIRINYAGA CENTRAL,58,379,422,801
KIRINYAGA,KIRINYAGA CENTRAL,59,492,529,1021
KIRINYAGA,KIRINYAGA CENTRAL,55-59,2522,2757,5279
KIRINYAGA,KIRINYAGA CENTRAL,60,516,582,1098
KIRINYAGA,KIRINYAGA CENTRAL,61,391,425,816
KIRINYAGA,KIRINYAGA CENTRAL,62,356,281,637
KIRINYAGA,KIRINYAGA CENTRAL,63,328,293,621
KIRINYAGA,KIRINYAGA CENTRAL,64,189,199,388
KIRINYAGA,KIRINYAGA CENTRAL,60-64,1780,1780,3560
KIRINYAGA,KIRINYAGA CENTRAL,65,338,448,786
KIRINYAGA,KIRINYAGA CENTRAL,66,239,244,483
KIRINYAGA,KIRINYAGA CENTRAL,67,377,401,778
KIRINYAGA,KIRINYAGA CENTRAL,68,223,171,394
KIRINYAGA,KIRINYAGA CENTRAL,69,235,263,498
KIRINYAGA,KIRINYAGA CENTRAL,65-69,1412,1527,2939
KIRINYAGA,KIRINYAGA CENTRAL,70,331,502,833
KIRINYAGA,KIRINYAGA CENTRAL,71,207,273,480
KIRINYAGA,KIRINYAGA CENTRAL,72,196,192,388
KIRINYAGA,KIRINYAGA CENTRAL,73,162,173,335
KIRINYAGA,KIRINYAGA CENTRAL,74,153,193,346
KIRINYAGA,KIRINYAGA CENTRAL,70-74,1049,1333,2382
KIRINYAGA,KIRINYAGA CENTRAL,75,117,212,329
KIRINYAGA,KIRINYAGA CENTRAL,76,96,135,231
KIRINYAGA,KIRINYAGA CENTRAL,77,104,136,240
KIRINYAGA,KIRINYAGA CENTRAL,78,90,80,170
KIRINYAGA,KIRINYAGA CENTRAL,79,90,167,257
KIRINYAGA,KIRINYAGA CENTRAL,75-79,497,730,1227
KIRINYAGA,KIRINYAGA CENTRAL,80,134,288,422
KIRINYAGA,KIRINYAGA CENTRAL,81,55,112,167
KIRINYAGA,KIRINYAGA CENTRAL,82,46,54,100
KIRINYAGA,KIRINYAGA CENTRAL,83,63,76,139
KIRINYAGA,KIRINYAGA CENTRAL,84,46,120,166
KIRINYAGA,KIRINYAGA CENTRAL,80-84,344,650,994
KIRINYAGA,KIRINYAGA CENTRAL,85,37,86,123
KIRINYAGA,KIRINYAGA CENTRAL,86,39,56,95
KIRINYAGA,KIRINYAGA CENTRAL,87,38,43,81
KIRINYAGA,KIRINYAGA CENTRAL,88,22,33,55
KIRINYAGA,KIRINYAGA CENTRAL,89,49,143,192
KIRINYAGA,KIRINYAGA CENTRAL,85-89,185,361,546
KIRINYAGA,KIRINYAGA CENTRAL,90,20,113,133
KIRINYAGA,KIRINYAGA CENTRAL,91,25,103,128
KIRINYAGA,KIRINYAGA CENTRAL,92,16,29,45
KIRINYAGA,KIRINYAGA CENTRAL,93,12,21,33
KIRINYAGA,KIRINYAGA CENTRAL,94,8,33,41
KIRINYAGA,KIRINYAGA CENTRAL,90-94,81,299,380
KIRINYAGA,KIRINYAGA CENTRAL,95,16,37,53
KIRINYAGA,KIRINYAGA CENTRAL,96,7,14,21
KIRINYAGA,KIRINYAGA CENTRAL,97,4,13,17
KIRINYAGA,KIRINYAGA CENTRAL,98,4,13,17
KIRINYAGA,KIRINYAGA CENTRAL,99,8,40,48
KIRINYAGA,KIRINYAGA CENTRAL,95-99,39,117,156
KIRINYAGA,KIRINYAGA CENTRAL,100+,27,138,165
KIRINYAGA,KIRINYAGA CENTRAL,Not Stated,-,1,1
KIRINYAGA,KIRINYAGA EAST,Total,67037,68514,135551
KIRINYAGA,KIRINYAGA EAST,0,1204,1187,2391
KIRINYAGA,KIRINYAGA EAST,1,1145,1209,2354
KIRINYAGA,KIRINYAGA EAST,2,1180,1205,2385
KIRINYAGA,KIRINYAGA EAST,3,1224,1266,2490
KIRINYAGA,KIRINYAGA EAST,4,1145,1189,2334
KIRINYAGA,KIRINYAGA EAST,0 - 4,5898,6056,11954
KIRINYAGA,KIRINYAGA EAST,5,1123,1145,2268
KIRINYAGA,KIRINYAGA EAST,6,1126,1235,2361
KIRINYAGA,KIRINYAGA EAST,7,1262,1233,2495
KIRINYAGA,KIRINYAGA EAST,8,1190,1160,2350
KIRINYAGA,KIRINYAGA EAST,9,1241,1308,2549
KIRINYAGA,KIRINYAGA EAST,05-Sep,5942,6081,12023
KIRINYAGA,KIRINYAGA EAST,10,1274,1352,2626
KIRINYAGA,KIRINYAGA EAST,11,1215,1249,2464
KIRINYAGA,KIRINYAGA EAST,12,1338,1309,2647
KIRINYAGA,KIRINYAGA EAST,13,1461,1353,2814
KIRINYAGA,KIRINYAGA EAST,14,1391,1360,2751
KIRINYAGA,KIRINYAGA EAST,Oct-14,6679,6623,13302
KIRINYAGA,KIRINYAGA EAST,15,1414,1361,2775
KIRINYAGA,KIRINYAGA EAST,16,1368,1333,2701
KIRINYAGA,KIRINYAGA EAST,17,1372,1225,2597
KIRINYAGA,KIRINYAGA EAST,18,1178,1002,2180
KIRINYAGA,KIRINYAGA EAST,19,1096,1055,2151
KIRINYAGA,KIRINYAGA EAST,15-19,6428,5976,12404
KIRINYAGA,KIRINYAGA EAST,20,1018,987,2005
KIRINYAGA,KIRINYAGA EAST,21,933,869,1802
KIRINYAGA,KIRINYAGA EAST,22,915,871,1786
KIRINYAGA,KIRINYAGA EAST,23,947,1000,1947
KIRINYAGA,KIRINYAGA EAST,24,883,867,1750
KIRINYAGA,KIRINYAGA EAST,20-24,4696,4594,9290
KIRINYAGA,KIRINYAGA EAST,25,909,805,1714
KIRINYAGA,KIRINYAGA EAST,26,727,758,1485
KIRINYAGA,KIRINYAGA EAST,27,804,815,1619
KIRINYAGA,KIRINYAGA EAST,28,731,790,1521
KIRINYAGA,KIRINYAGA EAST,29,738,857,1595
KIRINYAGA,KIRINYAGA EAST,25-29,3909,4025,7934
KIRINYAGA,KIRINYAGA EAST,30,1103,1104,2207
KIRINYAGA,KIRINYAGA EAST,31,865,929,1794
KIRINYAGA,KIRINYAGA EAST,32,1075,1149,2224
KIRINYAGA,KIRINYAGA EAST,33,1077,1138,2215
KIRINYAGA,KIRINYAGA EAST,34,985,1072,2057
KIRINYAGA,KIRINYAGA EAST,30-34,5105,5392,10497
KIRINYAGA,KIRINYAGA EAST,35,1313,1311,2624
KIRINYAGA,KIRINYAGA EAST,36,1108,1007,2115
KIRINYAGA,KIRINYAGA EAST,37,1095,1000,2095
KIRINYAGA,KIRINYAGA EAST,38,954,981,1935
KIRINYAGA,KIRINYAGA EAST,39,1122,1070,2192
KIRINYAGA,KIRINYAGA EAST,35-39,5592,5369,10961
KIRINYAGA,KIRINYAGA EAST,40,1250,1260,2510
KIRINYAGA,KIRINYAGA EAST,41,1037,1036,2073
KIRINYAGA,KIRINYAGA EAST,42,1004,996,2000
KIRINYAGA,KIRINYAGA EAST,43,949,906,1855
KIRINYAGA,KIRINYAGA EAST,44,848,843,1691
KIRINYAGA,KIRINYAGA EAST,40-44,5088,5041,10129
KIRINYAGA,KIRINYAGA EAST,45,1063,1103,2166
KIRINYAGA,KIRINYAGA EAST,46,866,814,1680
KIRINYAGA,KIRINYAGA EAST,47,890,823,1713
KIRINYAGA,KIRINYAGA EAST,48,708,694,1402
KIRINYAGA,KIRINYAGA EAST,49,805,750,1555
KIRINYAGA,KIRINYAGA EAST,45-49,4332,4184,8516
KIRINYAGA,KIRINYAGA EAST,50,924,1006,1930
KIRINYAGA,KIRINYAGA EAST,51,815,745,1560
KIRINYAGA,KIRINYAGA EAST,52,743,707,1450
KIRINYAGA,KIRINYAGA EAST,53,581,646,1227
KIRINYAGA,KIRINYAGA EAST,54,728,659,1387
KIRINYAGA,KIRINYAGA EAST,50-54,3791,3763,7554
KIRINYAGA,KIRINYAGA EAST,55,744,749,1493
KIRINYAGA,KIRINYAGA EAST,56,767,733,1500
KIRINYAGA,KIRINYAGA EAST,57,602,672,1274
KIRINYAGA,KIRINYAGA EAST,58,525,538,1063
KIRINYAGA,KIRINYAGA EAST,59,588,621,1209
KIRINYAGA,KIRINYAGA EAST,55-59,3226,3313,6539
KIRINYAGA,KIRINYAGA EAST,60,633,621,1254
KIRINYAGA,KIRINYAGA EAST,61,477,472,949
KIRINYAGA,KIRINYAGA EAST,62,382,396,778
KIRINYAGA,KIRINYAGA EAST,63,362,404,766
KIRINYAGA,KIRINYAGA EAST,64,217,233,450
KIRINYAGA,KIRINYAGA EAST,60-64,2071,2126,4197
KIRINYAGA,KIRINYAGA EAST,65,379,488,867
KIRINYAGA,KIRINYAGA EAST,66,271,273,544
KIRINYAGA,KIRINYAGA EAST,67,460,465,925
KIRINYAGA,KIRINYAGA EAST,68,248,235,483
KIRINYAGA,KIRINYAGA EAST,69,316,386,702
KIRINYAGA,KIRINYAGA EAST,65-69,1674,1847,3521
KIRINYAGA,KIRINYAGA EAST,70,374,596,970
KIRINYAGA,KIRINYAGA EAST,71,270,399,669
KIRINYAGA,KIRINYAGA EAST,72,199,222,421
KIRINYAGA,KIRINYAGA EAST,73,162,196,358
KIRINYAGA,KIRINYAGA EAST,74,149,223,372
KIRINYAGA,KIRINYAGA EAST,70-74,1154,1636,2790
KIRINYAGA,KIRINYAGA EAST,75,135,183,318
KIRINYAGA,KIRINYAGA EAST,76,111,160,271
KIRINYAGA,KIRINYAGA EAST,77,138,151,289
KIRINYAGA,KIRINYAGA EAST,78,83,83,166
KIRINYAGA,KIRINYAGA EAST,79,94,185,279
KIRINYAGA,KIRINYAGA EAST,75-79,561,762,1323
KIRINYAGA,KIRINYAGA EAST,80,160,281,441
KIRINYAGA,KIRINYAGA EAST,81,68,159,227
KIRINYAGA,KIRINYAGA EAST,82,53,74,127
KIRINYAGA,KIRINYAGA EAST,83,59,88,147
KIRINYAGA,KIRINYAGA EAST,84,85,110,195
KIRINYAGA,KIRINYAGA EAST,80-84,425,712,1137
KIRINYAGA,KIRINYAGA EAST,85,59,110,169
KIRINYAGA,KIRINYAGA EAST,86,39,64,103
KIRINYAGA,KIRINYAGA EAST,87,58,65,123
KIRINYAGA,KIRINYAGA EAST,88,24,39,63
KIRINYAGA,KIRINYAGA EAST,89,55,151,206
KIRINYAGA,KIRINYAGA EAST,85-89,235,429,664
KIRINYAGA,KIRINYAGA EAST,90,44,90,134
KIRINYAGA,KIRINYAGA EAST,91,55,97,152
KIRINYAGA,KIRINYAGA EAST,92,17,43,60
KIRINYAGA,KIRINYAGA EAST,93,8,38,46
KIRINYAGA,KIRINYAGA EAST,94,11,35,46
KIRINYAGA,KIRINYAGA EAST,90-94,135,303,438
KIRINYAGA,KIRINYAGA EAST,95,13,53,66
KIRINYAGA,KIRINYAGA EAST,96,14,20,34
KIRINYAGA,KIRINYAGA EAST,97,14,15,29
KIRINYAGA,KIRINYAGA EAST,98,4,12,16
KIRINYAGA,KIRINYAGA EAST,99,13,61,74
KIRINYAGA,KIRINYAGA EAST,95-99,58,161,219
KIRINYAGA,KIRINYAGA EAST,100+,36,119,155
KIRINYAGA,KIRINYAGA EAST,Not Stated,2,2,4
KIRINYAGA,KIRINYAGA WEST,Total,56154,58502,114656
KIRINYAGA,KIRINYAGA WEST,0,1070,1075,2145
KIRINYAGA,KIRINYAGA WEST,1,1105,1027,2132
KIRINYAGA,KIRINYAGA WEST,2,1082,1085,2167
KIRINYAGA,KIRINYAGA WEST,3,1184,1140,2324
KIRINYAGA,KIRINYAGA WEST,4,1090,1054,2144
KIRINYAGA,KIRINYAGA WEST,0 - 4,5531,5381,10912
KIRINYAGA,KIRINYAGA WEST,5,1109,1045,2154
KIRINYAGA,KIRINYAGA WEST,6,1043,1095,2138
KIRINYAGA,KIRINYAGA WEST,7,1174,1191,2365
KIRINYAGA,KIRINYAGA WEST,8,1087,1137,2224
KIRINYAGA,KIRINYAGA WEST,9,1240,1172,2412
KIRINYAGA,KIRINYAGA WEST,05-Sep,5653,5640,11293
KIRINYAGA,KIRINYAGA WEST,10,1149,1147,2296
KIRINYAGA,KIRINYAGA WEST,11,1076,1087,2163
KIRINYAGA,KIRINYAGA WEST,12,1235,1100,2335
KIRINYAGA,KIRINYAGA WEST,13,1212,1254,2466
KIRINYAGA,KIRINYAGA WEST,14,1143,1185,2328
KIRINYAGA,KIRINYAGA WEST,Oct-14,5815,5773,11588
KIRINYAGA,KIRINYAGA WEST,15,1186,1163,2349
KIRINYAGA,KIRINYAGA WEST,16,1131,1214,2345
KIRINYAGA,KIRINYAGA WEST,17,1219,1175,2394
KIRINYAGA,KIRINYAGA WEST,18,1032,953,1985
KIRINYAGA,KIRINYAGA WEST,19,1043,957,2000
KIRINYAGA,KIRINYAGA WEST,15-19,5611,5462,11073
KIRINYAGA,KIRINYAGA WEST,20,877,878,1755
KIRINYAGA,KIRINYAGA WEST,21,848,803,1651
KIRINYAGA,KIRINYAGA WEST,22,811,806,1617
KIRINYAGA,KIRINYAGA WEST,23,849,872,1721
KIRINYAGA,KIRINYAGA WEST,24,775,756,1531
KIRINYAGA,KIRINYAGA WEST,20-24,4160,4115,8275
KIRINYAGA,KIRINYAGA WEST,25,838,856,1694
KIRINYAGA,KIRINYAGA WEST,26,693,750,1443
KIRINYAGA,KIRINYAGA WEST,27,685,754,1439
KIRINYAGA,KIRINYAGA WEST,28,656,731,1387
KIRINYAGA,KIRINYAGA WEST,29,736,786,1522
KIRINYAGA,KIRINYAGA WEST,25-29,3608,3877,7485
KIRINYAGA,KIRINYAGA WEST,30,950,1030,1980
KIRINYAGA,KIRINYAGA WEST,31,673,709,1382
KIRINYAGA,KIRINYAGA WEST,32,853,1005,1858
KIRINYAGA,KIRINYAGA WEST,33,859,918,1777
KIRINYAGA,KIRINYAGA WEST,34,761,860,1621
KIRINYAGA,KIRINYAGA WEST,30-34,4096,4522,8618
KIRINYAGA,KIRINYAGA WEST,35,1094,1116,2210
KIRINYAGA,KIRINYAGA WEST,36,788,928,1716
KIRINYAGA,KIRINYAGA WEST,37,793,859,1652
KIRINYAGA,KIRINYAGA WEST,38,750,804,1554
KIRINYAGA,KIRINYAGA WEST,39,808,898,1706
KIRINYAGA,KIRINYAGA WEST,35-39,4233,4605,8838
KIRINYAGA,KIRINYAGA WEST,40,947,993,1940
KIRINYAGA,KIRINYAGA WEST,41,743,734,1477
KIRINYAGA,KIRINYAGA WEST,42,762,773,1535
KIRINYAGA,KIRINYAGA WEST,43,638,704,1342
KIRINYAGA,KIRINYAGA WEST,44,603,634,1237
KIRINYAGA,KIRINYAGA WEST,40-44,3693,3838,7531
KIRINYAGA,KIRINYAGA WEST,45,835,869,1704
KIRINYAGA,KIRINYAGA WEST,46,686,680,1366
KIRINYAGA,KIRINYAGA WEST,47,676,658,1334
KIRINYAGA,KIRINYAGA WEST,48,564,625,1189
KIRINYAGA,KIRINYAGA WEST,49,625,629,1254
KIRINYAGA,KIRINYAGA WEST,45-49,3386,3461,6847
KIRINYAGA,KIRINYAGA WEST,50,751,815,1566
KIRINYAGA,KIRINYAGA WEST,51,558,562,1120
KIRINYAGA,KIRINYAGA WEST,52,567,554,1121
KIRINYAGA,KIRINYAGA WEST,53,415,442,857
KIRINYAGA,KIRINYAGA WEST,54,537,452,989
KIRINYAGA,KIRINYAGA WEST,50-54,2828,2825,5653
KIRINYAGA,KIRINYAGA WEST,55,558,513,1071
KIRINYAGA,KIRINYAGA WEST,56,633,574,1207
KIRINYAGA,KIRINYAGA WEST,57,472,516,988
KIRINYAGA,KIRINYAGA WEST,58,389,406,795
KIRINYAGA,KIRINYAGA WEST,59,437,460,897
KIRINYAGA,KIRINYAGA WEST,55-59,2489,2469,4958
KIRINYAGA,KIRINYAGA WEST,60,475,478,953
KIRINYAGA,KIRINYAGA WEST,61,337,406,743
KIRINYAGA,KIRINYAGA WEST,62,312,282,594
KIRINYAGA,KIRINYAGA WEST,63,236,259,495
KIRINYAGA,KIRINYAGA WEST,64,175,195,370
KIRINYAGA,KIRINYAGA WEST,60-64,1535,1620,3155
KIRINYAGA,KIRINYAGA WEST,65,292,377,669
KIRINYAGA,KIRINYAGA WEST,66,200,208,408
KIRINYAGA,KIRINYAGA WEST,67,369,408,777
KIRINYAGA,KIRINYAGA WEST,68,203,176,379
KIRINYAGA,KIRINYAGA WEST,69,282,292,574
KIRINYAGA,KIRINYAGA WEST,65-69,1346,1461,2807
KIRINYAGA,KIRINYAGA WEST,70,293,444,737
KIRINYAGA,KIRINYAGA WEST,71,199,258,457
KIRINYAGA,KIRINYAGA WEST,72,228,184,412
KIRINYAGA,KIRINYAGA WEST,73,167,138,305
KIRINYAGA,KIRINYAGA WEST,74,165,184,349
KIRINYAGA,KIRINYAGA WEST,70-74,1052,1208,2260
KIRINYAGA,KIRINYAGA WEST,75,115,183,298
KIRINYAGA,KIRINYAGA WEST,76,100,164,264
KIRINYAGA,KIRINYAGA WEST,77,92,137,229
KIRINYAGA,KIRINYAGA WEST,78,71,84,155
KIRINYAGA,KIRINYAGA WEST,79,91,172,263
KIRINYAGA,KIRINYAGA WEST,75-79,469,740,1209
KIRINYAGA,KIRINYAGA WEST,80,123,246,369
KIRINYAGA,KIRINYAGA WEST,81,35,107,142
KIRINYAGA,KIRINYAGA WEST,82,47,78,125
KIRINYAGA,KIRINYAGA WEST,83,59,101,160
KIRINYAGA,KIRINYAGA WEST,84,46,109,155
KIRINYAGA,KIRINYAGA WEST,80-84,310,641,951
KIRINYAGA,KIRINYAGA WEST,85,58,96,154
KIRINYAGA,KIRINYAGA WEST,86,42,63,105
KIRINYAGA,KIRINYAGA WEST,87,31,58,89
KIRINYAGA,KIRINYAGA WEST,88,21,31,52
KIRINYAGA,KIRINYAGA WEST,89,33,118,151
KIRINYAGA,KIRINYAGA WEST,85-89,185,366,551
KIRINYAGA,KIRINYAGA WEST,90,26,99,125
KIRINYAGA,KIRINYAGA WEST,91,38,73,111
KIRINYAGA,KIRINYAGA WEST,92,10,25,35
KIRINYAGA,KIRINYAGA WEST,93,10,35,45
KIRINYAGA,KIRINYAGA WEST,94,11,38,49
KIRINYAGA,KIRINYAGA WEST,90-94,95,270,365
KIRINYAGA,KIRINYAGA WEST,95,16,51,67
KIRINYAGA,KIRINYAGA WEST,96,7,17,24
KIRINYAGA,KIRINYAGA WEST,97,10,26,36
KIRINYAGA,KIRINYAGA WEST,98,4,13,17
KIRINYAGA,KIRINYAGA WEST,99,7,30,37
KIRINYAGA,KIRINYAGA WEST,95-99,44,137,181
KIRINYAGA,KIRINYAGA WEST,100+,13,90,103
KIRINYAGA,KIRINYAGA WEST,Not Stated,2,1,3
KIRINYAGA,MWEA EAST,Total,66432,66114,132546
KIRINYAGA,MWEA EAST,0,1545,1443,2988
KIRINYAGA,MWEA EAST,1,1362,1275,2637
KIRINYAGA,MWEA EAST,2,1363,1284,2647
KIRINYAGA,MWEA EAST,3,1341,1270,2611
KIRINYAGA,MWEA EAST,4,1234,1273,2507
KIRINYAGA,MWEA EAST,0 - 4,6845,6545,13390
KIRINYAGA,MWEA EAST,5,1277,1254,2531
KIRINYAGA,MWEA EAST,6,1219,1227,2446
KIRINYAGA,MWEA EAST,7,1326,1307,2633
KIRINYAGA,MWEA EAST,8,1243,1204,2447
KIRINYAGA,MWEA EAST,9,1470,1390,2860
KIRINYAGA,MWEA EAST,05-Sep,6535,6382,12917
KIRINYAGA,MWEA EAST,10,1338,1307,2645
KIRINYAGA,MWEA EAST,11,1189,1267,2456
KIRINYAGA,MWEA EAST,12,1395,1324,2719
KIRINYAGA,MWEA EAST,13,1386,1339,2725
KIRINYAGA,MWEA EAST,14,1315,1252,2567
KIRINYAGA,MWEA EAST,Oct-14,6623,6489,13112
KIRINYAGA,MWEA EAST,15,1299,1355,2654
KIRINYAGA,MWEA EAST,16,1244,1260,2504
KIRINYAGA,MWEA EAST,17,1292,1287,2579
KIRINYAGA,MWEA EAST,18,1111,1057,2168
KIRINYAGA,MWEA EAST,19,1114,1163,2277
KIRINYAGA,MWEA EAST,15-19,6060,6122,12182
KIRINYAGA,MWEA EAST,20,1172,1184,2356
KIRINYAGA,MWEA EAST,21,1015,1108,2123
KIRINYAGA,MWEA EAST,22,1145,1173,2318
KIRINYAGA,MWEA EAST,23,1116,1295,2411
KIRINYAGA,MWEA EAST,24,1098,1161,2259
KIRINYAGA,MWEA EAST,20-24,5546,5921,11467
KIRINYAGA,MWEA EAST,25,1176,1234,2410
KIRINYAGA,MWEA EAST,26,981,1035,2016
KIRINYAGA,MWEA EAST,27,1107,1126,2233
KIRINYAGA,MWEA EAST,28,1021,1076,2097
KIRINYAGA,MWEA EAST,29,1131,1116,2247
KIRINYAGA,MWEA EAST,25-29,5416,5587,11003
KIRINYAGA,MWEA EAST,30,1492,1508,3000
KIRINYAGA,MWEA EAST,31,1026,1038,2064
KIRINYAGA,MWEA EAST,32,1264,1366,2630
KIRINYAGA,MWEA EAST,33,1119,1161,2280
KIRINYAGA,MWEA EAST,34,989,1086,2075
KIRINYAGA,MWEA EAST,30-34,5890,6159,12049
KIRINYAGA,MWEA EAST,35,1536,1431,2967
KIRINYAGA,MWEA EAST,36,1031,1010,2041
KIRINYAGA,MWEA EAST,37,1066,929,1995
KIRINYAGA,MWEA EAST,38,928,961,1889
KIRINYAGA,MWEA EAST,39,969,972,1941
KIRINYAGA,MWEA EAST,35-39,5530,5303,10833
KIRINYAGA,MWEA EAST,40,1245,1103,2348
KIRINYAGA,MWEA EAST,41,943,871,1814
KIRINYAGA,MWEA EAST,42,914,861,1775
KIRINYAGA,MWEA EAST,43,797,749,1546
KIRINYAGA,MWEA EAST,44,786,696,1482
KIRINYAGA,MWEA EAST,40-44,4685,4280,8965
KIRINYAGA,MWEA EAST,45,1036,978,2014
KIRINYAGA,MWEA EAST,46,765,671,1436
KIRINYAGA,MWEA EAST,47,748,621,1369
KIRINYAGA,MWEA EAST,48,553,519,1072
KIRINYAGA,MWEA EAST,49,581,622,1203
KIRINYAGA,MWEA EAST,45-49,3683,3411,7094
KIRINYAGA,MWEA EAST,50,766,774,1540
KIRINYAGA,MWEA EAST,51,556,535,1091
KIRINYAGA,MWEA EAST,52,611,560,1171
KIRINYAGA,MWEA EAST,53,406,424,830
KIRINYAGA,MWEA EAST,54,549,445,994
KIRINYAGA,MWEA EAST,50-54,2888,2738,5626
KIRINYAGA,MWEA EAST,55,581,521,1102
KIRINYAGA,MWEA EAST,56,607,509,1116
KIRINYAGA,MWEA EAST,57,423,431,854
KIRINYAGA,MWEA EAST,58,392,367,759
KIRINYAGA,MWEA EAST,59,432,425,857
KIRINYAGA,MWEA EAST,55-59,2435,2253,4688
KIRINYAGA,MWEA EAST,60,460,426,886
KIRINYAGA,MWEA EAST,61,339,307,646
KIRINYAGA,MWEA EAST,62,277,229,506
KIRINYAGA,MWEA EAST,63,219,230,449
KIRINYAGA,MWEA EAST,64,181,145,326
KIRINYAGA,MWEA EAST,60-64,1476,1337,2813
KIRINYAGA,MWEA EAST,65,294,310,604
KIRINYAGA,MWEA EAST,66,187,158,345
KIRINYAGA,MWEA EAST,67,316,298,614
KIRINYAGA,MWEA EAST,68,155,166,321
KIRINYAGA,MWEA EAST,69,205,209,414
KIRINYAGA,MWEA EAST,65-69,1157,1141,2298
KIRINYAGA,MWEA EAST,70,252,369,621
KIRINYAGA,MWEA EAST,71,165,196,361
KIRINYAGA,MWEA EAST,72,134,143,277
KIRINYAGA,MWEA EAST,73,108,97,205
KIRINYAGA,MWEA EAST,74,99,126,225
KIRINYAGA,MWEA EAST,70-74,758,931,1689
KIRINYAGA,MWEA EAST,75,94,138,232
KIRINYAGA,MWEA EAST,76,65,88,153
KIRINYAGA,MWEA EAST,77,82,102,184
KIRINYAGA,MWEA EAST,78,69,59,128
KIRINYAGA,MWEA EAST,79,60,107,167
KIRINYAGA,MWEA EAST,75-79,370,494,864
KIRINYAGA,MWEA EAST,80,83,200,283
KIRINYAGA,MWEA EAST,81,33,71,104
KIRINYAGA,MWEA EAST,82,49,49,98
KIRINYAGA,MWEA EAST,83,34,55,89
KIRINYAGA,MWEA EAST,84,39,61,100
KIRINYAGA,MWEA EAST,80-84,238,436,674
KIRINYAGA,MWEA EAST,85,35,74,109
KIRINYAGA,MWEA EAST,86,32,30,62
KIRINYAGA,MWEA EAST,87,29,35,64
KIRINYAGA,MWEA EAST,88,21,14,35
KIRINYAGA,MWEA EAST,89,35,71,106
KIRINYAGA,MWEA EAST,85-89,152,224,376
KIRINYAGA,MWEA EAST,90,25,75,100
KIRINYAGA,MWEA EAST,91,24,52,76
KIRINYAGA,MWEA EAST,92,7,15,22
KIRINYAGA,MWEA EAST,93,13,16,29
KIRINYAGA,MWEA EAST,94,11,22,33
KIRINYAGA,MWEA EAST,90-94,80,180,260
KIRINYAGA,MWEA EAST,95,12,42,54
KIRINYAGA,MWEA EAST,96,5,16,21
KIRINYAGA,MWEA EAST,97,10,14,24
KIRINYAGA,MWEA EAST,98,11,13,24
KIRINYAGA,MWEA EAST,99,5,27,32
KIRINYAGA,MWEA EAST,95-99,43,112,155
KIRINYAGA,MWEA EAST,100+,22,69,91
KIRINYAGA,MWEA EAST,Not Stated,-,-,-
KIRINYAGA,MWEA WEST,Total,52228,52594,104822
KIRINYAGA,MWEA WEST,0,1127,1016,2143
KIRINYAGA,MWEA WEST,1,945,973,1918
KIRINYAGA,MWEA WEST,2,932,965,1897
KIRINYAGA,MWEA WEST,3,994,1011,2005
KIRINYAGA,MWEA WEST,4,983,1025,2008
KIRINYAGA,MWEA WEST,0 - 4,4981,4990,9971
KIRINYAGA,MWEA WEST,5,993,959,1952
KIRINYAGA,MWEA WEST,6,986,979,1965
KIRINYAGA,MWEA WEST,7,1010,1050,2060
KIRINYAGA,MWEA WEST,8,1050,989,2039
KIRINYAGA,MWEA WEST,9,1185,1117,2302
KIRINYAGA,MWEA WEST,05-Sep,5224,5094,10318
KIRINYAGA,MWEA WEST,10,1176,1093,2269
KIRINYAGA,MWEA WEST,11,1064,1088,2152
KIRINYAGA,MWEA WEST,12,1098,1130,2228
KIRINYAGA,MWEA WEST,13,1214,1222,2436
KIRINYAGA,MWEA WEST,14,1128,1139,2267
KIRINYAGA,MWEA WEST,Oct-14,5680,5672,11352
KIRINYAGA,MWEA WEST,15,1122,1140,2262
KIRINYAGA,MWEA WEST,16,1239,1114,2353
KIRINYAGA,MWEA WEST,17,1218,1073,2291
KIRINYAGA,MWEA WEST,18,1008,940,1948
KIRINYAGA,MWEA WEST,19,1055,894,1949
KIRINYAGA,MWEA WEST,15-19,5642,5161,10803
KIRINYAGA,MWEA WEST,20,900,906,1806
KIRINYAGA,MWEA WEST,21,755,809,1564
KIRINYAGA,MWEA WEST,22,772,826,1598
KIRINYAGA,MWEA WEST,23,829,852,1681
KIRINYAGA,MWEA WEST,24,767,747,1514
KIRINYAGA,MWEA WEST,20-24,4023,4140,8163
KIRINYAGA,MWEA WEST,25,827,759,1586
KIRINYAGA,MWEA WEST,26,631,699,1330
KIRINYAGA,MWEA WEST,27,768,739,1507
KIRINYAGA,MWEA WEST,28,682,679,1361
KIRINYAGA,MWEA WEST,29,740,838,1578
KIRINYAGA,MWEA WEST,25-29,3648,3714,7362
KIRINYAGA,MWEA WEST,30,952,989,1941
KIRINYAGA,MWEA WEST,31,742,710,1452
KIRINYAGA,MWEA WEST,32,962,1008,1970
KIRINYAGA,MWEA WEST,33,865,933,1798
KIRINYAGA,MWEA WEST,34,730,791,1521
KIRINYAGA,MWEA WEST,30-34,4251,4431,8682
KIRINYAGA,MWEA WEST,35,1067,1095,2162
KIRINYAGA,MWEA WEST,36,820,837,1657
KIRINYAGA,MWEA WEST,37,847,847,1694
KIRINYAGA,MWEA WEST,38,681,756,1437
KIRINYAGA,MWEA WEST,39,798,821,1619
KIRINYAGA,MWEA WEST,35-39,4213,4356,8569
KIRINYAGA,MWEA WEST,40,919,961,1880
KIRINYAGA,MWEA WEST,41,806,721,1527
KIRINYAGA,MWEA WEST,42,751,702,1453
KIRINYAGA,MWEA WEST,43,681,657,1338
KIRINYAGA,MWEA WEST,44,679,623,1302
KIRINYAGA,MWEA WEST,40-44,3836,3664,7500
KIRINYAGA,MWEA WEST,45,845,868,1713
KIRINYAGA,MWEA WEST,46,641,642,1283
KIRINYAGA,MWEA WEST,47,688,568,1256
KIRINYAGA,MWEA WEST,48,470,449,919
KIRINYAGA,MWEA WEST,49,546,507,1053
KIRINYAGA,MWEA WEST,45-49,3190,3034,6224
KIRINYAGA,MWEA WEST,50,624,580,1204
KIRINYAGA,MWEA WEST,51,510,448,958
KIRINYAGA,MWEA WEST,52,505,439,944
KIRINYAGA,MWEA WEST,53,325,276,601
KIRINYAGA,MWEA WEST,54,387,323,710
KIRINYAGA,MWEA WEST,50-54,2351,2066,4417
KIRINYAGA,MWEA WEST,55,424,371,795
KIRINYAGA,MWEA WEST,56,473,430,903
KIRINYAGA,MWEA WEST,57,322,326,648
KIRINYAGA,MWEA WEST,58,275,243,518
KIRINYAGA,MWEA WEST,59,328,322,650
KIRINYAGA,MWEA WEST,55-59,1822,1692,3514
KIRINYAGA,MWEA WEST,60,301,327,628
KIRINYAGA,MWEA WEST,61,263,234,497
KIRINYAGA,MWEA WEST,62,206,225,431
KIRINYAGA,MWEA WEST,63,156,175,331
KIRINYAGA,MWEA WEST,64,130,130,260
KIRINYAGA,MWEA WEST,60-64,1056,1091,2147
KIRINYAGA,MWEA WEST,65,204,259,463
KIRINYAGA,MWEA WEST,66,135,154,289
KIRINYAGA,MWEA WEST,67,254,273,527
KIRINYAGA,MWEA WEST,68,118,132,250
KIRINYAGA,MWEA WEST,69,144,188,332
KIRINYAGA,MWEA WEST,65-69,855,1006,1861
KIRINYAGA,MWEA WEST,70,177,360,537
KIRINYAGA,MWEA WEST,71,139,187,326
KIRINYAGA,MWEA WEST,72,111,161,272
KIRINYAGA,MWEA WEST,73,95,100,195
KIRINYAGA,MWEA WEST,74,96,136,232
KIRINYAGA,MWEA WEST,70-74,618,944,1562
KIRINYAGA,MWEA WEST,75,75,144,219
KIRINYAGA,MWEA WEST,76,64,85,149
KIRINYAGA,MWEA WEST,77,69,100,169
KIRINYAGA,MWEA WEST,78,46,64,110
KIRINYAGA,MWEA WEST,79,74,120,194
KIRINYAGA,MWEA WEST,75-79,328,513,841
KIRINYAGA,MWEA WEST,80,88,171,259
KIRINYAGA,MWEA WEST,81,32,87,119
KIRINYAGA,MWEA WEST,82,36,45,81
KIRINYAGA,MWEA WEST,83,38,69,107
KIRINYAGA,MWEA WEST,84,36,81,117
KIRINYAGA,MWEA WEST,80-84,230,453,683
KIRINYAGA,MWEA WEST,85,51,52,103
KIRINYAGA,MWEA WEST,86,32,35,67
KIRINYAGA,MWEA WEST,87,22,37,59
KIRINYAGA,MWEA WEST,88,17,25,42
KIRINYAGA,MWEA WEST,89,37,81,118
KIRINYAGA,MWEA WEST,85-89,159,230,389
KIRINYAGA,MWEA WEST,90,17,58,75
KIRINYAGA,MWEA WEST,91,19,59,78
KIRINYAGA,MWEA WEST,92,5,21,26
KIRINYAGA,MWEA WEST,93,20,12,32
KIRINYAGA,MWEA WEST,94,7,21,28
KIRINYAGA,MWEA WEST,90-94,68,171,239
KIRINYAGA,MWEA WEST,95,7,25,32
KIRINYAGA,MWEA WEST,96,6,17,23
KIRINYAGA,MWEA WEST,97,11,17,28
KIRINYAGA,MWEA WEST,98,5,8,13
KIRINYAGA,MWEA WEST,99,7,30,37
KIRINYAGA,MWEA WEST,95-99,36,97,133
KIRINYAGA,MWEA WEST,100+,17,74,91
KIRINYAGA,MWEA WEST,Not Stated,-,1,1
KIRINYAGA,MT. KENYA FORE,Total,42,28,70
KIRINYAGA,MT. KENYA FORE,0,1,1,2
KIRINYAGA,MT. KENYA FORE,1,1,-,1
KIRINYAGA,MT. KENYA FORE,2,-,2,2
KIRINYAGA,MT. KENYA FORE,3,-,-,-
KIRINYAGA,MT. KENYA FORE,4,-,2,2
KIRINYAGA,MT. KENYA FORE,0 - 4,2,5,7
KIRINYAGA,MT. KENYA FORE,5,1,-,1
KIRINYAGA,MT. KENYA FORE,6,-,-,-
KIRINYAGA,MT. KENYA FORE,7,-,-,-
KIRINYAGA,MT. KENYA FORE,8,-,-,-
KIRINYAGA,MT. KENYA FORE,9,-,-,-
KIRINYAGA,MT. KENYA FORE,05-Sep,1,-,1
KIRINYAGA,MT. KENYA FORE,10,-,-,-
KIRINYAGA,MT. KENYA FORE,11,-,-,-
KIRINYAGA,MT. KENYA FORE,12,-,-,-
KIRINYAGA,MT. KENYA FORE,13,-,-,-
KIRINYAGA,MT. KENYA FORE,14,1,-,1
KIRINYAGA,MT. KENYA FORE,Oct-14,1,-,1
KIRINYAGA,MT. KENYA FORE,15,-,-,-
KIRINYAGA,MT. KENYA FORE,16,-,-,-
KIRINYAGA,MT. KENYA FORE,17,-,1,1
KIRINYAGA,MT. KENYA FORE,18,-,-,-
KIRINYAGA,MT. KENYA FORE,19,-,-,-
KIRINYAGA,MT. KENYA FORE,15-19,-,1,1
KIRINYAGA,MT. KENYA FORE,20,1,-,1
KIRINYAGA,MT. KENYA FORE,21,-,-,-
KIRINYAGA,MT. KENYA FORE,22,-,1,1
KIRINYAGA,MT. KENYA FORE,23,2,2,4
KIRINYAGA,MT. KENYA FORE,24,1,-,1
KIRINYAGA,MT. KENYA FORE,20-24,4,3,7
KIRINYAGA,MT. KENYA FORE,25,3,6,9
KIRINYAGA,MT. KENYA FORE,26,1,-,1
KIRINYAGA,MT. KENYA FORE,27,1,-,1
KIRINYAGA,MT. KENYA FORE,28,5,-,5
KIRINYAGA,MT. KENYA FORE,29,-,-,-
KIRINYAGA,MT. KENYA FORE,25-29,10,6,16
KIRINYAGA,MT. KENYA FORE,30,1,2,3
KIRINYAGA,MT. KENYA FORE,31,2,1,3
KIRINYAGA,MT. KENYA FORE,32,1,-,1
KIRINYAGA,MT. KENYA FORE,33,2,-,2
KIRINYAGA,MT. KENYA FORE,34,2,2,4
KIRINYAGA,MT. KENYA FORE,30-34,8,5,13
KIRINYAGA,MT. KENYA FORE,35,3,-,3
KIRINYAGA,MT. KENYA FORE,36,-,1,1
KIRINYAGA,MT. KENYA FORE,37,-,-,-
KIRINYAGA,MT. KENYA FORE,38,-,-,-
KIRINYAGA,MT. KENYA FORE,39,1,-,1
KIRINYAGA,MT. KENYA FORE,35-39,4,1,5
KIRINYAGA,MT. KENYA FORE,40,1,-,1
KIRINYAGA,MT. KENYA FORE,41,1,-,1
KIRINYAGA,MT. KENYA FORE,42,-,-,-
KIRINYAGA,MT. KENYA FORE,43,1,-,1
KIRINYAGA,MT. KENYA FORE,44,1,-,1
KIRINYAGA,MT. KENYA FORE,40-44,4,-,4
KIRINYAGA,MT. KENYA FORE,45,1,-,1
KIRINYAGA,MT. KENYA FORE,46,-,-,-
KIRINYAGA,MT. KENYA FORE,47,-,-,-
KIRINYAGA,MT. KENYA FORE,48,-,-,-
KIRINYAGA,MT. KENYA FORE,49,1,-,1
KIRINYAGA,MT. KENYA FORE,45-49,2,-,2
KIRINYAGA,MT. KENYA FORE,50,-,-,-
KIRINYAGA,MT. KENYA FORE,51,1,-,1
KIRINYAGA,MT. KENYA FORE,52,2,1,3
KIRINYAGA,MT. KENYA FORE,53,-,1,1
KIRINYAGA,MT. KENYA FORE,54,-,1,1
KIRINYAGA,MT. KENYA FORE,50-54,3,3,6
KIRINYAGA,MT. KENYA FORE,55,-,-,-
KIRINYAGA,MT. KENYA FORE,56,1,-,1
KIRINYAGA,MT. KENYA FORE,57,-,-,-
KIRINYAGA,MT. KENYA FORE,58,-,1,1
KIRINYAGA,MT. KENYA FORE,59,1,-,1
KIRINYAGA,MT. KENYA FORE,55-59,2,1,3
KIRINYAGA,MT. KENYA FORE,60,-,-,-
KIRINYAGA,MT. KENYA FORE,61,-,1,1
KIRINYAGA,MT. KENYA FORE,62,-,-,-
KIRINYAGA,MT. KENYA FORE,63,-,-,-
KIRINYAGA,MT. KENYA FORE,64,-,1,1
KIRINYAGA,MT. KENYA FORE,60-64,-,2,2
KIRINYAGA,MT. KENYA FORE,65,1,-,1
KIRINYAGA,MT. KENYA FORE,66,-,-,-
KIRINYAGA,MT. KENYA FORE,67,-,-,-
KIRINYAGA,MT. KENYA FORE,68,-,-,-
KIRINYAGA,MT. KENYA FORE,69,-,-,-
KIRINYAGA,MT. KENYA FORE,65-69,1,-,1
KIRINYAGA,MT. KENYA FORE,70,-,-,-
KIRINYAGA,MT. KENYA FORE,71,-,-,-
KIRINYAGA,MT. KENYA FORE,72,-,-,-
KIRINYAGA,MT. KENYA FORE,73,-,1,1
KIRINYAGA,MT. KENYA FORE,74,-,-,-
KIRINYAGA,MT. KENYA FORE,70-74,-,1,1
KIRINYAGA,MT. KENYA FORE,75,-,-,-
KIRINYAGA,MT. KENYA FORE,76,-,-,-
KIRINYAGA,MT. KENYA FORE,77,-,-,-
KIRINYAGA,MT. KENYA FORE,78,-,-,-
KIRINYAGA,MT. KENYA FORE,79,-,-,-
KIRINYAGA,MT. KENYA FORE,75-79,-,-,-
KIRINYAGA,MT. KENYA FORE,80,-,-,-
KIRINYAGA,MT. KENYA FORE,81,-,-,-
KIRINYAGA,MT. KENYA FORE,82,-,-,-
KIRINYAGA,MT. KENYA FORE,83,-,-,-
KIRINYAGA,MT. KENYA FORE,84,-,-,-
KIRINYAGA,MT. KENYA FORE,80-84,-,-,-
KIRINYAGA,MT. KENYA FORE,85,-,-,-
KIRINYAGA,MT. KENYA FORE,86,-,-,-
KIRINYAGA,MT. KENYA FORE,87,-,-,-
KIRINYAGA,MT. KENYA FORE,88,-,-,-
KIRINYAGA,MT. KENYA FORE,89,-,-,-
KIRINYAGA,MT. KENYA FORE,85-89,-,-,-
KIRINYAGA,MT. KENYA FORE,90,-,-,-
KIRINYAGA,MT. KENYA FORE,91,-,-,-
KIRINYAGA,MT. KENYA FORE,92,-,-,-
KIRINYAGA,MT. KENYA FORE,93,-,-,-
KIRINYAGA,MT. KENYA FORE,94,-,-,-
KIRINYAGA,MT. KENYA FORE,90-94,-,-,-
KIRINYAGA,MT. KENYA FORE,95,-,-,-
KIRINYAGA,MT. KENYA FORE,96,-,-,-
KIRINYAGA,MT. KENYA FORE,97,-,-,-
KIRINYAGA,MT. KENYA FORE,98,-,-,-
KIRINYAGA,MT. KENYA FORE,99,-,-,-
KIRINYAGA,MT. KENYA FORE,95-99,-,-,-
KIRINYAGA,MT. KENYA FORE,100+,-,-,-
KIRINYAGA,MT. KENYA FORE,Not Stated,-,-,-
KISII,ALL,Total,605784,661038,1266822
KISII,ALL,0,13498,13564,27062
KISII,ALL,1,13548,13374,26922
KISII,ALL,2,13895,13822,27717
KISII,ALL,3,15058,15276,30334
KISII,ALL,4,15814,15658,31472
KISII,ALL,0 - 4,71813,71694,143507
KISII,ALL,5,15818,15813,31631
KISII,ALL,6,16995,17034,34029
KISII,ALL,7,17688,17370,35058
KISII,ALL,8,16709,16858,33567
KISII,ALL,9,18870,18795,37665
KISII,ALL,05-Sep,86080,85870,171950
KISII,ALL,10,20721,20333,41054
KISII,ALL,11,17690,18410,36100
KISII,ALL,12,21501,20343,41844
KISII,ALL,13,20009,20238,40247
KISII,ALL,14,18146,17995,36141
KISII,ALL,Oct-14,98067,97319,195386
KISII,ALL,15,17332,17437,34769
KISII,ALL,16,15694,15662,31356
KISII,ALL,17,15979,15617,31596
KISII,ALL,18,12915,12710,25625
KISII,ALL,19,13222,13599,26821
KISII,ALL,15-19,75142,75025,150167
KISII,ALL,20,10891,12724,23615
KISII,ALL,21,8954,10945,19899
KISII,ALL,22,8784,10867,19651
KISII,ALL,23,8849,11707,20556
KISII,ALL,24,8119,10686,18805
KISII,ALL,20-24,45597,56929,102526
KISII,ALL,25,9666,12796,22462
KISII,ALL,26,7822,10510,18332
KISII,ALL,27,8248,10562,18810
KISII,ALL,28,6535,8565,15100
KISII,ALL,29,7000,9368,16368
KISII,ALL,25-29,39271,51801,91072
KISII,ALL,30,9467,13378,22845
KISII,ALL,31,7401,10034,17435
KISII,ALL,32,8714,11889,20603
KISII,ALL,33,7185,10453,17638
KISII,ALL,34,6391,8768,15159
KISII,ALL,30-34,39158,54522,93680
KISII,ALL,35,8576,9664,18240
KISII,ALL,36,5782,5527,11309
KISII,ALL,37,6068,5615,11683
KISII,ALL,38,4369,4268,8637
KISII,ALL,39,5383,5485,10868
KISII,ALL,35-39,30178,30559,60737
KISII,ALL,40,6462,6506,12968
KISII,ALL,41,6798,6275,13073
KISII,ALL,42,5124,4965,10089
KISII,ALL,43,4898,5053,9951
KISII,ALL,44,3488,4049,7537
KISII,ALL,40-44,26770,26848,53618
KISII,ALL,45,6493,7392,13885
KISII,ALL,46,4301,5487,9788
KISII,ALL,47,4700,6067,10767
KISII,ALL,48,2735,3226,5961
KISII,ALL,49,3266,4233,7499
KISII,ALL,45-49,21495,26405,47900
KISII,ALL,50,4234,4846,9080
KISII,ALL,51,3500,3476,6976
KISII,ALL,52,2578,2296,4874
KISII,ALL,53,2046,1796,3842
KISII,ALL,54,2556,2180,4736
KISII,ALL,50-54,14914,14594,29508
KISII,ALL,55,3359,3013,6372
KISII,ALL,56,3818,3874,7692
KISII,ALL,57,4153,5473,9626
KISII,ALL,58,2811,3318,6129
KISII,ALL,59,3936,4860,8796
KISII,ALL,55-59,18077,20538,38615
KISII,ALL,60,3886,5206,9092
KISII,ALL,61,3422,3800,7222
KISII,ALL,62,2411,2671,5082
KISII,ALL,63,2562,2829,5391
KISII,ALL,64,1846,2078,3924
KISII,ALL,60-64,14127,16584,30711
KISII,ALL,65,2703,3494,6197
KISII,ALL,66,1567,1632,3199
KISII,ALL,67,2466,2760,5226
KISII,ALL,68,1071,1372,2443
KISII,ALL,69,1947,2517,4464
KISII,ALL,65-69,9754,11775,21529
KISII,ALL,70,2049,3375,5424
KISII,ALL,71,1701,1695,3396
KISII,ALL,72,1255,1149,2404
KISII,ALL,73,998,952,1950
KISII,ALL,74,1027,1343,2370
KISII,ALL,70-74,7030,8514,15544
KISII,ALL,75,864,1186,2050
KISII,ALL,76,558,624,1182
KISII,ALL,77,871,898,1769
KISII,ALL,78,480,478,958
KISII,ALL,79,666,1252,1918
KISII,ALL,75-79,3439,4438,7877
KISII,ALL,80,741,1400,2141
KISII,ALL,81,486,719,1205
KISII,ALL,82,396,418,814
KISII,ALL,83,437,473,910
KISII,ALL,84,414,657,1071
KISII,ALL,80-84,2474,3667,6141
KISII,ALL,85,336,552,888
KISII,ALL,86,261,280,541
KISII,ALL,87,361,416,777
KISII,ALL,88,190,229,419
KISII,ALL,89,337,732,1069
KISII,ALL,85-89,1485,2209,3694
KISII,ALL,90,164,401,565
KISII,ALL,91,117,179,296
KISII,ALL,92,114,123,237
KISII,ALL,93,50,102,152
KISII,ALL,94,89,150,239
KISII,ALL,90-94,534,955,1489
KISII,ALL,95,91,152,243
KISII,ALL,96,43,66,109
KISII,ALL,97,59,85,144
KISII,ALL,98,28,63,91
KISII,ALL,99,51,120,171
KISII,ALL,95-99,272,486,758
KISII,ALL,100+,92,299,391
KISII,ALL,Not Stated,15,7,22
KISII,ETAGO,Total,40137,43647,83784
KISII,ETAGO,0,923,929,1852
KISII,ETAGO,1,941,894,1835
KISII,ETAGO,2,902,969,1871
KISII,ETAGO,3,1089,1142,2231
KISII,ETAGO,4,1204,1178,2382
KISII,ETAGO,0 - 4,5059,5112,10171
KISII,ETAGO,5,1210,1234,2444
KISII,ETAGO,6,1350,1374,2724
KISII,ETAGO,7,1377,1303,2680
KISII,ETAGO,8,1305,1334,2639
KISII,ETAGO,9,1375,1407,2782
KISII,ETAGO,05-Sep,6617,6652,13269
KISII,ETAGO,10,1613,1572,3185
KISII,ETAGO,11,1379,1442,2821
KISII,ETAGO,12,1577,1470,3047
KISII,ETAGO,13,1434,1445,2879
KISII,ETAGO,14,1239,1227,2466
KISII,ETAGO,Oct-14,7242,7156,14398
KISII,ETAGO,15,1189,1244,2433
KISII,ETAGO,16,1042,985,2027
KISII,ETAGO,17,1033,970,2003
KISII,ETAGO,18,791,781,1572
KISII,ETAGO,19,873,894,1767
KISII,ETAGO,15-19,4928,4874,9802
KISII,ETAGO,20,708,796,1504
KISII,ETAGO,21,462,618,1080
KISII,ETAGO,22,509,632,1141
KISII,ETAGO,23,501,605,1106
KISII,ETAGO,24,428,586,1014
KISII,ETAGO,20-24,2608,3237,5845
KISII,ETAGO,25,526,692,1218
KISII,ETAGO,26,458,587,1045
KISII,ETAGO,27,507,590,1097
KISII,ETAGO,28,363,426,789
KISII,ETAGO,29,423,520,943
KISII,ETAGO,25-29,2277,2815,5092
KISII,ETAGO,30,576,799,1375
KISII,ETAGO,31,557,703,1260
KISII,ETAGO,32,523,768,1291
KISII,ETAGO,33,502,743,1245
KISII,ETAGO,34,419,585,1004
KISII,ETAGO,30-34,2577,3598,6175
KISII,ETAGO,35,527,577,1104
KISII,ETAGO,36,353,330,683
KISII,ETAGO,37,401,331,732
KISII,ETAGO,38,240,212,452
KISII,ETAGO,39,295,305,600
KISII,ETAGO,35-39,1816,1755,3571
KISII,ETAGO,40,346,372,718
KISII,ETAGO,41,392,366,758
KISII,ETAGO,42,305,273,578
KISII,ETAGO,43,280,247,527
KISII,ETAGO,44,176,224,400
KISII,ETAGO,40-44,1499,1482,2981
KISII,ETAGO,45,412,424,836
KISII,ETAGO,46,331,418,749
KISII,ETAGO,47,331,464,795
KISII,ETAGO,48,136,203,339
KISII,ETAGO,49,190,292,482
KISII,ETAGO,45-49,1400,1801,3201
KISII,ETAGO,50,234,282,516
KISII,ETAGO,51,229,213,442
KISII,ETAGO,52,149,121,270
KISII,ETAGO,53,120,84,204
KISII,ETAGO,54,118,100,218
KISII,ETAGO,50-54,850,800,1650
KISII,ETAGO,55,176,190,366
KISII,ETAGO,56,247,222,469
KISII,ETAGO,57,225,352,577
KISII,ETAGO,58,144,193,337
KISII,ETAGO,59,201,376,577
KISII,ETAGO,55-59,993,1333,2326
KISII,ETAGO,60,217,345,562
KISII,ETAGO,61,204,253,457
KISII,ETAGO,62,126,155,281
KISII,ETAGO,63,121,162,283
KISII,ETAGO,64,114,132,246
KISII,ETAGO,60-64,782,1047,1829
KISII,ETAGO,65,171,216,387
KISII,ETAGO,66,92,117,209
KISII,ETAGO,67,125,202,327
KISII,ETAGO,68,65,101,166
KISII,ETAGO,69,106,161,267
KISII,ETAGO,65-69,559,797,1356
KISII,ETAGO,70,111,175,286
KISII,ETAGO,71,105,108,213
KISII,ETAGO,72,64,70,134
KISII,ETAGO,73,45,51,96
KISII,ETAGO,74,54,88,142
KISII,ETAGO,70-74,379,492,871
KISII,ETAGO,75,56,74,130
KISII,ETAGO,76,26,47,73
KISII,ETAGO,77,56,64,120
KISII,ETAGO,78,28,31,59
KISII,ETAGO,79,53,81,134
KISII,ETAGO,75-79,219,297,516
KISII,ETAGO,80,42,77,119
KISII,ETAGO,81,38,32,70
KISII,ETAGO,82,25,20,45
KISII,ETAGO,83,26,26,52
KISII,ETAGO,84,26,40,66
KISII,ETAGO,80-84,157,195,352
KISII,ETAGO,85,24,28,52
KISII,ETAGO,86,16,17,33
KISII,ETAGO,87,26,23,49
KISII,ETAGO,88,14,12,26
KISII,ETAGO,89,29,46,75
KISII,ETAGO,85-89,109,126,235
KISII,ETAGO,90,7,21,28
KISII,ETAGO,91,10,8,18
KISII,ETAGO,92,10,5,15
KISII,ETAGO,93,2,6,8
KISII,ETAGO,94,7,2,9
KISII,ETAGO,90-94,36,42,78
KISII,ETAGO,95,7,10,17
KISII,ETAGO,96,4,3,7
KISII,ETAGO,97,5,9,14
KISII,ETAGO,98,2,-,2
KISII,ETAGO,99,5,5,10
KISII,ETAGO,95-99,23,27,50
KISII,ETAGO,100+,6,9,15
KISII,ETAGO,Not Stated,1,-,1
KISII,GUCHA,Total,39631,44108,83739
KISII,GUCHA,0,916,895,1811
KISII,GUCHA,1,914,909,1823
KISII,GUCHA,2,935,903,1838
KISII,GUCHA,3,1000,970,1970
KISII,GUCHA,4,1037,1014,2051
KISII,GUCHA,0 - 4,4802,4691,9493
KISII,GUCHA,5,1075,1100,2175
KISII,GUCHA,6,1152,1148,2300
KISII,GUCHA,7,1222,1198,2420
KISII,GUCHA,8,1121,1125,2246
KISII,GUCHA,9,1268,1347,2615
KISII,GUCHA,05-Sep,5838,5918,11756
KISII,GUCHA,10,1504,1453,2957
KISII,GUCHA,11,1224,1317,2541
KISII,GUCHA,12,1530,1423,2953
KISII,GUCHA,13,1384,1396,2780
KISII,GUCHA,14,1279,1259,2538
KISII,GUCHA,Oct-14,6921,6848,13769
KISII,GUCHA,15,1192,1170,2362
KISII,GUCHA,16,1076,1076,2152
KISII,GUCHA,17,1104,1088,2192
KISII,GUCHA,18,858,852,1710
KISII,GUCHA,19,857,865,1722
KISII,GUCHA,15-19,5087,5051,10138
KISII,GUCHA,20,676,850,1526
KISII,GUCHA,21,525,678,1203
KISII,GUCHA,22,577,716,1293
KISII,GUCHA,23,515,797,1312
KISII,GUCHA,24,466,678,1144
KISII,GUCHA,20-24,2759,3719,6478
KISII,GUCHA,25,561,846,1407
KISII,GUCHA,26,437,703,1140
KISII,GUCHA,27,537,688,1225
KISII,GUCHA,28,362,585,947
KISII,GUCHA,29,408,666,1074
KISII,GUCHA,25-29,2305,3488,5793
KISII,GUCHA,30,578,889,1467
KISII,GUCHA,31,496,680,1176
KISII,GUCHA,32,463,742,1205
KISII,GUCHA,33,457,611,1068
KISII,GUCHA,34,355,523,878
KISII,GUCHA,30-34,2349,3445,5794
KISII,GUCHA,35,537,612,1149
KISII,GUCHA,36,364,357,721
KISII,GUCHA,37,360,368,728
KISII,GUCHA,38,253,274,527
KISII,GUCHA,39,342,358,700
KISII,GUCHA,35-39,1856,1969,3825
KISII,GUCHA,40,393,404,797
KISII,GUCHA,41,454,397,851
KISII,GUCHA,42,322,360,682
KISII,GUCHA,43,302,357,659
KISII,GUCHA,44,249,273,522
KISII,GUCHA,40-44,1720,1791,3511
KISII,GUCHA,45,391,463,854
KISII,GUCHA,46,271,394,665
KISII,GUCHA,47,299,427,726
KISII,GUCHA,48,168,221,389
KISII,GUCHA,49,205,314,519
KISII,GUCHA,45-49,1334,1819,3153
KISII,GUCHA,50,222,308,530
KISII,GUCHA,51,252,241,493
KISII,GUCHA,52,160,120,280
KISII,GUCHA,53,132,96,228
KISII,GUCHA,54,150,123,273
KISII,GUCHA,50-54,916,888,1804
KISII,GUCHA,55,239,181,420
KISII,GUCHA,56,216,220,436
KISII,GUCHA,57,303,306,609
KISII,GUCHA,58,217,216,433
KISII,GUCHA,59,268,307,575
KISII,GUCHA,55-59,1243,1230,2473
KISII,GUCHA,60,251,414,665
KISII,GUCHA,61,224,256,480
KISII,GUCHA,62,160,175,335
KISII,GUCHA,63,180,168,348
KISII,GUCHA,64,100,136,236
KISII,GUCHA,60-64,915,1149,2064
KISII,GUCHA,65,200,276,476
KISII,GUCHA,66,108,119,227
KISII,GUCHA,67,133,161,294
KISII,GUCHA,68,78,93,171
KISII,GUCHA,69,113,123,236
KISII,GUCHA,65-69,632,772,1404
KISII,GUCHA,70,138,235,373
KISII,GUCHA,71,107,96,203
KISII,GUCHA,72,68,65,133
KISII,GUCHA,73,60,61,121
KISII,GUCHA,74,69,79,148
KISII,GUCHA,70-74,442,536,978
KISII,GUCHA,75,50,62,112
KISII,GUCHA,76,39,44,83
KISII,GUCHA,77,45,48,93
KISII,GUCHA,78,29,31,60
KISII,GUCHA,79,36,67,103
KISII,GUCHA,75-79,199,252,451
KISII,GUCHA,80,38,103,141
KISII,GUCHA,81,25,43,68
KISII,GUCHA,82,23,26,49
KISII,GUCHA,83,38,35,73
KISII,GUCHA,84,27,37,64
KISII,GUCHA,80-84,151,244,395
KISII,GUCHA,85,19,51,70
KISII,GUCHA,86,21,17,38
KISII,GUCHA,87,27,31,58
KISII,GUCHA,88,10,18,28
KISII,GUCHA,89,23,33,56
KISII,GUCHA,85-89,100,150,250
KISII,GUCHA,90,11,35,46
KISII,GUCHA,91,9,16,25
KISII,GUCHA,92,10,9,19
KISII,GUCHA,93,1,5,6
KISII,GUCHA,94,4,13,17
KISII,GUCHA,90-94,35,78,113
KISII,GUCHA,95,6,11,17
KISII,GUCHA,96,5,3,8
KISII,GUCHA,97,3,8,11
KISII,GUCHA,98,2,7,9
KISII,GUCHA,99,5,15,20
KISII,GUCHA,95-99,21,44,65
KISII,GUCHA,100+,6,25,31
KISII,GUCHA,Not Stated,-,1,1
KISII,GUCHA SOUTH,Total,40022,43598,83620
KISII,GUCHA SOUTH,0,802,840,1642
KISII,GUCHA SOUTH,1,933,863,1796
KISII,GUCHA SOUTH,2,922,877,1799
KISII,GUCHA SOUTH,3,1037,950,1987
KISII,GUCHA SOUTH,4,1031,1110,2141
KISII,GUCHA SOUTH,0 - 4,4725,4640,9365
KISII,GUCHA SOUTH,5,1085,1033,2118
KISII,GUCHA SOUTH,6,1130,1160,2290
KISII,GUCHA SOUTH,7,1243,1174,2417
KISII,GUCHA SOUTH,8,1151,1161,2312
KISII,GUCHA SOUTH,9,1288,1272,2560
KISII,GUCHA SOUTH,05-Sep,5897,5800,11697
KISII,GUCHA SOUTH,10,1465,1480,2945
KISII,GUCHA SOUTH,11,1291,1281,2572
KISII,GUCHA SOUTH,12,1517,1392,2909
KISII,GUCHA SOUTH,13,1424,1420,2844
KISII,GUCHA SOUTH,14,1258,1214,2472
KISII,GUCHA SOUTH,Oct-14,6955,6787,13742
KISII,GUCHA SOUTH,15,1193,1218,2411
KISII,GUCHA SOUTH,16,1074,998,2072
KISII,GUCHA SOUTH,17,1087,1002,2089
KISII,GUCHA SOUTH,18,842,840,1682
KISII,GUCHA SOUTH,19,875,875,1750
KISII,GUCHA SOUTH,15-19,5071,4933,10004
KISII,GUCHA SOUTH,20,736,885,1621
KISII,GUCHA SOUTH,21,563,647,1210
KISII,GUCHA SOUTH,22,516,653,1169
KISII,GUCHA SOUTH,23,563,712,1275
KISII,GUCHA SOUTH,24,494,693,1187
KISII,GUCHA SOUTH,20-24,2872,3590,6462
KISII,GUCHA SOUTH,25,585,775,1360
KISII,GUCHA SOUTH,26,430,623,1053
KISII,GUCHA SOUTH,27,526,616,1142
KISII,GUCHA SOUTH,28,384,517,901
KISII,GUCHA SOUTH,29,421,562,983
KISII,GUCHA SOUTH,25-29,2346,3093,5439
KISII,GUCHA SOUTH,30,590,893,1483
KISII,GUCHA SOUTH,31,491,754,1245
KISII,GUCHA SOUTH,32,577,858,1435
KISII,GUCHA SOUTH,33,463,675,1138
KISII,GUCHA SOUTH,34,436,576,1012
KISII,GUCHA SOUTH,30-34,2557,3756,6313
KISII,GUCHA SOUTH,35,558,630,1188
KISII,GUCHA SOUTH,36,348,369,717
KISII,GUCHA SOUTH,37,375,307,682
KISII,GUCHA SOUTH,38,268,229,497
KISII,GUCHA SOUTH,39,333,327,660
KISII,GUCHA SOUTH,35-39,1882,1862,3744
KISII,GUCHA SOUTH,40,390,430,820
KISII,GUCHA SOUTH,41,454,381,835
KISII,GUCHA SOUTH,42,337,282,619
KISII,GUCHA SOUTH,43,307,299,606
KISII,GUCHA SOUTH,44,228,244,472
KISII,GUCHA SOUTH,40-44,1716,1636,3352
KISII,GUCHA SOUTH,45,438,500,938
KISII,GUCHA SOUTH,46,304,347,651
KISII,GUCHA SOUTH,47,313,396,709
KISII,GUCHA SOUTH,48,148,203,351
KISII,GUCHA SOUTH,49,238,270,508
KISII,GUCHA SOUTH,45-49,1441,1716,3157
KISII,GUCHA SOUTH,50,260,348,608
KISII,GUCHA SOUTH,51,211,230,441
KISII,GUCHA SOUTH,52,157,143,300
KISII,GUCHA SOUTH,53,140,130,270
KISII,GUCHA SOUTH,54,166,146,312
KISII,GUCHA SOUTH,50-54,934,997,1931
KISII,GUCHA SOUTH,55,250,206,456
KISII,GUCHA SOUTH,56,289,274,563
KISII,GUCHA SOUTH,57,260,379,639
KISII,GUCHA SOUTH,58,157,216,373
KISII,GUCHA SOUTH,59,269,298,567
KISII,GUCHA SOUTH,55-59,1225,1373,2598
KISII,GUCHA SOUTH,60,211,317,528
KISII,GUCHA SOUTH,61,212,232,444
KISII,GUCHA SOUTH,62,157,196,353
KISII,GUCHA SOUTH,63,138,193,331
KISII,GUCHA SOUTH,64,131,162,293
KISII,GUCHA SOUTH,60-64,849,1100,1949
KISII,GUCHA SOUTH,65,166,225,391
KISII,GUCHA SOUTH,66,97,111,208
KISII,GUCHA SOUTH,67,138,209,347
KISII,GUCHA SOUTH,68,77,80,157
KISII,GUCHA SOUTH,69,129,194,323
KISII,GUCHA SOUTH,65-69,607,819,1426
KISII,GUCHA SOUTH,70,125,230,355
KISII,GUCHA SOUTH,71,100,144,244
KISII,GUCHA SOUTH,72,79,87,166
KISII,GUCHA SOUTH,73,53,64,117
KISII,GUCHA SOUTH,74,63,82,145
KISII,GUCHA SOUTH,70-74,420,607,1027
KISII,GUCHA SOUTH,75,51,89,140
KISII,GUCHA SOUTH,76,25,37,62
KISII,GUCHA SOUTH,77,56,56,112
KISII,GUCHA SOUTH,78,31,36,67
KISII,GUCHA SOUTH,79,51,67,118
KISII,GUCHA SOUTH,75-79,214,285,499
KISII,GUCHA SOUTH,80,51,108,159
KISII,GUCHA SOUTH,81,28,48,76
KISII,GUCHA SOUTH,82,24,31,55
KISII,GUCHA SOUTH,83,20,38,58
KISII,GUCHA SOUTH,84,13,64,77
KISII,GUCHA SOUTH,80-84,136,289,425
KISII,GUCHA SOUTH,85,24,35,59
KISII,GUCHA SOUTH,86,15,26,41
KISII,GUCHA SOUTH,87,37,39,76
KISII,GUCHA SOUTH,88,11,17,28
KISII,GUCHA SOUTH,89,20,63,83
KISII,GUCHA SOUTH,85-89,107,180,287
KISII,GUCHA SOUTH,90,7,32,39
KISII,GUCHA SOUTH,91,15,15,30
KISII,GUCHA SOUTH,92,5,10,15
KISII,GUCHA SOUTH,93,4,7,11
KISII,GUCHA SOUTH,94,7,10,17
KISII,GUCHA SOUTH,90-94,38,74,112
KISII,GUCHA SOUTH,95,10,12,22
KISII,GUCHA SOUTH,96,4,4,8
KISII,GUCHA SOUTH,97,-,4,4
KISII,GUCHA SOUTH,98,1,6,7
KISII,GUCHA SOUTH,99,2,11,13
KISII,GUCHA SOUTH,95-99,17,37,54
KISII,GUCHA SOUTH,100+,10,23,33
KISII,GUCHA SOUTH,Not Stated,3,1,4
KISII,KENYENYA,Total,62859,68878,131737
KISII,KENYENYA,0,1391,1387,2778
KISII,KENYENYA,1,1370,1396,2766
KISII,KENYENYA,2,1421,1449,2870
KISII,KENYENYA,3,1592,1681,3273
KISII,KENYENYA,4,1700,1718,3418
KISII,KENYENYA,0 - 4,7474,7631,15105
KISII,KENYENYA,5,1689,1701,3390
KISII,KENYENYA,6,1851,1819,3670
KISII,KENYENYA,7,1908,1900,3808
KISII,KENYENYA,8,1822,1770,3592
KISII,KENYENYA,9,2119,2057,4176
KISII,KENYENYA,05-Sep,9389,9247,18636
KISII,KENYENYA,10,2281,2200,4481
KISII,KENYENYA,11,1948,2050,3998
KISII,KENYENYA,12,2278,2277,4555
KISII,KENYENYA,13,2201,2246,4447
KISII,KENYENYA,14,1873,1904,3777
KISII,KENYENYA,Oct-14,10581,10677,21258
KISII,KENYENYA,15,1877,1911,3788
KISII,KENYENYA,16,1731,1705,3436
KISII,KENYENYA,17,1753,1611,3364
KISII,KENYENYA,18,1335,1273,2608
KISII,KENYENYA,19,1436,1401,2837
KISII,KENYENYA,15-19,8132,7901,16033
KISII,KENYENYA,20,1065,1238,2303
KISII,KENYENYA,21,852,1047,1899
KISII,KENYENYA,22,879,1037,1916
KISII,KENYENYA,23,782,1140,1922
KISII,KENYENYA,24,666,937,1603
KISII,KENYENYA,20-24,4244,5399,9643
KISII,KENYENYA,25,837,1157,1994
KISII,KENYENYA,26,762,1001,1763
KISII,KENYENYA,27,780,1027,1807
KISII,KENYENYA,28,606,800,1406
KISII,KENYENYA,29,685,911,1596
KISII,KENYENYA,25-29,3670,4896,8566
KISII,KENYENYA,30,846,1335,2181
KISII,KENYENYA,31,697,1024,1721
KISII,KENYENYA,32,891,1157,2048
KISII,KENYENYA,33,749,1099,1848
KISII,KENYENYA,34,587,988,1575
KISII,KENYENYA,30-34,3770,5603,9373
KISII,KENYENYA,35,796,968,1764
KISII,KENYENYA,36,561,563,1124
KISII,KENYENYA,37,587,613,1200
KISII,KENYENYA,38,432,415,847
KISII,KENYENYA,39,587,620,1207
KISII,KENYENYA,35-39,2963,3179,6142
KISII,KENYENYA,40,663,629,1292
KISII,KENYENYA,41,632,713,1345
KISII,KENYENYA,42,496,487,983
KISII,KENYENYA,43,525,587,1112
KISII,KENYENYA,44,412,498,910
KISII,KENYENYA,40-44,2728,2914,5642
KISII,KENYENYA,45,686,754,1440
KISII,KENYENYA,46,487,501,988
KISII,KENYENYA,47,507,555,1062
KISII,KENYENYA,48,255,258,513
KISII,KENYENYA,49,274,419,693
KISII,KENYENYA,45-49,2209,2487,4696
KISII,KENYENYA,50,423,461,884
KISII,KENYENYA,51,393,389,782
KISII,KENYENYA,52,276,221,497
KISII,KENYENYA,53,240,197,437
KISII,KENYENYA,54,272,219,491
KISII,KENYENYA,50-54,1604,1487,3091
KISII,KENYENYA,55,340,280,620
KISII,KENYENYA,56,384,441,825
KISII,KENYENYA,57,422,585,1007
KISII,KENYENYA,58,280,327,607
KISII,KENYENYA,59,424,521,945
KISII,KENYENYA,55-59,1850,2154,4004
KISII,KENYENYA,60,421,494,915
KISII,KENYENYA,61,369,383,752
KISII,KENYENYA,62,281,297,578
KISII,KENYENYA,63,266,279,545
KISII,KENYENYA,64,172,180,352
KISII,KENYENYA,60-64,1509,1633,3142
KISII,KENYENYA,65,284,396,680
KISII,KENYENYA,66,162,189,351
KISII,KENYENYA,67,245,292,537
KISII,KENYENYA,68,104,154,258
KISII,KENYENYA,69,221,251,472
KISII,KENYENYA,65-69,1016,1282,2298
KISII,KENYENYA,70,174,346,520
KISII,KENYENYA,71,189,184,373
KISII,KENYENYA,72,149,141,290
KISII,KENYENYA,73,108,108,216
KISII,KENYENYA,74,126,158,284
KISII,KENYENYA,70-74,746,937,1683
KISII,KENYENYA,75,86,139,225
KISII,KENYENYA,76,65,71,136
KISII,KENYENYA,77,101,98,199
KISII,KENYENYA,78,52,56,108
KISII,KENYENYA,79,69,146,215
KISII,KENYENYA,75-79,373,510,883
KISII,KENYENYA,80,72,179,251
KISII,KENYENYA,81,54,82,136
KISII,KENYENYA,82,37,48,85
KISII,KENYENYA,83,64,63,127
KISII,KENYENYA,84,46,76,122
KISII,KENYENYA,80-84,273,448,721
KISII,KENYENYA,85,47,79,126
KISII,KENYENYA,86,41,32,73
KISII,KENYENYA,87,43,63,106
KISII,KENYENYA,88,30,29,59
KISII,KENYENYA,89,40,79,119
KISII,KENYENYA,85-89,201,282,483
KISII,KENYENYA,90,26,45,71
KISII,KENYENYA,91,8,24,32
KISII,KENYENYA,92,11,13,24
KISII,KENYENYA,93,6,17,23
KISII,KENYENYA,94,13,18,31
KISII,KENYENYA,90-94,64,117,181
KISII,KENYENYA,95,14,15,29
KISII,KENYENYA,96,8,8,16
KISII,KENYENYA,97,13,10,23
KISII,KENYENYA,98,7,10,17
KISII,KENYENYA,99,6,13,19
KISII,KENYENYA,95-99,48,56,104
KISII,KENYENYA,100+,15,37,52
KISII,KENYENYA,Not Stated,-,1,1
KISII,KISII CENTRAL,Total,81330,85573,166903
KISII,KISII CENTRAL,0,1816,1889,3705
KISII,KISII CENTRAL,1,1770,1775,3545
KISII,KISII CENTRAL,2,1774,1764,3538
KISII,KISII CENTRAL,3,1864,1962,3826
KISII,KISII CENTRAL,4,1989,1922,3911
KISII,KISII CENTRAL,0 - 4,9213,9312,18525
KISII,KISII CENTRAL,5,1846,1865,3711
KISII,KISII CENTRAL,6,2004,1969,3973
KISII,KISII CENTRAL,7,2042,1998,4040
KISII,KISII CENTRAL,8,1916,1921,3837
KISII,KISII CENTRAL,9,2106,2103,4209
KISII,KISII CENTRAL,05-Sep,9914,9856,19770
KISII,KISII CENTRAL,10,2320,2221,4541
KISII,KISII CENTRAL,11,1948,2094,4042
KISII,KISII CENTRAL,12,2417,2250,4667
KISII,KISII CENTRAL,13,2327,2387,4714
KISII,KISII CENTRAL,14,2147,2198,4345
KISII,KISII CENTRAL,Oct-14,11159,11150,22309
KISII,KISII CENTRAL,15,2007,2089,4096
KISII,KISII CENTRAL,16,1868,1966,3834
KISII,KISII CENTRAL,17,2014,2012,4026
KISII,KISII CENTRAL,18,1626,1646,3272
KISII,KISII CENTRAL,19,1791,1870,3661
KISII,KISII CENTRAL,15-19,9306,9583,18889
KISII,KISII CENTRAL,20,1595,1783,3378
KISII,KISII CENTRAL,21,1521,1715,3236
KISII,KISII CENTRAL,22,1485,1715,3200
KISII,KISII CENTRAL,23,1617,1919,3536
KISII,KISII CENTRAL,24,1508,1788,3296
KISII,KISII CENTRAL,20-24,7726,8920,16646
KISII,KISII CENTRAL,25,1701,2034,3735
KISII,KISII CENTRAL,26,1378,1697,3075
KISII,KISII CENTRAL,27,1389,1644,3033
KISII,KISII CENTRAL,28,1119,1298,2417
KISII,KISII CENTRAL,29,1208,1431,2639
KISII,KISII CENTRAL,25-29,6795,8104,14899
KISII,KISII CENTRAL,30,1565,1903,3468
KISII,KISII CENTRAL,31,1119,1380,2499
KISII,KISII CENTRAL,32,1375,1675,3050
KISII,KISII CENTRAL,33,1033,1338,2371
KISII,KISII CENTRAL,34,978,1136,2114
KISII,KISII CENTRAL,30-34,6070,7432,13502
KISII,KISII CENTRAL,35,1330,1299,2629
KISII,KISII CENTRAL,36,918,792,1710
KISII,KISII CENTRAL,37,962,816,1778
KISII,KISII CENTRAL,38,702,657,1359
KISII,KISII CENTRAL,39,846,743,1589
KISII,KISII CENTRAL,35-39,4758,4307,9065
KISII,KISII CENTRAL,40,982,936,1918
KISII,KISII CENTRAL,41,985,857,1842
KISII,KISII CENTRAL,42,769,676,1445
KISII,KISII CENTRAL,43,691,620,1311
KISII,KISII CENTRAL,44,486,505,991
KISII,KISII CENTRAL,40-44,3913,3594,7507
KISII,KISII CENTRAL,45,987,915,1902
KISII,KISII CENTRAL,46,575,708,1283
KISII,KISII CENTRAL,47,640,768,1408
KISII,KISII CENTRAL,48,432,418,850
KISII,KISII CENTRAL,49,492,534,1026
KISII,KISII CENTRAL,45-49,3126,3343,6469
KISII,KISII CENTRAL,50,597,622,1219
KISII,KISII CENTRAL,51,452,417,869
KISII,KISII CENTRAL,52,369,307,676
KISII,KISII CENTRAL,53,269,231,500
KISII,KISII CENTRAL,54,369,314,683
KISII,KISII CENTRAL,50-54,2056,1891,3947
KISII,KISII CENTRAL,55,446,389,835
KISII,KISII CENTRAL,56,474,495,969
KISII,KISII CENTRAL,57,581,715,1296
KISII,KISII CENTRAL,58,395,436,831
KISII,KISII CENTRAL,59,517,590,1107
KISII,KISII CENTRAL,55-59,2413,2625,5038
KISII,KISII CENTRAL,60,489,609,1098
KISII,KISII CENTRAL,61,451,423,874
KISII,KISII CENTRAL,62,304,311,615
KISII,KISII CENTRAL,63,328,304,632
KISII,KISII CENTRAL,64,216,245,461
KISII,KISII CENTRAL,60-64,1788,1892,3680
KISII,KISII CENTRAL,65,329,387,716
KISII,KISII CENTRAL,66,193,191,384
KISII,KISII CENTRAL,67,331,328,659
KISII,KISII CENTRAL,68,146,140,286
KISII,KISII CENTRAL,69,243,247,490
KISII,KISII CENTRAL,65-69,1242,1293,2535
KISII,KISII CENTRAL,70,284,369,653
KISII,KISII CENTRAL,71,210,177,387
KISII,KISII CENTRAL,72,159,126,285
KISII,KISII CENTRAL,73,141,114,255
KISII,KISII CENTRAL,74,102,132,234
KISII,KISII CENTRAL,70-74,896,918,1814
KISII,KISII CENTRAL,75,99,129,228
KISII,KISII CENTRAL,76,75,75,150
KISII,KISII CENTRAL,77,111,112,223
KISII,KISII CENTRAL,78,52,55,107
KISII,KISII CENTRAL,79,81,133,214
KISII,KISII CENTRAL,75-79,418,504,922
KISII,KISII CENTRAL,80,90,165,255
KISII,KISII CENTRAL,81,54,84,138
KISII,KISII CENTRAL,82,46,46,92
KISII,KISII CENTRAL,83,52,54,106
KISII,KISII CENTRAL,84,47,63,110
KISII,KISII CENTRAL,80-84,289,412,701
KISII,KISII CENTRAL,85,38,61,99
KISII,KISII CENTRAL,86,25,29,54
KISII,KISII CENTRAL,87,34,43,77
KISII,KISII CENTRAL,88,22,30,52
KISII,KISII CENTRAL,89,29,87,116
KISII,KISII CENTRAL,85-89,148,250,398
KISII,KISII CENTRAL,90,15,34,49
KISII,KISII CENTRAL,91,14,20,34
KISII,KISII CENTRAL,92,17,19,36
KISII,KISII CENTRAL,93,9,13,22
KISII,KISII CENTRAL,94,10,22,32
KISII,KISII CENTRAL,90-94,65,108,173
KISII,KISII CENTRAL,95,11,15,26
KISII,KISII CENTRAL,96,5,9,14
KISII,KISII CENTRAL,97,4,8,12
KISII,KISII CENTRAL,98,3,3,6
KISII,KISII CENTRAL,99,5,13,18
KISII,KISII CENTRAL,95-99,28,48,76
KISII,KISII CENTRAL,100+,7,30,37
KISII,KISII CENTRAL,Not Stated,-,1,1
KISII,KISII SOUTH,Total,64514,70615,135129
KISII,KISII SOUTH,0,1404,1461,2865
KISII,KISII SOUTH,1,1470,1499,2969
KISII,KISII SOUTH,2,1560,1519,3079
KISII,KISII SOUTH,3,1674,1596,3270
KISII,KISII SOUTH,4,1591,1707,3298
KISII,KISII SOUTH,0 - 4,7699,7782,15481
KISII,KISII SOUTH,5,1622,1734,3356
KISII,KISII SOUTH,6,1813,1812,3625
KISII,KISII SOUTH,7,1884,1866,3750
KISII,KISII SOUTH,8,1838,1881,3719
KISII,KISII SOUTH,9,2060,2120,4180
KISII,KISII SOUTH,05-Sep,9217,9413,18630
KISII,KISII SOUTH,10,2230,2182,4412
KISII,KISII SOUTH,11,1848,2022,3870
KISII,KISII SOUTH,12,2276,2130,4406
KISII,KISII SOUTH,13,2119,2186,4305
KISII,KISII SOUTH,14,1962,1927,3889
KISII,KISII SOUTH,Oct-14,10435,10447,20882
KISII,KISII SOUTH,15,1932,1911,3843
KISII,KISII SOUTH,16,1760,1820,3580
KISII,KISII SOUTH,17,1712,1719,3431
KISII,KISII SOUTH,18,1443,1512,2955
KISII,KISII SOUTH,19,1522,1548,3070
KISII,KISII SOUTH,15-19,8369,8510,16879
KISII,KISII SOUTH,20,1267,1565,2832
KISII,KISII SOUTH,21,1027,1278,2305
KISII,KISII SOUTH,22,946,1180,2126
KISII,KISII SOUTH,23,997,1276,2273
KISII,KISII SOUTH,24,944,1221,2165
KISII,KISII SOUTH,20-24,5181,6520,11701
KISII,KISII SOUTH,25,1075,1417,2492
KISII,KISII SOUTH,26,869,1064,1933
KISII,KISII SOUTH,27,869,1150,2019
KISII,KISII SOUTH,28,756,930,1686
KISII,KISII SOUTH,29,738,1042,1780
KISII,KISII SOUTH,25-29,4307,5603,9910
KISII,KISII SOUTH,30,935,1302,2237
KISII,KISII SOUTH,31,766,995,1761
KISII,KISII SOUTH,32,881,1172,2053
KISII,KISII SOUTH,33,787,1022,1809
KISII,KISII SOUTH,34,668,835,1503
KISII,KISII SOUTH,30-34,4037,5326,9363
KISII,KISII SOUTH,35,891,997,1888
KISII,KISII SOUTH,36,641,562,1203
KISII,KISII SOUTH,37,680,583,1263
KISII,KISII SOUTH,38,462,400,862
KISII,KISII SOUTH,39,550,550,1100
KISII,KISII SOUTH,35-39,3224,3092,6316
KISII,KISII SOUTH,40,635,663,1298
KISII,KISII SOUTH,41,699,651,1350
KISII,KISII SOUTH,42,582,578,1160
KISII,KISII SOUTH,43,547,601,1148
KISII,KISII SOUTH,44,364,466,830
KISII,KISII SOUTH,40-44,2827,2959,5786
KISII,KISII SOUTH,45,695,705,1400
KISII,KISII SOUTH,46,425,532,957
KISII,KISII SOUTH,47,514,632,1146
KISII,KISII SOUTH,48,282,362,644
KISII,KISII SOUTH,49,331,415,746
KISII,KISII SOUTH,45-49,2247,2646,4893
KISII,KISII SOUTH,50,422,516,938
KISII,KISII SOUTH,51,324,362,686
KISII,KISII SOUTH,52,268,247,515
KISII,KISII SOUTH,53,180,196,376
KISII,KISII SOUTH,54,250,254,504
KISII,KISII SOUTH,50-54,1444,1575,3019
KISII,KISII SOUTH,55,377,347,724
KISII,KISII SOUTH,56,461,379,840
KISII,KISII SOUTH,57,363,476,839
KISII,KISII SOUTH,58,237,346,583
KISII,KISII SOUTH,59,342,434,776
KISII,KISII SOUTH,55-59,1780,1982,3762
KISII,KISII SOUTH,60,352,554,906
KISII,KISII SOUTH,61,310,385,695
KISII,KISII SOUTH,62,260,263,523
KISII,KISII SOUTH,63,237,277,514
KISII,KISII SOUTH,64,215,204,419
KISII,KISII SOUTH,60-64,1374,1683,3057
KISII,KISII SOUTH,65,267,371,638
KISII,KISII SOUTH,66,153,140,293
KISII,KISII SOUTH,67,267,255,522
KISII,KISII SOUTH,68,110,158,268
KISII,KISII SOUTH,69,193,270,463
KISII,KISII SOUTH,65-69,990,1194,2184
KISII,KISII SOUTH,70,219,374,593
KISII,KISII SOUTH,71,159,163,322
KISII,KISII SOUTH,72,131,100,231
KISII,KISII SOUTH,73,85,84,169
KISII,KISII SOUTH,74,83,116,199
KISII,KISII SOUTH,70-74,677,837,1514
KISII,KISII SOUTH,75,79,105,184
KISII,KISII SOUTH,76,58,60,118
KISII,KISII SOUTH,77,71,65,136
KISII,KISII SOUTH,78,52,30,82
KISII,KISII SOUTH,79,59,102,161
KISII,KISII SOUTH,75-79,319,362,681
KISII,KISII SOUTH,80,67,113,180
KISII,KISII SOUTH,81,40,54,94
KISII,KISII SOUTH,82,39,33,72
KISII,KISII SOUTH,83,32,28,60
KISII,KISII SOUTH,84,41,60,101
KISII,KISII SOUTH,80-84,219,288,507
KISII,KISII SOUTH,85,18,49,67
KISII,KISII SOUTH,86,16,27,43
KISII,KISII SOUTH,87,28,38,66
KISII,KISII SOUTH,88,13,20,33
KISII,KISII SOUTH,89,26,70,96
KISII,KISII SOUTH,85-89,101,204,305
KISII,KISII SOUTH,90,13,42,55
KISII,KISII SOUTH,91,7,15,22
KISII,KISII SOUTH,92,10,14,24
KISII,KISII SOUTH,93,3,11,14
KISII,KISII SOUTH,94,6,17,23
KISII,KISII SOUTH,90-94,39,99,138
KISII,KISII SOUTH,95,4,15,19
KISII,KISII SOUTH,96,6,7,13
KISII,KISII SOUTH,97,3,9,12
KISII,KISII SOUTH,98,3,5,8
KISII,KISII SOUTH,99,2,16,18
KISII,KISII SOUTH,95-99,18,52,70
KISII,KISII SOUTH,100+,10,41,51
KISII,KISII SOUTH,Not Stated,-,-,-
KISII,KITUTU CENTRAL,Total,74608,79561,154169
KISII,KITUTU CENTRAL,0,1811,1797,3608
KISII,KITUTU CENTRAL,1,1787,1702,3489
KISII,KITUTU CENTRAL,2,1767,1709,3476
KISII,KITUTU CENTRAL,3,1836,1898,3734
KISII,KITUTU CENTRAL,4,1890,1746,3636
KISII,KITUTU CENTRAL,0 - 4,9091,8852,17943
KISII,KITUTU CENTRAL,5,1747,1815,3562
KISII,KITUTU CENTRAL,6,1955,1924,3879
KISII,KITUTU CENTRAL,7,1931,2043,3974
KISII,KITUTU CENTRAL,8,1828,1829,3657
KISII,KITUTU CENTRAL,9,2121,2069,4190
KISII,KITUTU CENTRAL,05-Sep,9582,9680,19262
KISII,KITUTU CENTRAL,10,2109,2194,4303
KISII,KITUTU CENTRAL,11,1859,1906,3765
KISII,KITUTU CENTRAL,12,2332,2294,4626
KISII,KITUTU CENTRAL,13,2121,2254,4375
KISII,KITUTU CENTRAL,14,1926,2023,3949
KISII,KITUTU CENTRAL,Oct-14,10347,10671,21018
KISII,KITUTU CENTRAL,15,1844,1899,3743
KISII,KITUTU CENTRAL,16,1775,1781,3556
KISII,KITUTU CENTRAL,17,1732,1832,3564
KISII,KITUTU CENTRAL,18,1490,1499,2989
KISII,KITUTU CENTRAL,19,1585,1779,3364
KISII,KITUTU CENTRAL,15-19,8426,8790,17216
KISII,KITUTU CENTRAL,20,1401,1783,3184
KISII,KITUTU CENTRAL,21,1274,1588,2862
KISII,KITUTU CENTRAL,22,1291,1663,2954
KISII,KITUTU CENTRAL,23,1415,1880,3295
KISII,KITUTU CENTRAL,24,1390,1724,3114
KISII,KITUTU CENTRAL,20-24,6771,8638,15409
KISII,KITUTU CENTRAL,25,1573,1831,3404
KISII,KITUTU CENTRAL,26,1322,1701,3023
KISII,KITUTU CENTRAL,27,1281,1564,2845
KISII,KITUTU CENTRAL,28,1088,1279,2367
KISII,KITUTU CENTRAL,29,1209,1356,2565
KISII,KITUTU CENTRAL,25-29,6473,7731,14204
KISII,KITUTU CENTRAL,30,1563,1886,3449
KISII,KITUTU CENTRAL,31,1065,1169,2234
KISII,KITUTU CENTRAL,32,1368,1476,2844
KISII,KITUTU CENTRAL,33,1011,1288,2299
KISII,KITUTU CENTRAL,34,977,1100,2077
KISII,KITUTU CENTRAL,30-34,5984,6919,12903
KISII,KITUTU CENTRAL,35,1244,1258,2502
KISII,KITUTU CENTRAL,36,868,800,1668
KISII,KITUTU CENTRAL,37,822,746,1568
KISII,KITUTU CENTRAL,38,620,608,1228
KISII,KITUTU CENTRAL,39,748,758,1506
KISII,KITUTU CENTRAL,35-39,4302,4170,8472
KISII,KITUTU CENTRAL,40,947,808,1755
KISII,KITUTU CENTRAL,41,886,710,1596
KISII,KITUTU CENTRAL,42,673,586,1259
KISII,KITUTU CENTRAL,43,657,579,1236
KISII,KITUTU CENTRAL,44,451,502,953
KISII,KITUTU CENTRAL,40-44,3614,3185,6799
KISII,KITUTU CENTRAL,45,750,830,1580
KISII,KITUTU CENTRAL,46,511,541,1052
KISII,KITUTU CENTRAL,47,559,573,1132
KISII,KITUTU CENTRAL,48,342,354,696
KISII,KITUTU CENTRAL,49,444,440,884
KISII,KITUTU CENTRAL,45-49,2606,2738,5344
KISII,KITUTU CENTRAL,50,523,567,1090
KISII,KITUTU CENTRAL,51,362,386,748
KISII,KITUTU CENTRAL,52,345,300,645
KISII,KITUTU CENTRAL,53,261,214,475
KISII,KITUTU CENTRAL,54,321,280,601
KISII,KITUTU CENTRAL,50-54,1812,1747,3559
KISII,KITUTU CENTRAL,55,407,363,770
KISII,KITUTU CENTRAL,56,439,385,824
KISII,KITUTU CENTRAL,57,428,504,932
KISII,KITUTU CENTRAL,58,325,368,693
KISII,KITUTU CENTRAL,59,381,438,819
KISII,KITUTU CENTRAL,55-59,1980,2058,4038
KISII,KITUTU CENTRAL,60,396,483,879
KISII,KITUTU CENTRAL,61,309,343,652
KISII,KITUTU CENTRAL,62,216,247,463
KISII,KITUTU CENTRAL,63,273,291,564
KISII,KITUTU CENTRAL,64,193,216,409
KISII,KITUTU CENTRAL,60-64,1387,1580,2967
KISII,KITUTU CENTRAL,65,247,319,566
KISII,KITUTU CENTRAL,66,163,168,331
KISII,KITUTU CENTRAL,67,267,242,509
KISII,KITUTU CENTRAL,68,96,113,209
KISII,KITUTU CENTRAL,69,166,221,387
KISII,KITUTU CENTRAL,65-69,939,1063,2002
KISII,KITUTU CENTRAL,70,206,302,508
KISII,KITUTU CENTRAL,71,158,133,291
KISII,KITUTU CENTRAL,72,115,112,227
KISII,KITUTU CENTRAL,73,84,76,160
KISII,KITUTU CENTRAL,74,91,116,207
KISII,KITUTU CENTRAL,70-74,654,739,1393
KISII,KITUTU CENTRAL,75,79,110,189
KISII,KITUTU CENTRAL,76,41,43,84
KISII,KITUTU CENTRAL,77,75,81,156
KISII,KITUTU CENTRAL,78,37,23,60
KISII,KITUTU CENTRAL,79,47,113,160
KISII,KITUTU CENTRAL,75-79,279,370,649
KISII,KITUTU CENTRAL,80,65,117,182
KISII,KITUTU CENTRAL,81,34,55,89
KISII,KITUTU CENTRAL,82,39,41,80
KISII,KITUTU CENTRAL,83,33,45,78
KISII,KITUTU CENTRAL,84,37,39,76
KISII,KITUTU CENTRAL,80-84,208,297,505
KISII,KITUTU CENTRAL,85,19,38,57
KISII,KITUTU CENTRAL,86,20,19,39
KISII,KITUTU CENTRAL,87,20,34,54
KISII,KITUTU CENTRAL,88,11,22,33
KISII,KITUTU CENTRAL,89,24,63,87
KISII,KITUTU CENTRAL,85-89,94,176,270
KISII,KITUTU CENTRAL,90,15,38,53
KISII,KITUTU CENTRAL,91,7,13,20
KISII,KITUTU CENTRAL,92,4,11,15
KISII,KITUTU CENTRAL,93,3,6,9
KISII,KITUTU CENTRAL,94,3,8,11
KISII,KITUTU CENTRAL,90-94,32,76,108
KISII,KITUTU CENTRAL,95,6,24,30
KISII,KITUTU CENTRAL,96,-,4,4
KISII,KITUTU CENTRAL,97,3,8,11
KISII,KITUTU CENTRAL,98,3,4,7
KISII,KITUTU CENTRAL,99,5,7,12
KISII,KITUTU CENTRAL,95-99,17,47,64
KISII,KITUTU CENTRAL,100+,7,33,40
KISII,KITUTU CENTRAL,Not Stated,3,1,4
KISII,MARANI,Total,50598,56864,107462
KISII,MARANI,0,1107,1105,2212
KISII,MARANI,1,1116,1135,2251
KISII,MARANI,2,1137,1218,2355
KISII,MARANI,3,1317,1285,2602
KISII,MARANI,4,1321,1346,2667
KISII,MARANI,0 - 4,5998,6089,12087
KISII,MARANI,5,1389,1349,2738
KISII,MARANI,6,1462,1473,2935
KISII,MARANI,7,1450,1458,2908
KISII,MARANI,8,1489,1454,2943
KISII,MARANI,9,1586,1564,3150
KISII,MARANI,05-Sep,7376,7298,14674
KISII,MARANI,10,1806,1746,3552
KISII,MARANI,11,1485,1564,3049
KISII,MARANI,12,2002,1780,3782
KISII,MARANI,13,1752,1765,3517
KISII,MARANI,14,1715,1537,3252
KISII,MARANI,Oct-14,8760,8392,17152
KISII,MARANI,15,1571,1505,3076
KISII,MARANI,16,1365,1311,2676
KISII,MARANI,17,1440,1374,2814
KISII,MARANI,18,1107,1048,2155
KISII,MARANI,19,978,1075,2053
KISII,MARANI,15-19,6461,6313,12774
KISII,MARANI,20,827,931,1758
KISII,MARANI,21,632,831,1463
KISII,MARANI,22,613,808,1421
KISII,MARANI,23,566,832,1398
KISII,MARANI,24,558,725,1283
KISII,MARANI,20-24,3196,4127,7323
KISII,MARANI,25,656,912,1568
KISII,MARANI,26,518,775,1293
KISII,MARANI,27,520,845,1365
KISII,MARANI,28,441,716,1157
KISII,MARANI,29,455,699,1154
KISII,MARANI,25-29,2590,3947,6537
KISII,MARANI,30,641,1117,1758
KISII,MARANI,31,489,754,1243
KISII,MARANI,32,571,1014,1585
KISII,MARANI,33,514,915,1429
KISII,MARANI,34,437,783,1220
KISII,MARANI,30-34,2652,4583,7235
KISII,MARANI,35,625,818,1443
KISII,MARANI,36,453,469,922
KISII,MARANI,37,451,497,948
KISII,MARANI,38,369,429,798
KISII,MARANI,39,385,506,891
KISII,MARANI,35-39,2283,2719,5002
KISII,MARANI,40,532,583,1115
KISII,MARANI,41,541,525,1066
KISII,MARANI,42,416,443,859
KISII,MARANI,43,383,391,774
KISII,MARANI,44,285,328,613
KISII,MARANI,40-44,2157,2270,4427
KISII,MARANI,45,496,668,1164
KISII,MARANI,46,361,487,848
KISII,MARANI,47,400,539,939
KISII,MARANI,48,251,326,577
KISII,MARANI,49,268,385,653
KISII,MARANI,45-49,1776,2405,4181
KISII,MARANI,50,382,441,823
KISII,MARANI,51,311,294,605
KISII,MARANI,52,201,210,411
KISII,MARANI,53,181,171,352
KISII,MARANI,54,249,211,460
KISII,MARANI,50-54,1324,1327,2651
KISII,MARANI,55,287,277,564
KISII,MARANI,56,310,391,701
KISII,MARANI,57,414,609,1023
KISII,MARANI,58,291,343,634
KISII,MARANI,59,426,514,940
KISII,MARANI,55-59,1728,2134,3862
KISII,MARANI,60,434,608,1042
KISII,MARANI,61,313,381,694
KISII,MARANI,62,228,274,502
KISII,MARANI,63,259,301,560
KISII,MARANI,64,194,232,426
KISII,MARANI,60-64,1428,1796,3224
KISII,MARANI,65,292,357,649
KISII,MARANI,66,199,166,365
KISII,MARANI,67,286,286,572
KISII,MARANI,68,121,150,271
KISII,MARANI,69,236,295,531
KISII,MARANI,65-69,1134,1254,2388
KISII,MARANI,70,248,396,644
KISII,MARANI,71,177,172,349
KISII,MARANI,72,140,109,249
KISII,MARANI,73,106,110,216
KISII,MARANI,74,119,144,263
KISII,MARANI,70-74,790,931,1721
KISII,MARANI,75,112,128,240
KISII,MARANI,76,64,56,120
KISII,MARANI,77,92,117,209
KISII,MARANI,78,59,69,128
KISII,MARANI,79,68,156,224
KISII,MARANI,75-79,395,526,921
KISII,MARANI,80,87,143,230
KISII,MARANI,81,68,81,149
KISII,MARANI,82,43,37,80
KISII,MARANI,83,44,49,93
KISII,MARANI,84,63,76,139
KISII,MARANI,80-84,305,386,691
KISII,MARANI,85,37,51,88
KISII,MARANI,86,19,21,40
KISII,MARANI,87,38,27,65
KISII,MARANI,88,14,21,35
KISII,MARANI,89,39,84,123
KISII,MARANI,85-89,147,204,351
KISII,MARANI,90,17,46,63
KISII,MARANI,91,15,18,33
KISII,MARANI,92,6,9,15
KISII,MARANI,93,7,5,12
KISII,MARANI,94,10,19,29
KISII,MARANI,90-94,55,97,152
KISII,MARANI,95,9,13,22
KISII,MARANI,96,1,9,10
KISII,MARANI,97,9,7,16
KISII,MARANI,98,1,6,7
KISII,MARANI,99,9,9,18
KISII,MARANI,95-99,29,44,73
KISII,MARANI,100+,6,21,27
KISII,MARANI,Not Stated,8,1,9
KISII,MASABA SOUTH,Total,58143,64248,122391
KISII,MASABA SOUTH,0,1319,1225,2544
KISII,MASABA SOUTH,1,1251,1146,2397
KISII,MASABA SOUTH,2,1288,1310,2598
KISII,MASABA SOUTH,3,1391,1363,2754
KISII,MASABA SOUTH,4,1578,1508,3086
KISII,MASABA SOUTH,0 - 4,6827,6552,13379
KISII,MASABA SOUTH,5,1564,1567,3131
KISII,MASABA SOUTH,6,1535,1609,3144
KISII,MASABA SOUTH,7,1789,1714,3503
KISII,MASABA SOUTH,8,1567,1569,3136
KISII,MASABA SOUTH,9,1879,1876,3755
KISII,MASABA SOUTH,05-Sep,8334,8335,16669
KISII,MASABA SOUTH,10,2076,1945,4021
KISII,MASABA SOUTH,11,1760,1694,3454
KISII,MASABA SOUTH,12,2121,1927,4048
KISII,MASABA SOUTH,13,1998,1923,3921
KISII,MASABA SOUTH,14,1761,1749,3510
KISII,MASABA SOUTH,Oct-14,9716,9238,18954
KISII,MASABA SOUTH,15,1752,1741,3493
KISII,MASABA SOUTH,16,1486,1518,3004
KISII,MASABA SOUTH,17,1541,1556,3097
KISII,MASABA SOUTH,18,1253,1239,2492
KISII,MASABA SOUTH,19,1268,1290,2558
KISII,MASABA SOUTH,15-19,7300,7344,14644
KISII,MASABA SOUTH,20,1033,1082,2115
KISII,MASABA SOUTH,21,819,946,1765
KISII,MASABA SOUTH,22,777,947,1724
KISII,MASABA SOUTH,23,718,968,1686
KISII,MASABA SOUTH,24,721,870,1591
KISII,MASABA SOUTH,20-24,4068,4813,8881
KISII,MASABA SOUTH,25,827,1187,2014
KISII,MASABA SOUTH,26,634,908,1542
KISII,MASABA SOUTH,27,650,894,1544
KISII,MASABA SOUTH,28,512,720,1232
KISII,MASABA SOUTH,29,535,789,1324
KISII,MASABA SOUTH,25-29,3158,4498,7656
KISII,MASABA SOUTH,30,825,1182,2007
KISII,MASABA SOUTH,31,637,992,1629
KISII,MASABA SOUTH,32,762,1174,1936
KISII,MASABA SOUTH,33,644,1063,1707
KISII,MASABA SOUTH,34,589,864,1453
KISII,MASABA SOUTH,30-34,3457,5275,8732
KISII,MASABA SOUTH,35,777,949,1726
KISII,MASABA SOUTH,36,468,507,975
KISII,MASABA SOUTH,37,534,565,1099
KISII,MASABA SOUTH,38,347,384,731
KISII,MASABA SOUTH,39,500,531,1031
KISII,MASABA SOUTH,35-39,2626,2936,5562
KISII,MASABA SOUTH,40,638,714,1352
KISII,MASABA SOUTH,41,733,714,1447
KISII,MASABA SOUTH,42,459,557,1016
KISII,MASABA SOUTH,43,467,523,990
KISII,MASABA SOUTH,44,294,376,670
KISII,MASABA SOUTH,40-44,2591,2884,5475
KISII,MASABA SOUTH,45,648,837,1485
KISII,MASABA SOUTH,46,428,669,1097
KISII,MASABA SOUTH,47,448,678,1126
KISII,MASABA SOUTH,48,273,333,606
KISII,MASABA SOUTH,49,323,384,707
KISII,MASABA SOUTH,45-49,2120,2901,5021
KISII,MASABA SOUTH,50,455,474,929
KISII,MASABA SOUTH,51,384,391,775
KISII,MASABA SOUTH,52,242,235,477
KISII,MASABA SOUTH,53,191,190,381
KISII,MASABA SOUTH,54,260,212,472
KISII,MASABA SOUTH,50-54,1532,1502,3034
KISII,MASABA SOUTH,55,314,265,579
KISII,MASABA SOUTH,56,421,487,908
KISII,MASABA SOUTH,57,523,701,1224
KISII,MASABA SOUTH,58,307,357,664
KISII,MASABA SOUTH,59,458,570,1028
KISII,MASABA SOUTH,55-59,2023,2380,4403
KISII,MASABA SOUTH,60,449,551,1000
KISII,MASABA SOUTH,61,406,430,836
KISII,MASABA SOUTH,62,260,277,537
KISII,MASABA SOUTH,63,281,343,624
KISII,MASABA SOUTH,64,175,213,388
KISII,MASABA SOUTH,60-64,1571,1814,3385
KISII,MASABA SOUTH,65,288,399,687
KISII,MASABA SOUTH,66,159,184,343
KISII,MASABA SOUTH,67,260,316,576
KISII,MASABA SOUTH,68,105,140,245
KISII,MASABA SOUTH,69,216,306,522
KISII,MASABA SOUTH,65-69,1028,1345,2373
KISII,MASABA SOUTH,70,229,374,603
KISII,MASABA SOUTH,71,188,219,407
KISII,MASABA SOUTH,72,148,133,281
KISII,MASABA SOUTH,73,120,103,223
KISII,MASABA SOUTH,74,117,162,279
KISII,MASABA SOUTH,70-74,802,991,1793
KISII,MASABA SOUTH,75,104,135,239
KISII,MASABA SOUTH,76,66,82,148
KISII,MASABA SOUTH,77,86,107,193
KISII,MASABA SOUTH,78,42,49,91
KISII,MASABA SOUTH,79,85,181,266
KISII,MASABA SOUTH,75-79,383,554,937
KISII,MASABA SOUTH,80,96,159,255
KISII,MASABA SOUTH,81,63,90,153
KISII,MASABA SOUTH,82,49,53,102
KISII,MASABA SOUTH,83,56,55,111
KISII,MASABA SOUTH,84,46,71,117
KISII,MASABA SOUTH,80-84,310,428,738
KISII,MASABA SOUTH,85,42,60,102
KISII,MASABA SOUTH,86,36,31,67
KISII,MASABA SOUTH,87,49,57,106
KISII,MASABA SOUTH,88,29,33,62
KISII,MASABA SOUTH,89,42,101,143
KISII,MASABA SOUTH,85-89,198,282,480
KISII,MASABA SOUTH,90,21,45,66
KISII,MASABA SOUTH,91,8,17,25
KISII,MASABA SOUTH,92,22,10,32
KISII,MASABA SOUTH,93,5,11,16
KISII,MASABA SOUTH,94,13,14,27
KISII,MASABA SOUTH,90-94,69,97,166
KISII,MASABA SOUTH,95,7,13,20
KISII,MASABA SOUTH,96,1,12,13
KISII,MASABA SOUTH,97,8,7,15
KISII,MASABA SOUTH,98,3,9,12
KISII,MASABA SOUTH,99,4,11,15
KISII,MASABA SOUTH,95-99,23,52,75
KISII,MASABA SOUTH,100+,7,27,34
KISII,MASABA SOUTH,Not Stated,-,-,-
KISII,NYAMACHE,Total,62113,68782,130895
KISII,NYAMACHE,0,1345,1378,2723
KISII,NYAMACHE,1,1327,1366,2693
KISII,NYAMACHE,2,1429,1366,2795
KISII,NYAMACHE,3,1474,1629,3103
KISII,NYAMACHE,4,1618,1629,3247
KISII,NYAMACHE,0 - 4,7193,7368,14561
KISII,NYAMACHE,5,1784,1618,3402
KISII,NYAMACHE,6,1859,1803,3662
KISII,NYAMACHE,7,1948,1823,3771
KISII,NYAMACHE,8,1803,1896,3699
KISII,NYAMACHE,9,2114,1949,4063
KISII,NYAMACHE,05-Sep,9508,9089,18597
KISII,NYAMACHE,10,2207,2245,4452
KISII,NYAMACHE,11,1946,2039,3985
KISII,NYAMACHE,12,2298,2244,4542
KISII,NYAMACHE,13,2165,2086,4251
KISII,NYAMACHE,14,1971,1929,3900
KISII,NYAMACHE,Oct-14,10587,10543,21130
KISII,NYAMACHE,15,1857,1770,3627
KISII,NYAMACHE,16,1634,1640,3274
KISII,NYAMACHE,17,1670,1572,3242
KISII,NYAMACHE,18,1441,1311,2752
KISII,NYAMACHE,19,1354,1295,2649
KISII,NYAMACHE,15-19,7956,7588,15544
KISII,NYAMACHE,20,984,1156,2140
KISII,NYAMACHE,21,842,1023,1865
KISII,NYAMACHE,22,732,969,1701
KISII,NYAMACHE,23,763,1021,1784
KISII,NYAMACHE,24,599,948,1547
KISII,NYAMACHE,20-24,3920,5117,9037
KISII,NYAMACHE,25,829,1275,2104
KISII,NYAMACHE,26,655,913,1568
KISII,NYAMACHE,27,753,1012,1765
KISII,NYAMACHE,28,582,830,1412
KISII,NYAMACHE,29,567,909,1476
KISII,NYAMACHE,25-29,3386,4939,8325
KISII,NYAMACHE,30,921,1390,2311
KISII,NYAMACHE,31,692,1058,1750
KISII,NYAMACHE,32,822,1177,1999
KISII,NYAMACHE,33,665,1159,1824
KISII,NYAMACHE,34,629,931,1560
KISII,NYAMACHE,30-34,3729,5715,9444
KISII,NYAMACHE,35,833,1029,1862
KISII,NYAMACHE,36,517,522,1039
KISII,NYAMACHE,37,575,540,1115
KISII,NYAMACHE,38,439,450,889
KISII,NYAMACHE,39,532,514,1046
KISII,NYAMACHE,35-39,2896,3055,5951
KISII,NYAMACHE,40,620,643,1263
KISII,NYAMACHE,41,669,639,1308
KISII,NYAMACHE,42,503,456,959
KISII,NYAMACHE,43,497,563,1060
KISII,NYAMACHE,44,361,442,803
KISII,NYAMACHE,40-44,2650,2743,5393
KISII,NYAMACHE,45,668,916,1584
KISII,NYAMACHE,46,399,631,1030
KISII,NYAMACHE,47,448,673,1121
KISII,NYAMACHE,48,303,365,668
KISII,NYAMACHE,49,346,557,903
KISII,NYAMACHE,45-49,2164,3142,5306
KISII,NYAMACHE,50,467,552,1019
KISII,NYAMACHE,51,385,350,735
KISII,NYAMACHE,52,233,257,490
KISII,NYAMACHE,53,227,189,416
KISII,NYAMACHE,54,245,208,453
KISII,NYAMACHE,50-54,1557,1556,3113
KISII,NYAMACHE,55,326,325,651
KISII,NYAMACHE,56,387,380,767
KISII,NYAMACHE,57,421,567,988
KISII,NYAMACHE,58,315,338,653
KISII,NYAMACHE,59,423,527,950
KISII,NYAMACHE,55-59,1872,2137,4009
KISII,NYAMACHE,60,466,550,1016
KISII,NYAMACHE,61,411,475,886
KISII,NYAMACHE,62,285,314,599
KISII,NYAMACHE,63,319,347,666
KISII,NYAMACHE,64,224,256,480
KISII,NYAMACHE,60-64,1705,1942,3647
KISII,NYAMACHE,65,319,363,682
KISII,NYAMACHE,66,178,166,344
KISII,NYAMACHE,67,274,322,596
KISII,NYAMACHE,68,114,171,285
KISII,NYAMACHE,69,208,325,533
KISII,NYAMACHE,65-69,1093,1347,2440
KISII,NYAMACHE,70,216,394,610
KISII,NYAMACHE,71,219,209,428
KISII,NYAMACHE,72,137,143,280
KISII,NYAMACHE,73,131,117,248
KISII,NYAMACHE,74,136,179,315
KISII,NYAMACHE,70-74,839,1042,1881
KISII,NYAMACHE,75,103,141,244
KISII,NYAMACHE,76,69,78,147
KISII,NYAMACHE,77,118,102,220
KISII,NYAMACHE,78,74,74,148
KISII,NYAMACHE,79,82,140,222
KISII,NYAMACHE,75-79,446,535,981
KISII,NYAMACHE,80,101,167,268
KISII,NYAMACHE,81,55,112,167
KISII,NYAMACHE,82,46,60,106
KISII,NYAMACHE,83,49,53,102
KISII,NYAMACHE,84,42,94,136
KISII,NYAMACHE,80-84,293,486,779
KISII,NYAMACHE,85,47,62,109
KISII,NYAMACHE,86,32,40,72
KISII,NYAMACHE,87,37,41,78
KISII,NYAMACHE,88,25,18,43
KISII,NYAMACHE,89,53,79,132
KISII,NYAMACHE,85-89,194,240,434
KISII,NYAMACHE,90,23,46,69
KISII,NYAMACHE,91,18,23,41
KISII,NYAMACHE,92,15,15,30
KISII,NYAMACHE,93,8,14,22
KISII,NYAMACHE,94,13,15,28
KISII,NYAMACHE,90-94,77,113,190
KISII,NYAMACHE,95,13,13,26
KISII,NYAMACHE,96,7,6,13
KISII,NYAMACHE,97,7,11,18
KISII,NYAMACHE,98,3,10,13
KISII,NYAMACHE,99,4,14,18
KISII,NYAMACHE,95-99,34,54,88
KISII,NYAMACHE,100+,14,31,45
KISII,NYAMACHE,Not Stated,-,-,-
KISII,SAMETA,Total,31829,35164,66993
KISII,SAMETA,0,664,658,1322
KISII,SAMETA,1,669,689,1358
KISII,SAMETA,2,760,738,1498
KISII,SAMETA,3,784,800,1584
KISII,SAMETA,4,855,780,1635
KISII,SAMETA,0 - 4,3732,3665,7397
KISII,SAMETA,5,807,797,1604
KISII,SAMETA,6,884,943,1827
KISII,SAMETA,7,894,893,1787
KISII,SAMETA,8,869,918,1787
KISII,SAMETA,9,954,1031,1985
KISII,SAMETA,05-Sep,4408,4582,8990
KISII,SAMETA,10,1110,1095,2205
KISII,SAMETA,11,1002,1001,2003
KISII,SAMETA,12,1153,1156,2309
KISII,SAMETA,13,1084,1130,2214
KISII,SAMETA,14,1015,1028,2043
KISII,SAMETA,Oct-14,5364,5410,10774
KISII,SAMETA,15,918,979,1897
KISII,SAMETA,16,883,862,1745
KISII,SAMETA,17,893,881,1774
KISII,SAMETA,18,729,709,1438
KISII,SAMETA,19,683,707,1390
KISII,SAMETA,15-19,4106,4138,8244
KISII,SAMETA,20,599,655,1254
KISII,SAMETA,21,437,574,1011
KISII,SAMETA,22,459,547,1006
KISII,SAMETA,23,412,557,969
KISII,SAMETA,24,345,516,861
KISII,SAMETA,20-24,2252,2849,5101
KISII,SAMETA,25,496,670,1166
KISII,SAMETA,26,359,538,897
KISII,SAMETA,27,436,532,968
KISII,SAMETA,28,322,464,786
KISII,SAMETA,29,351,483,834
KISII,SAMETA,25-29,1964,2687,4651
KISII,SAMETA,30,427,682,1109
KISII,SAMETA,31,392,525,917
KISII,SAMETA,32,481,676,1157
KISII,SAMETA,33,360,540,900
KISII,SAMETA,34,316,447,763
KISII,SAMETA,30-34,1976,2870,4846
KISII,SAMETA,35,458,527,985
KISII,SAMETA,36,291,256,547
KISII,SAMETA,37,321,249,570
KISII,SAMETA,38,237,210,447
KISII,SAMETA,39,265,273,538
KISII,SAMETA,35-39,1572,1515,3087
KISII,SAMETA,40,316,324,640
KISII,SAMETA,41,353,322,675
KISII,SAMETA,42,262,267,529
KISII,SAMETA,43,242,286,528
KISII,SAMETA,44,182,191,373
KISII,SAMETA,40-44,1355,1390,2745
KISII,SAMETA,45,322,380,702
KISII,SAMETA,46,209,259,468
KISII,SAMETA,47,241,362,603
KISII,SAMETA,48,145,183,328
KISII,SAMETA,49,155,223,378
KISII,SAMETA,45-49,1072,1407,2479
KISII,SAMETA,50,249,275,524
KISII,SAMETA,51,197,203,400
KISII,SAMETA,52,178,135,313
KISII,SAMETA,53,105,98,203
KISII,SAMETA,54,156,113,269
KISII,SAMETA,50-54,885,824,1709
KISII,SAMETA,55,197,190,387
KISII,SAMETA,56,190,200,390
KISII,SAMETA,57,213,279,492
KISII,SAMETA,58,143,178,321
KISII,SAMETA,59,227,285,512
KISII,SAMETA,55-59,970,1132,2102
KISII,SAMETA,60,200,281,481
KISII,SAMETA,61,213,239,452
KISII,SAMETA,62,134,162,296
KISII,SAMETA,63,160,164,324
KISII,SAMETA,64,112,102,214
KISII,SAMETA,60-64,819,948,1767
KISII,SAMETA,65,140,185,325
KISII,SAMETA,66,63,81,144
KISII,SAMETA,67,140,147,287
KISII,SAMETA,68,55,72,127
KISII,SAMETA,69,116,124,240
KISII,SAMETA,65-69,514,609,1123
KISII,SAMETA,70,99,180,279
KISII,SAMETA,71,89,90,179
KISII,SAMETA,72,65,63,128
KISII,SAMETA,73,65,64,129
KISII,SAMETA,74,67,87,154
KISII,SAMETA,70-74,385,484,869
KISII,SAMETA,75,45,74,119
KISII,SAMETA,76,30,31,61
KISII,SAMETA,77,60,48,108
KISII,SAMETA,78,24,24,48
KISII,SAMETA,79,35,66,101
KISII,SAMETA,75-79,194,243,437
KISII,SAMETA,80,32,69,101
KISII,SAMETA,81,27,38,65
KISII,SAMETA,82,25,23,48
KISII,SAMETA,83,23,27,50
KISII,SAMETA,84,26,37,63
KISII,SAMETA,80-84,133,194,327
KISII,SAMETA,85,21,38,59
KISII,SAMETA,86,20,21,41
KISII,SAMETA,87,22,20,42
KISII,SAMETA,88,11,9,20
KISII,SAMETA,89,12,27,39
KISII,SAMETA,85-89,86,115,201
KISII,SAMETA,90,9,17,26
KISII,SAMETA,91,6,10,16
KISII,SAMETA,92,4,8,12
KISII,SAMETA,93,2,7,9
KISII,SAMETA,94,3,12,15
KISII,SAMETA,90-94,24,54,78
KISII,SAMETA,95,4,11,15
KISII,SAMETA,96,2,1,3
KISII,SAMETA,97,4,4,8
KISII,SAMETA,98,-,3,3
KISII,SAMETA,99,4,6,10
KISII,SAMETA,95-99,14,25,39
KISII,SAMETA,100+,4,22,26
KISII,SAMETA,Not Stated,-,1,1
KISUMU,ALL,Total,560942,594609,1155551
KISUMU,ALL,0,13840,13762,27602
KISUMU,ALL,1,14183,14016,28199
KISUMU,ALL,2,13853,14170,28023
KISUMU,ALL,3,14330,14622,28952
KISUMU,ALL,4,13994,14300,28294
KISUMU,ALL,0 - 4,70200,70870,141070
KISUMU,ALL,5,14355,14032,28387
KISUMU,ALL,6,14800,14823,29623
KISUMU,ALL,7,14594,14960,29554
KISUMU,ALL,8,14287,14214,28501
KISUMU,ALL,9,15696,15904,31600
KISUMU,ALL,05-Sep,73732,73933,147665
KISUMU,ALL,10,17169,16451,33620
KISUMU,ALL,11,15177,15848,31025
KISUMU,ALL,12,17562,17558,35120
KISUMU,ALL,13,16707,17268,33975
KISUMU,ALL,14,15203,15580,30783
KISUMU,ALL,Oct-14,81818,82705,164523
KISUMU,ALL,15,14847,15229,30076
KISUMU,ALL,16,13353,14022,27375
KISUMU,ALL,17,13966,14001,27967
KISUMU,ALL,18,11539,11815,23354
KISUMU,ALL,19,12506,13626,26132
KISUMU,ALL,15-19,66211,68693,134904
KISUMU,ALL,20,11213,13337,24550
KISUMU,ALL,21,10392,12367,22759
KISUMU,ALL,22,9647,11925,21572
KISUMU,ALL,23,10213,12669,22882
KISUMU,ALL,24,9592,11685,21277
KISUMU,ALL,20-24,51057,61983,113040
KISUMU,ALL,25,10828,12584,23412
KISUMU,ALL,26,8804,10748,19552
KISUMU,ALL,27,9713,11339,21052
KISUMU,ALL,28,7365,8433,15798
KISUMU,ALL,29,7646,9326,16972
KISUMU,ALL,25-29,44356,52430,96786
KISUMU,ALL,30,10435,12598,23033
KISUMU,ALL,31,7297,8086,15383
KISUMU,ALL,32,9441,10620,20061
KISUMU,ALL,33,7563,8803,16366
KISUMU,ALL,34,7410,8045,15455
KISUMU,ALL,30-34,42146,48152,90298
KISUMU,ALL,35,9069,8767,17836
KISUMU,ALL,36,6582,5794,12376
KISUMU,ALL,37,7026,5675,12701
KISUMU,ALL,38,5000,4127,9127
KISUMU,ALL,39,5869,4874,10743
KISUMU,ALL,35-39,33546,29237,62783
KISUMU,ALL,40,7165,6234,13399
KISUMU,ALL,41,5864,4784,10648
KISUMU,ALL,42,5460,4441,9901
KISUMU,ALL,43,4937,4849,9786
KISUMU,ALL,44,3793,3616,7409
KISUMU,ALL,40-44,27219,23924,51143
KISUMU,ALL,45,5200,4779,9979
KISUMU,ALL,46,3738,3272,7010
KISUMU,ALL,47,3940,3508,7448
KISUMU,ALL,48,2428,2245,4673
KISUMU,ALL,49,2724,2580,5304
KISUMU,ALL,45-49,18030,16384,34414
KISUMU,ALL,50,3542,4049,7591
KISUMU,ALL,51,2885,3407,6292
KISUMU,ALL,52,2362,2576,4938
KISUMU,ALL,53,2008,2186,4194
KISUMU,ALL,54,2225,2241,4466
KISUMU,ALL,50-54,13022,14459,27481
KISUMU,ALL,55,2418,2525,4943
KISUMU,ALL,56,2371,3008,5379
KISUMU,ALL,57,2499,3746,6245
KISUMU,ALL,58,1760,2037,3797
KISUMU,ALL,59,2126,2642,4768
KISUMU,ALL,55-59,11174,13958,25132
KISUMU,ALL,60,2587,3690,6277
KISUMU,ALL,61,2119,2575,4694
KISUMU,ALL,62,1686,2047,3733
KISUMU,ALL,63,1764,2183,3947
KISUMU,ALL,64,1396,1649,3045
KISUMU,ALL,60-64,9552,12144,21696
KISUMU,ALL,65,1936,2532,4468
KISUMU,ALL,66,1271,1756,3027
KISUMU,ALL,67,1941,2596,4537
KISUMU,ALL,68,785,912,1697
KISUMU,ALL,69,1361,1477,2838
KISUMU,ALL,65-69,7294,9273,16567
KISUMU,ALL,70,1802,2613,4415
KISUMU,ALL,71,1314,1363,2677
KISUMU,ALL,72,1004,1099,2103
KISUMU,ALL,73,814,898,1712
KISUMU,ALL,74,799,1062,1861
KISUMU,ALL,70-74,5733,7035,12768
KISUMU,ALL,75,662,939,1601
KISUMU,ALL,76,565,860,1425
KISUMU,ALL,77,636,958,1594
KISUMU,ALL,78,330,447,777
KISUMU,ALL,79,418,836,1254
KISUMU,ALL,75-79,2611,4040,6651
KISUMU,ALL,80,554,1033,1587
KISUMU,ALL,81,365,562,927
KISUMU,ALL,82,292,382,674
KISUMU,ALL,83,372,435,807
KISUMU,ALL,84,298,439,737
KISUMU,ALL,80-84,1881,2851,4732
KISUMU,ALL,85,237,416,653
KISUMU,ALL,86,186,221,407
KISUMU,ALL,87,240,404,644
KISUMU,ALL,88,91,167,258
KISUMU,ALL,89,142,386,528
KISUMU,ALL,85-89,896,1594,2490
KISUMU,ALL,90,87,236,323
KISUMU,ALL,91,67,135,202
KISUMU,ALL,92,66,83,149
KISUMU,ALL,93,41,69,110
KISUMU,ALL,94,38,54,92
KISUMU,ALL,90-94,299,577,876
KISUMU,ALL,95,37,76,113
KISUMU,ALL,96,19,50,69
KISUMU,ALL,97,20,36,56
KISUMU,ALL,98,17,36,53
KISUMU,ALL,99,21,57,78
KISUMU,ALL,95-99,114,255,369
KISUMU,ALL,100+,39,97,136
KISUMU,ALL,Not Stated,12,15,27
KISUMU,KISUMU EAST,Total,108304,112689,220993
KISUMU,KISUMU EAST,0,2946,3060,6006
KISUMU,KISUMU EAST,1,2954,2980,5934
KISUMU,KISUMU EAST,2,2809,2800,5609
KISUMU,KISUMU EAST,3,2945,2923,5868
KISUMU,KISUMU EAST,4,2748,2761,5509
KISUMU,KISUMU EAST,0 - 4,14402,14524,28926
KISUMU,KISUMU EAST,5,2621,2574,5195
KISUMU,KISUMU EAST,6,2703,2763,5466
KISUMU,KISUMU EAST,7,2643,2687,5330
KISUMU,KISUMU EAST,8,2559,2548,5107
KISUMU,KISUMU EAST,9,2727,2881,5608
KISUMU,KISUMU EAST,05-Sep,13253,13453,26706
KISUMU,KISUMU EAST,10,2975,2934,5909
KISUMU,KISUMU EAST,11,2507,2567,5074
KISUMU,KISUMU EAST,12,2998,2994,5992
KISUMU,KISUMU EAST,13,2683,2983,5666
KISUMU,KISUMU EAST,14,2445,2710,5155
KISUMU,KISUMU EAST,Oct-14,13608,14188,27796
KISUMU,KISUMU EAST,15,2323,2553,4876
KISUMU,KISUMU EAST,16,2256,2440,4696
KISUMU,KISUMU EAST,17,2272,2470,4742
KISUMU,KISUMU EAST,18,1982,2159,4141
KISUMU,KISUMU EAST,19,2025,2641,4666
KISUMU,KISUMU EAST,15-19,10858,12263,23121
KISUMU,KISUMU EAST,20,2069,2850,4919
KISUMU,KISUMU EAST,21,2162,2828,4990
KISUMU,KISUMU EAST,22,2131,2901,5032
KISUMU,KISUMU EAST,23,2439,3167,5606
KISUMU,KISUMU EAST,24,2428,2929,5357
KISUMU,KISUMU EAST,20-24,11229,14675,25904
KISUMU,KISUMU EAST,25,2659,3158,5817
KISUMU,KISUMU EAST,26,2236,2646,4882
KISUMU,KISUMU EAST,27,2519,2679,5198
KISUMU,KISUMU EAST,28,1896,2020,3916
KISUMU,KISUMU EAST,29,1946,2101,4047
KISUMU,KISUMU EAST,25-29,11256,12604,23860
KISUMU,KISUMU EAST,30,2688,2848,5536
KISUMU,KISUMU EAST,31,1852,1682,3534
KISUMU,KISUMU EAST,32,2326,2259,4585
KISUMU,KISUMU EAST,33,1742,1690,3432
KISUMU,KISUMU EAST,34,1634,1571,3205
KISUMU,KISUMU EAST,30-34,10242,10050,20292
KISUMU,KISUMU EAST,35,2037,1714,3751
KISUMU,KISUMU EAST,36,1506,1202,2708
KISUMU,KISUMU EAST,37,1489,1096,2585
KISUMU,KISUMU EAST,38,1092,846,1938
KISUMU,KISUMU EAST,39,1287,949,2236
KISUMU,KISUMU EAST,35-39,7411,5807,13218
KISUMU,KISUMU EAST,40,1508,1215,2723
KISUMU,KISUMU EAST,41,1137,820,1957
KISUMU,KISUMU EAST,42,1085,793,1878
KISUMU,KISUMU EAST,43,927,813,1740
KISUMU,KISUMU EAST,44,679,566,1245
KISUMU,KISUMU EAST,40-44,5336,4207,9543
KISUMU,KISUMU EAST,45,1018,743,1761
KISUMU,KISUMU EAST,46,651,493,1144
KISUMU,KISUMU EAST,47,755,554,1309
KISUMU,KISUMU EAST,48,453,351,804
KISUMU,KISUMU EAST,49,510,419,929
KISUMU,KISUMU EAST,45-49,3387,2560,5947
KISUMU,KISUMU EAST,50,637,615,1252
KISUMU,KISUMU EAST,51,439,467,906
KISUMU,KISUMU EAST,52,377,384,761
KISUMU,KISUMU EAST,53,335,324,659
KISUMU,KISUMU EAST,54,361,355,716
KISUMU,KISUMU EAST,50-54,2149,2145,4294
KISUMU,KISUMU EAST,55,395,363,758
KISUMU,KISUMU EAST,56,372,423,795
KISUMU,KISUMU EAST,57,371,507,878
KISUMU,KISUMU EAST,58,248,250,498
KISUMU,KISUMU EAST,59,287,346,633
KISUMU,KISUMU EAST,55-59,1673,1889,3562
KISUMU,KISUMU EAST,60,366,464,830
KISUMU,KISUMU EAST,61,307,319,626
KISUMU,KISUMU EAST,62,243,279,522
KISUMU,KISUMU EAST,63,227,262,489
KISUMU,KISUMU EAST,64,193,219,412
KISUMU,KISUMU EAST,60-64,1336,1543,2879
KISUMU,KISUMU EAST,65,267,291,558
KISUMU,KISUMU EAST,66,167,198,365
KISUMU,KISUMU EAST,67,235,288,523
KISUMU,KISUMU EAST,68,103,101,204
KISUMU,KISUMU EAST,69,159,185,344
KISUMU,KISUMU EAST,65-69,931,1063,1994
KISUMU,KISUMU EAST,70,219,284,503
KISUMU,KISUMU EAST,71,152,145,297
KISUMU,KISUMU EAST,72,101,118,219
KISUMU,KISUMU EAST,73,88,94,182
KISUMU,KISUMU EAST,74,86,99,185
KISUMU,KISUMU EAST,70-74,646,740,1386
KISUMU,KISUMU EAST,75,78,89,167
KISUMU,KISUMU EAST,76,60,101,161
KISUMU,KISUMU EAST,77,64,99,163
KISUMU,KISUMU EAST,78,30,44,74
KISUMU,KISUMU EAST,79,40,91,131
KISUMU,KISUMU EAST,75-79,272,424,696
KISUMU,KISUMU EAST,80,47,103,150
KISUMU,KISUMU EAST,81,28,54,82
KISUMU,KISUMU EAST,82,33,30,63
KISUMU,KISUMU EAST,83,39,57,96
KISUMU,KISUMU EAST,84,21,55,76
KISUMU,KISUMU EAST,80-84,168,299,467
KISUMU,KISUMU EAST,85,40,39,79
KISUMU,KISUMU EAST,86,20,25,45
KISUMU,KISUMU EAST,87,25,46,71
KISUMU,KISUMU EAST,88,10,16,26
KISUMU,KISUMU EAST,89,12,31,43
KISUMU,KISUMU EAST,85-89,107,157,264
KISUMU,KISUMU EAST,90,9,22,31
KISUMU,KISUMU EAST,91,4,15,19
KISUMU,KISUMU EAST,92,5,4,9
KISUMU,KISUMU EAST,93,3,9,12
KISUMU,KISUMU EAST,94,3,9,12
KISUMU,KISUMU EAST,90-94,24,59,83
KISUMU,KISUMU EAST,95,4,12,16
KISUMU,KISUMU EAST,96,1,2,3
KISUMU,KISUMU EAST,97,2,9,11
KISUMU,KISUMU EAST,98,2,2,4
KISUMU,KISUMU EAST,99,1,4,5
KISUMU,KISUMU EAST,95-99,10,29,39
KISUMU,KISUMU EAST,100+,5,7,12
KISUMU,KISUMU EAST,Not Stated,1,3,4
KISUMU,KISUMU CENTRAL,Total,84155,89985,174140
KISUMU,KISUMU CENTRAL,0,2216,2078,4294
KISUMU,KISUMU CENTRAL,1,2170,2118,4288
KISUMU,KISUMU CENTRAL,2,1946,2006,3952
KISUMU,KISUMU CENTRAL,3,1988,2107,4095
KISUMU,KISUMU CENTRAL,4,1870,1987,3857
KISUMU,KISUMU CENTRAL,0 - 4,10190,10296,20486
KISUMU,KISUMU CENTRAL,5,1712,1803,3515
KISUMU,KISUMU CENTRAL,6,1817,1902,3719
KISUMU,KISUMU CENTRAL,7,1912,1911,3823
KISUMU,KISUMU CENTRAL,8,1773,1796,3569
KISUMU,KISUMU CENTRAL,9,1873,1983,3856
KISUMU,KISUMU CENTRAL,05-Sep,9087,9395,18482
KISUMU,KISUMU CENTRAL,10,2040,1941,3981
KISUMU,KISUMU CENTRAL,11,1765,1942,3707
KISUMU,KISUMU CENTRAL,12,1918,2237,4155
KISUMU,KISUMU CENTRAL,13,1845,2174,4019
KISUMU,KISUMU CENTRAL,14,1761,1899,3660
KISUMU,KISUMU CENTRAL,Oct-14,9329,10193,19522
KISUMU,KISUMU CENTRAL,15,1665,1968,3633
KISUMU,KISUMU CENTRAL,16,1574,1945,3519
KISUMU,KISUMU CENTRAL,17,1701,2050,3751
KISUMU,KISUMU CENTRAL,18,1521,1769,3290
KISUMU,KISUMU CENTRAL,19,1650,2196,3846
KISUMU,KISUMU CENTRAL,15-19,8111,9928,18039
KISUMU,KISUMU CENTRAL,20,1600,2288,3888
KISUMU,KISUMU CENTRAL,21,1673,2310,3983
KISUMU,KISUMU CENTRAL,22,1780,2331,4111
KISUMU,KISUMU CENTRAL,23,1933,2532,4465
KISUMU,KISUMU CENTRAL,24,1861,2491,4352
KISUMU,KISUMU CENTRAL,20-24,8847,11952,20799
KISUMU,KISUMU CENTRAL,25,2091,2512,4603
KISUMU,KISUMU CENTRAL,26,1738,2273,4011
KISUMU,KISUMU CENTRAL,27,1883,2260,4143
KISUMU,KISUMU CENTRAL,28,1580,1875,3455
KISUMU,KISUMU CENTRAL,29,1634,2014,3648
KISUMU,KISUMU CENTRAL,25-29,8926,10934,19860
KISUMU,KISUMU CENTRAL,30,2107,2515,4622
KISUMU,KISUMU CENTRAL,31,1413,1572,2985
KISUMU,KISUMU CENTRAL,32,1933,2138,4071
KISUMU,KISUMU CENTRAL,33,1450,1609,3059
KISUMU,KISUMU CENTRAL,34,1485,1515,3000
KISUMU,KISUMU CENTRAL,30-34,8388,9349,17737
KISUMU,KISUMU CENTRAL,35,1752,1634,3386
KISUMU,KISUMU CENTRAL,36,1246,1232,2478
KISUMU,KISUMU CENTRAL,37,1305,1120,2425
KISUMU,KISUMU CENTRAL,38,1113,949,2062
KISUMU,KISUMU CENTRAL,39,1139,1006,2145
KISUMU,KISUMU CENTRAL,35-39,6555,5941,12496
KISUMU,KISUMU CENTRAL,40,1425,1186,2611
KISUMU,KISUMU CENTRAL,41,1093,802,1895
KISUMU,KISUMU CENTRAL,42,1065,852,1917
KISUMU,KISUMU CENTRAL,43,887,697,1584
KISUMU,KISUMU CENTRAL,44,683,552,1235
KISUMU,KISUMU CENTRAL,40-44,5153,4089,9242
KISUMU,KISUMU CENTRAL,45,982,783,1765
KISUMU,KISUMU CENTRAL,46,674,544,1218
KISUMU,KISUMU CENTRAL,47,696,510,1206
KISUMU,KISUMU CENTRAL,48,486,391,877
KISUMU,KISUMU CENTRAL,49,545,412,957
KISUMU,KISUMU CENTRAL,45-49,3383,2640,6023
KISUMU,KISUMU CENTRAL,50,675,558,1233
KISUMU,KISUMU CENTRAL,51,445,323,768
KISUMU,KISUMU CENTRAL,52,455,330,785
KISUMU,KISUMU CENTRAL,53,364,284,648
KISUMU,KISUMU CENTRAL,54,402,274,676
KISUMU,KISUMU CENTRAL,50-54,2341,1769,4110
KISUMU,KISUMU CENTRAL,55,394,296,690
KISUMU,KISUMU CENTRAL,56,382,325,707
KISUMU,KISUMU CENTRAL,57,326,309,635
KISUMU,KISUMU CENTRAL,58,261,225,486
KISUMU,KISUMU CENTRAL,59,315,260,575
KISUMU,KISUMU CENTRAL,55-59,1678,1415,3093
KISUMU,KISUMU CENTRAL,60,291,259,550
KISUMU,KISUMU CENTRAL,61,185,165,350
KISUMU,KISUMU CENTRAL,62,185,152,337
KISUMU,KISUMU CENTRAL,63,185,157,342
KISUMU,KISUMU CENTRAL,64,151,124,275
KISUMU,KISUMU CENTRAL,60-64,997,857,1854
KISUMU,KISUMU CENTRAL,65,158,160,318
KISUMU,KISUMU CENTRAL,66,84,94,178
KISUMU,KISUMU CENTRAL,67,134,126,260
KISUMU,KISUMU CENTRAL,68,72,50,122
KISUMU,KISUMU CENTRAL,69,97,83,180
KISUMU,KISUMU CENTRAL,65-69,545,513,1058
KISUMU,KISUMU CENTRAL,70,112,113,225
KISUMU,KISUMU CENTRAL,71,78,74,152
KISUMU,KISUMU CENTRAL,72,55,64,119
KISUMU,KISUMU CENTRAL,73,48,49,97
KISUMU,KISUMU CENTRAL,74,66,46,112
KISUMU,KISUMU CENTRAL,70-74,359,346,705
KISUMU,KISUMU CENTRAL,75,37,34,71
KISUMU,KISUMU CENTRAL,76,28,31,59
KISUMU,KISUMU CENTRAL,77,29,30,59
KISUMU,KISUMU CENTRAL,78,25,22,47
KISUMU,KISUMU CENTRAL,79,16,26,42
KISUMU,KISUMU CENTRAL,75-79,135,143,278
KISUMU,KISUMU CENTRAL,80,29,42,71
KISUMU,KISUMU CENTRAL,81,15,23,38
KISUMU,KISUMU CENTRAL,82,6,25,31
KISUMU,KISUMU CENTRAL,83,14,12,26
KISUMU,KISUMU CENTRAL,84,11,16,27
KISUMU,KISUMU CENTRAL,80-84,75,118,193
KISUMU,KISUMU CENTRAL,85,10,23,33
KISUMU,KISUMU CENTRAL,86,8,11,19
KISUMU,KISUMU CENTRAL,87,6,11,17
KISUMU,KISUMU CENTRAL,88,5,6,11
KISUMU,KISUMU CENTRAL,89,6,12,18
KISUMU,KISUMU CENTRAL,85-89,35,63,98
KISUMU,KISUMU CENTRAL,90,6,11,17
KISUMU,KISUMU CENTRAL,91,2,2,4
KISUMU,KISUMU CENTRAL,92,3,6,9
KISUMU,KISUMU CENTRAL,93,-,2,2
KISUMU,KISUMU CENTRAL,94,3,1,4
KISUMU,KISUMU CENTRAL,90-94,14,22,36
KISUMU,KISUMU CENTRAL,95,-,6,6
KISUMU,KISUMU CENTRAL,96,1,3,4
KISUMU,KISUMU CENTRAL,97,1,1,2
KISUMU,KISUMU CENTRAL,98,1,2,3
KISUMU,KISUMU CENTRAL,99,-,2,2
KISUMU,KISUMU CENTRAL,95-99,3,14,17
KISUMU,KISUMU CENTRAL,100+,-,1,1
KISUMU,KISUMU CENTRAL,Not Stated,4,7,11
KISUMU,KISUMU WEST,Total,85697,87121,172818
KISUMU,KISUMU WEST,0,2057,2018,4075
KISUMU,KISUMU WEST,1,2036,2034,4070
KISUMU,KISUMU WEST,2,2128,2100,4228
KISUMU,KISUMU WEST,3,1985,2066,4051
KISUMU,KISUMU WEST,4,2007,1931,3938
KISUMU,KISUMU WEST,0 - 4,10213,10149,20362
KISUMU,KISUMU WEST,5,2040,1970,4010
KISUMU,KISUMU WEST,6,2073,2107,4180
KISUMU,KISUMU WEST,7,2173,2220,4393
KISUMU,KISUMU WEST,8,2147,2065,4212
KISUMU,KISUMU WEST,9,2270,2283,4553
KISUMU,KISUMU WEST,05-Sep,10703,10645,21348
KISUMU,KISUMU WEST,10,2485,2451,4936
KISUMU,KISUMU WEST,11,2177,2426,4603
KISUMU,KISUMU WEST,12,2494,2548,5042
KISUMU,KISUMU WEST,13,2413,2509,4922
KISUMU,KISUMU WEST,14,2221,2254,4475
KISUMU,KISUMU WEST,Oct-14,11790,12188,23978
KISUMU,KISUMU WEST,15,2070,2092,4162
KISUMU,KISUMU WEST,16,1963,2047,4010
KISUMU,KISUMU WEST,17,2086,2104,4190
KISUMU,KISUMU WEST,18,1968,2138,4106
KISUMU,KISUMU WEST,19,2414,2331,4745
KISUMU,KISUMU WEST,15-19,10501,10712,21213
KISUMU,KISUMU WEST,20,2112,2062,4174
KISUMU,KISUMU WEST,21,1800,1865,3665
KISUMU,KISUMU WEST,22,1629,1782,3411
KISUMU,KISUMU WEST,23,1595,1836,3431
KISUMU,KISUMU WEST,24,1551,1697,3248
KISUMU,KISUMU WEST,20-24,8687,9242,17929
KISUMU,KISUMU WEST,25,1679,1821,3500
KISUMU,KISUMU WEST,26,1384,1469,2853
KISUMU,KISUMU WEST,27,1544,1707,3251
KISUMU,KISUMU WEST,28,1181,1200,2381
KISUMU,KISUMU WEST,29,1266,1351,2617
KISUMU,KISUMU WEST,25-29,7054,7548,14602
KISUMU,KISUMU WEST,30,1658,1718,3376
KISUMU,KISUMU WEST,31,1125,1088,2213
KISUMU,KISUMU WEST,32,1482,1441,2923
KISUMU,KISUMU WEST,33,1133,1271,2404
KISUMU,KISUMU WEST,34,1145,1107,2252
KISUMU,KISUMU WEST,30-34,6543,6625,13168
KISUMU,KISUMU WEST,35,1445,1288,2733
KISUMU,KISUMU WEST,36,1062,856,1918
KISUMU,KISUMU WEST,37,1143,871,2014
KISUMU,KISUMU WEST,38,816,603,1419
KISUMU,KISUMU WEST,39,905,717,1622
KISUMU,KISUMU WEST,35-39,5371,4335,9706
KISUMU,KISUMU WEST,40,1093,901,1994
KISUMU,KISUMU WEST,41,842,688,1530
KISUMU,KISUMU WEST,42,822,624,1446
KISUMU,KISUMU WEST,43,754,680,1434
KISUMU,KISUMU WEST,44,574,480,1054
KISUMU,KISUMU WEST,40-44,4085,3373,7458
KISUMU,KISUMU WEST,45,796,668,1464
KISUMU,KISUMU WEST,46,529,452,981
KISUMU,KISUMU WEST,47,600,487,1087
KISUMU,KISUMU WEST,48,384,317,701
KISUMU,KISUMU WEST,49,429,366,795
KISUMU,KISUMU WEST,45-49,2738,2290,5028
KISUMU,KISUMU WEST,50,548,586,1134
KISUMU,KISUMU WEST,51,430,505,935
KISUMU,KISUMU WEST,52,348,378,726
KISUMU,KISUMU WEST,53,304,342,646
KISUMU,KISUMU WEST,54,345,330,675
KISUMU,KISUMU WEST,50-54,1975,2141,4116
KISUMU,KISUMU WEST,55,393,405,798
KISUMU,KISUMU WEST,56,354,474,828
KISUMU,KISUMU WEST,57,370,553,923
KISUMU,KISUMU WEST,58,250,294,544
KISUMU,KISUMU WEST,59,302,419,721
KISUMU,KISUMU WEST,55-59,1669,2145,3814
KISUMU,KISUMU WEST,60,412,553,965
KISUMU,KISUMU WEST,61,329,405,734
KISUMU,KISUMU WEST,62,258,313,571
KISUMU,KISUMU WEST,63,281,349,630
KISUMU,KISUMU WEST,64,205,245,450
KISUMU,KISUMU WEST,60-64,1485,1865,3350
KISUMU,KISUMU WEST,65,300,404,704
KISUMU,KISUMU WEST,66,224,247,471
KISUMU,KISUMU WEST,67,304,362,666
KISUMU,KISUMU WEST,68,117,137,254
KISUMU,KISUMU WEST,69,183,215,398
KISUMU,KISUMU WEST,65-69,1128,1365,2493
KISUMU,KISUMU WEST,70,301,407,708
KISUMU,KISUMU WEST,71,191,234,425
KISUMU,KISUMU WEST,72,162,157,319
KISUMU,KISUMU WEST,73,132,158,290
KISUMU,KISUMU WEST,74,115,150,265
KISUMU,KISUMU WEST,70-74,901,1106,2007
KISUMU,KISUMU WEST,75,94,159,253
KISUMU,KISUMU WEST,76,88,133,221
KISUMU,KISUMU WEST,77,95,153,248
KISUMU,KISUMU WEST,78,57,62,119
KISUMU,KISUMU WEST,79,58,119,177
KISUMU,KISUMU WEST,75-79,392,626,1018
KISUMU,KISUMU WEST,80,75,145,220
KISUMU,KISUMU WEST,81,61,87,148
KISUMU,KISUMU WEST,82,41,64,105
KISUMU,KISUMU WEST,83,58,77,135
KISUMU,KISUMU WEST,84,52,62,114
KISUMU,KISUMU WEST,80-84,287,435,722
KISUMU,KISUMU WEST,85,35,56,91
KISUMU,KISUMU WEST,86,30,44,74
KISUMU,KISUMU WEST,87,24,59,83
KISUMU,KISUMU WEST,88,13,22,35
KISUMU,KISUMU WEST,89,24,28,52
KISUMU,KISUMU WEST,85-89,126,209,335
KISUMU,KISUMU WEST,90,8,30,38
KISUMU,KISUMU WEST,91,9,18,27
KISUMU,KISUMU WEST,92,8,11,19
KISUMU,KISUMU WEST,93,4,8,12
KISUMU,KISUMU WEST,94,3,5,8
KISUMU,KISUMU WEST,90-94,32,72,104
KISUMU,KISUMU WEST,95,2,12,14
KISUMU,KISUMU WEST,96,1,7,8
KISUMU,KISUMU WEST,97,3,2,5
KISUMU,KISUMU WEST,98,1,4,5
KISUMU,KISUMU WEST,99,3,6,9
KISUMU,KISUMU WEST,95-99,10,31,41
KISUMU,KISUMU WEST,100+,5,18,23
KISUMU,KISUMU WEST,Not Stated,2,1,3
KISUMU,SEME,Total,57658,64007,121665
KISUMU,SEME,0,1353,1410,2763
KISUMU,SEME,1,1563,1512,3075
KISUMU,SEME,2,1509,1523,3032
KISUMU,SEME,3,1511,1587,3098
KISUMU,SEME,4,1499,1530,3029
KISUMU,SEME,0 - 4,7435,7562,14997
KISUMU,SEME,5,1626,1560,3186
KISUMU,SEME,6,1716,1685,3401
KISUMU,SEME,7,1638,1732,3370
KISUMU,SEME,8,1649,1685,3334
KISUMU,SEME,9,1842,1834,3676
KISUMU,SEME,05-Sep,8471,8496,16967
KISUMU,SEME,10,1989,1869,3858
KISUMU,SEME,11,1844,1857,3701
KISUMU,SEME,12,2031,2049,4080
KISUMU,SEME,13,2047,1937,3984
KISUMU,SEME,14,1918,1797,3715
KISUMU,SEME,Oct-14,9829,9509,19338
KISUMU,SEME,15,1846,1722,3568
KISUMU,SEME,16,1641,1580,3221
KISUMU,SEME,17,1607,1529,3136
KISUMU,SEME,18,1275,1202,2477
KISUMU,SEME,19,1318,1347,2665
KISUMU,SEME,15-19,7687,7380,15067
KISUMU,SEME,20,1118,1196,2314
KISUMU,SEME,21,923,1056,1979
KISUMU,SEME,22,789,993,1782
KISUMU,SEME,23,799,999,1798
KISUMU,SEME,24,701,961,1662
KISUMU,SEME,20-24,4330,5205,9535
KISUMU,SEME,25,812,952,1764
KISUMU,SEME,26,648,870,1518
KISUMU,SEME,27,664,917,1581
KISUMU,SEME,28,522,615,1137
KISUMU,SEME,29,570,794,1364
KISUMU,SEME,25-29,3216,4148,7364
KISUMU,SEME,30,738,1115,1853
KISUMU,SEME,31,547,839,1386
KISUMU,SEME,32,684,939,1623
KISUMU,SEME,33,630,849,1479
KISUMU,SEME,34,637,751,1388
KISUMU,SEME,30-34,3236,4493,7729
KISUMU,SEME,35,724,808,1532
KISUMU,SEME,36,496,485,981
KISUMU,SEME,37,560,519,1079
KISUMU,SEME,38,394,371,765
KISUMU,SEME,39,486,446,932
KISUMU,SEME,35-39,2660,2629,5289
KISUMU,SEME,40,612,602,1214
KISUMU,SEME,41,529,513,1042
KISUMU,SEME,42,474,461,935
KISUMU,SEME,43,486,543,1029
KISUMU,SEME,44,349,434,783
KISUMU,SEME,40-44,2450,2553,5003
KISUMU,SEME,45,453,532,985
KISUMU,SEME,46,376,416,792
KISUMU,SEME,47,365,435,800
KISUMU,SEME,48,253,271,524
KISUMU,SEME,49,234,316,550
KISUMU,SEME,45-49,1681,1970,3651
KISUMU,SEME,50,327,494,821
KISUMU,SEME,51,304,425,729
KISUMU,SEME,52,241,338,579
KISUMU,SEME,53,225,304,529
KISUMU,SEME,54,218,283,501
KISUMU,SEME,50-54,1315,1844,3159
KISUMU,SEME,55,240,324,564
KISUMU,SEME,56,236,386,622
KISUMU,SEME,57,314,518,832
KISUMU,SEME,58,191,289,480
KISUMU,SEME,59,228,369,597
KISUMU,SEME,55-59,1209,1886,3095
KISUMU,SEME,60,338,581,919
KISUMU,SEME,61,260,389,649
KISUMU,SEME,62,225,329,554
KISUMU,SEME,63,207,345,552
KISUMU,SEME,64,169,226,395
KISUMU,SEME,60-64,1199,1870,3069
KISUMU,SEME,65,258,400,658
KISUMU,SEME,66,198,325,523
KISUMU,SEME,67,303,458,761
KISUMU,SEME,68,105,157,262
KISUMU,SEME,69,219,241,460
KISUMU,SEME,65-69,1083,1581,2664
KISUMU,SEME,70,253,470,723
KISUMU,SEME,71,219,223,442
KISUMU,SEME,72,155,193,348
KISUMU,SEME,73,114,137,251
KISUMU,SEME,74,121,195,316
KISUMU,SEME,70-74,862,1218,2080
KISUMU,SEME,75,103,159,262
KISUMU,SEME,76,101,150,251
KISUMU,SEME,77,119,203,322
KISUMU,SEME,78,51,90,141
KISUMU,SEME,79,81,142,223
KISUMU,SEME,75-79,455,744,1199
KISUMU,SEME,80,84,168,252
KISUMU,SEME,81,72,106,178
KISUMU,SEME,82,47,63,110
KISUMU,SEME,83,65,65,130
KISUMU,SEME,84,48,70,118
KISUMU,SEME,80-84,316,472,788
KISUMU,SEME,85,35,73,108
KISUMU,SEME,86,28,41,69
KISUMU,SEME,87,46,85,131
KISUMU,SEME,88,15,22,37
KISUMU,SEME,89,18,74,92
KISUMU,SEME,85-89,142,295,437
KISUMU,SEME,90,11,33,44
KISUMU,SEME,91,15,28,43
KISUMU,SEME,92,13,14,27
KISUMU,SEME,93,6,9,15
KISUMU,SEME,94,6,11,17
KISUMU,SEME,90-94,51,95,146
KISUMU,SEME,95,8,12,20
KISUMU,SEME,96,5,4,9
KISUMU,SEME,97,4,4,8
KISUMU,SEME,98,3,8,11
KISUMU,SEME,99,6,10,16
KISUMU,SEME,95-99,26,38,64
KISUMU,SEME,100+,5,19,24
KISUMU,SEME,Not Stated,-,-,-
KISUMU,MUHORONI,Total,76770,77345,154115
KISUMU,MUHORONI,0,1716,1739,3455
KISUMU,MUHORONI,1,1773,1846,3619
KISUMU,MUHORONI,2,1799,1850,3649
KISUMU,MUHORONI,3,1932,1990,3922
KISUMU,MUHORONI,4,2040,2039,4079
KISUMU,MUHORONI,0 - 4,9260,9464,18724
KISUMU,MUHORONI,5,2086,2045,4131
KISUMU,MUHORONI,6,2145,2100,4245
KISUMU,MUHORONI,7,2037,2140,4177
KISUMU,MUHORONI,8,2039,2051,4090
KISUMU,MUHORONI,9,2300,2274,4574
KISUMU,MUHORONI,05-Sep,10607,10610,21217
KISUMU,MUHORONI,10,2477,2339,4816
KISUMU,MUHORONI,11,2264,2324,4588
KISUMU,MUHORONI,12,2649,2539,5188
KISUMU,MUHORONI,13,2523,2559,5082
KISUMU,MUHORONI,14,2231,2218,4449
KISUMU,MUHORONI,Oct-14,12144,11979,24123
KISUMU,MUHORONI,15,2237,2122,4359
KISUMU,MUHORONI,16,1925,1888,3813
KISUMU,MUHORONI,17,1973,1831,3804
KISUMU,MUHORONI,18,1522,1449,2971
KISUMU,MUHORONI,19,1637,1678,3315
KISUMU,MUHORONI,15-19,9294,8968,18262
KISUMU,MUHORONI,20,1371,1580,2951
KISUMU,MUHORONI,21,1328,1388,2716
KISUMU,MUHORONI,22,1113,1270,2383
KISUMU,MUHORONI,23,1184,1380,2564
KISUMU,MUHORONI,24,1064,1161,2225
KISUMU,MUHORONI,20-24,6060,6779,12839
KISUMU,MUHORONI,25,1254,1334,2588
KISUMU,MUHORONI,26,937,1133,2070
KISUMU,MUHORONI,27,1098,1258,2356
KISUMU,MUHORONI,28,820,906,1726
KISUMU,MUHORONI,29,825,991,1816
KISUMU,MUHORONI,25-29,4934,5622,10556
KISUMU,MUHORONI,30,1123,1358,2481
KISUMU,MUHORONI,31,884,957,1841
KISUMU,MUHORONI,32,1165,1257,2422
KISUMU,MUHORONI,33,1016,1143,2159
KISUMU,MUHORONI,34,967,1063,2030
KISUMU,MUHORONI,30-34,5155,5778,10933
KISUMU,MUHORONI,35,1182,1093,2275
KISUMU,MUHORONI,36,927,672,1599
KISUMU,MUHORONI,37,909,654,1563
KISUMU,MUHORONI,38,609,443,1052
KISUMU,MUHORONI,39,817,608,1425
KISUMU,MUHORONI,35-39,4444,3470,7914
KISUMU,MUHORONI,40,913,735,1648
KISUMU,MUHORONI,41,895,671,1566
KISUMU,MUHORONI,42,772,573,1345
KISUMU,MUHORONI,43,739,664,1403
KISUMU,MUHORONI,44,576,534,1110
KISUMU,MUHORONI,40-44,3895,3177,7072
KISUMU,MUHORONI,45,816,671,1487
KISUMU,MUHORONI,46,618,434,1052
KISUMU,MUHORONI,47,626,473,1099
KISUMU,MUHORONI,48,341,272,613
KISUMU,MUHORONI,49,413,323,736
KISUMU,MUHORONI,45-49,2814,2173,4987
KISUMU,MUHORONI,50,529,530,1059
KISUMU,MUHORONI,51,464,503,967
KISUMU,MUHORONI,52,383,340,723
KISUMU,MUHORONI,53,301,262,563
KISUMU,MUHORONI,54,337,306,643
KISUMU,MUHORONI,50-54,2014,1941,3955
KISUMU,MUHORONI,55,344,349,693
KISUMU,MUHORONI,56,428,413,841
KISUMU,MUHORONI,57,407,572,979
KISUMU,MUHORONI,58,298,289,587
KISUMU,MUHORONI,59,366,375,741
KISUMU,MUHORONI,55-59,1843,1998,3841
KISUMU,MUHORONI,60,395,511,906
KISUMU,MUHORONI,61,347,365,712
KISUMU,MUHORONI,62,241,280,521
KISUMU,MUHORONI,63,293,301,594
KISUMU,MUHORONI,64,218,248,466
KISUMU,MUHORONI,60-64,1494,1705,3199
KISUMU,MUHORONI,65,278,338,616
KISUMU,MUHORONI,66,189,281,470
KISUMU,MUHORONI,67,286,378,664
KISUMU,MUHORONI,68,121,127,248
KISUMU,MUHORONI,69,221,232,453
KISUMU,MUHORONI,65-69,1095,1356,2451
KISUMU,MUHORONI,70,260,353,613
KISUMU,MUHORONI,71,191,210,401
KISUMU,MUHORONI,72,164,171,335
KISUMU,MUHORONI,73,105,127,232
KISUMU,MUHORONI,74,132,168,300
KISUMU,MUHORONI,70-74,852,1029,1881
KISUMU,MUHORONI,75,100,139,239
KISUMU,MUHORONI,76,65,138,203
KISUMU,MUHORONI,77,91,120,211
KISUMU,MUHORONI,78,50,65,115
KISUMU,MUHORONI,79,69,116,185
KISUMU,MUHORONI,75-79,375,578,953
KISUMU,MUHORONI,80,81,142,223
KISUMU,MUHORONI,81,59,77,136
KISUMU,MUHORONI,82,45,47,92
KISUMU,MUHORONI,83,52,58,110
KISUMU,MUHORONI,84,45,60,105
KISUMU,MUHORONI,80-84,282,384,666
KISUMU,MUHORONI,85,29,61,90
KISUMU,MUHORONI,86,20,23,43
KISUMU,MUHORONI,87,45,46,91
KISUMU,MUHORONI,88,13,31,44
KISUMU,MUHORONI,89,25,58,83
KISUMU,MUHORONI,85-89,132,219,351
KISUMU,MUHORONI,90,16,27,43
KISUMU,MUHORONI,91,11,14,25
KISUMU,MUHORONI,92,13,15,28
KISUMU,MUHORONI,93,9,8,17
KISUMU,MUHORONI,94,7,7,14
KISUMU,MUHORONI,90-94,56,71,127
KISUMU,MUHORONI,95,3,8,11
KISUMU,MUHORONI,96,5,10,15
KISUMU,MUHORONI,97,2,4,6
KISUMU,MUHORONI,98,1,4,5
KISUMU,MUHORONI,99,3,6,9
KISUMU,MUHORONI,95-99,14,32,46
KISUMU,MUHORONI,100+,4,11,15
KISUMU,MUHORONI,Not Stated,2,1,3
KISUMU,NYANDO,Total,77121,84380,161501
KISUMU,NYANDO,0,1902,1847,3749
KISUMU,NYANDO,1,1922,1851,3773
KISUMU,NYANDO,2,1891,1974,3865
KISUMU,NYANDO,3,2046,2032,4078
KISUMU,NYANDO,4,1894,2018,3912
KISUMU,NYANDO,0 - 4,9655,9722,19377
KISUMU,NYANDO,5,2148,2085,4233
KISUMU,NYANDO,6,2189,2106,4295
KISUMU,NYANDO,7,2217,2217,4434
KISUMU,NYANDO,8,2161,2059,4220
KISUMU,NYANDO,9,2352,2376,4728
KISUMU,NYANDO,05-Sep,11067,10843,21910
KISUMU,NYANDO,10,2647,2571,5218
KISUMU,NYANDO,11,2354,2467,4821
KISUMU,NYANDO,12,2857,2699,5556
KISUMU,NYANDO,13,2650,2550,5200
KISUMU,NYANDO,14,2357,2387,4744
KISUMU,NYANDO,Oct-14,12865,12674,25539
KISUMU,NYANDO,15,2415,2474,4889
KISUMU,NYANDO,16,2003,2096,4099
KISUMU,NYANDO,17,2175,2114,4289
KISUMU,NYANDO,18,1608,1576,3184
KISUMU,NYANDO,19,1801,1820,3621
KISUMU,NYANDO,15-19,10002,10080,20082
KISUMU,NYANDO,20,1508,1815,3323
KISUMU,NYANDO,21,1280,1570,2850
KISUMU,NYANDO,22,1192,1490,2682
KISUMU,NYANDO,23,1234,1494,2728
KISUMU,NYANDO,24,1111,1329,2440
KISUMU,NYANDO,20-24,6325,7698,14023
KISUMU,NYANDO,25,1292,1531,2823
KISUMU,NYANDO,26,1063,1303,2366
KISUMU,NYANDO,27,1161,1360,2521
KISUMU,NYANDO,28,758,962,1720
KISUMU,NYANDO,29,770,1087,1857
KISUMU,NYANDO,25-29,5044,6243,11287
KISUMU,NYANDO,30,1177,1499,2676
KISUMU,NYANDO,31,807,1058,1865
KISUMU,NYANDO,32,1062,1456,2518
KISUMU,NYANDO,33,885,1314,2199
KISUMU,NYANDO,34,855,1124,1979
KISUMU,NYANDO,30-34,4786,6451,11237
KISUMU,NYANDO,35,1050,1187,2237
KISUMU,NYANDO,36,730,729,1459
KISUMU,NYANDO,37,875,743,1618
KISUMU,NYANDO,38,543,476,1019
KISUMU,NYANDO,39,671,593,1264
KISUMU,NYANDO,35-39,3869,3728,7597
KISUMU,NYANDO,40,890,838,1728
KISUMU,NYANDO,41,700,647,1347
KISUMU,NYANDO,42,686,582,1268
KISUMU,NYANDO,43,574,767,1341
KISUMU,NYANDO,44,486,503,989
KISUMU,NYANDO,40-44,3336,3337,6673
KISUMU,NYANDO,45,589,641,1230
KISUMU,NYANDO,46,484,461,945
KISUMU,NYANDO,47,474,509,983
KISUMU,NYANDO,48,258,310,568
KISUMU,NYANDO,49,307,360,667
KISUMU,NYANDO,45-49,2112,2281,4393
KISUMU,NYANDO,50,437,671,1108
KISUMU,NYANDO,51,444,648,1092
KISUMU,NYANDO,52,290,428,718
KISUMU,NYANDO,53,242,341,583
KISUMU,NYANDO,54,270,315,585
KISUMU,NYANDO,50-54,1683,2403,4086
KISUMU,NYANDO,55,323,401,724
KISUMU,NYANDO,56,276,506,782
KISUMU,NYANDO,57,377,672,1049
KISUMU,NYANDO,58,274,334,608
KISUMU,NYANDO,59,334,421,755
KISUMU,NYANDO,55-59,1584,2334,3918
KISUMU,NYANDO,60,409,621,1030
KISUMU,NYANDO,61,377,434,811
KISUMU,NYANDO,62,260,326,586
KISUMU,NYANDO,63,277,379,656
KISUMU,NYANDO,64,245,289,534
KISUMU,NYANDO,60-64,1568,2049,3617
KISUMU,NYANDO,65,339,452,791
KISUMU,NYANDO,66,198,284,482
KISUMU,NYANDO,67,310,493,803
KISUMU,NYANDO,68,137,156,293
KISUMU,NYANDO,69,242,227,469
KISUMU,NYANDO,65-69,1226,1612,2838
KISUMU,NYANDO,70,309,470,779
KISUMU,NYANDO,71,210,220,430
KISUMU,NYANDO,72,152,160,312
KISUMU,NYANDO,73,155,145,300
KISUMU,NYANDO,74,122,190,312
KISUMU,NYANDO,70-74,948,1185,2133
KISUMU,NYANDO,75,119,166,285
KISUMU,NYANDO,76,103,161,264
KISUMU,NYANDO,77,112,169,281
KISUMU,NYANDO,78,48,79,127
KISUMU,NYANDO,79,64,169,233
KISUMU,NYANDO,75-79,446,744,1190
KISUMU,NYANDO,80,130,196,326
KISUMU,NYANDO,81,61,108,169
KISUMU,NYANDO,82,53,60,113
KISUMU,NYANDO,83,75,76,151
KISUMU,NYANDO,84,48,82,130
KISUMU,NYANDO,80-84,367,522,889
KISUMU,NYANDO,85,42,81,123
KISUMU,NYANDO,86,39,31,70
KISUMU,NYANDO,87,44,70,114
KISUMU,NYANDO,88,14,38,52
KISUMU,NYANDO,89,25,80,105
KISUMU,NYANDO,85-89,164,300,464
KISUMU,NYANDO,90,13,56,69
KISUMU,NYANDO,91,9,28,37
KISUMU,NYANDO,92,8,14,22
KISUMU,NYANDO,93,6,14,20
KISUMU,NYANDO,94,8,7,15
KISUMU,NYANDO,90-94,44,119,163
KISUMU,NYANDO,95,5,10,15
KISUMU,NYANDO,96,4,11,15
KISUMU,NYANDO,97,4,6,10
KISUMU,NYANDO,98,3,7,10
KISUMU,NYANDO,99,4,6,10
KISUMU,NYANDO,95-99,20,40,60
KISUMU,NYANDO,100+,8,13,21
KISUMU,NYANDO,Not Stated,2,2,4
KISUMU,NYAKACH,Total,71237,79082,150319
KISUMU,NYAKACH,0,1650,1610,3260
KISUMU,NYAKACH,1,1765,1675,3440
KISUMU,NYAKACH,2,1771,1917,3688
KISUMU,NYAKACH,3,1923,1917,3840
KISUMU,NYAKACH,4,1936,2034,3970
KISUMU,NYAKACH,0 - 4,9045,9153,18198
KISUMU,NYAKACH,5,2122,1995,4117
KISUMU,NYAKACH,6,2157,2160,4317
KISUMU,NYAKACH,7,1974,2053,4027
KISUMU,NYAKACH,8,1959,2010,3969
KISUMU,NYAKACH,9,2332,2273,4605
KISUMU,NYAKACH,05-Sep,10544,10491,21035
KISUMU,NYAKACH,10,2556,2346,4902
KISUMU,NYAKACH,11,2266,2265,4531
KISUMU,NYAKACH,12,2615,2492,5107
KISUMU,NYAKACH,13,2546,2556,5102
KISUMU,NYAKACH,14,2270,2315,4585
KISUMU,NYAKACH,Oct-14,12253,11974,24227
KISUMU,NYAKACH,15,2291,2298,4589
KISUMU,NYAKACH,16,1991,2026,4017
KISUMU,NYAKACH,17,2152,1903,4055
KISUMU,NYAKACH,18,1663,1522,3185
KISUMU,NYAKACH,19,1661,1613,3274
KISUMU,NYAKACH,15-19,9758,9362,19120
KISUMU,NYAKACH,20,1435,1546,2981
KISUMU,NYAKACH,21,1226,1350,2576
KISUMU,NYAKACH,22,1013,1158,2171
KISUMU,NYAKACH,23,1029,1261,2290
KISUMU,NYAKACH,24,876,1117,1993
KISUMU,NYAKACH,20-24,5579,6432,12011
KISUMU,NYAKACH,25,1041,1276,2317
KISUMU,NYAKACH,26,798,1054,1852
KISUMU,NYAKACH,27,844,1158,2002
KISUMU,NYAKACH,28,608,855,1463
KISUMU,NYAKACH,29,635,988,1623
KISUMU,NYAKACH,25-29,3926,5331,9257
KISUMU,NYAKACH,30,944,1545,2489
KISUMU,NYAKACH,31,669,890,1559
KISUMU,NYAKACH,32,789,1130,1919
KISUMU,NYAKACH,33,707,927,1634
KISUMU,NYAKACH,34,687,914,1601
KISUMU,NYAKACH,30-34,3796,5406,9202
KISUMU,NYAKACH,35,879,1043,1922
KISUMU,NYAKACH,36,615,618,1233
KISUMU,NYAKACH,37,745,672,1417
KISUMU,NYAKACH,38,433,439,872
KISUMU,NYAKACH,39,564,555,1119
KISUMU,NYAKACH,35-39,3236,3327,6563
KISUMU,NYAKACH,40,724,757,1481
KISUMU,NYAKACH,41,668,643,1311
KISUMU,NYAKACH,42,556,556,1112
KISUMU,NYAKACH,43,570,685,1255
KISUMU,NYAKACH,44,446,547,993
KISUMU,NYAKACH,40-44,2964,3188,6152
KISUMU,NYAKACH,45,546,741,1287
KISUMU,NYAKACH,46,406,472,878
KISUMU,NYAKACH,47,424,540,964
KISUMU,NYAKACH,48,253,333,586
KISUMU,NYAKACH,49,286,384,670
KISUMU,NYAKACH,45-49,1915,2470,4385
KISUMU,NYAKACH,50,389,595,984
KISUMU,NYAKACH,51,359,536,895
KISUMU,NYAKACH,52,268,378,646
KISUMU,NYAKACH,53,237,329,566
KISUMU,NYAKACH,54,292,378,670
KISUMU,NYAKACH,50-54,1545,2216,3761
KISUMU,NYAKACH,55,329,387,716
KISUMU,NYAKACH,56,323,481,804
KISUMU,NYAKACH,57,334,615,949
KISUMU,NYAKACH,58,238,356,594
KISUMU,NYAKACH,59,294,452,746
KISUMU,NYAKACH,55-59,1518,2291,3809
KISUMU,NYAKACH,60,376,701,1077
KISUMU,NYAKACH,61,314,498,812
KISUMU,NYAKACH,62,274,368,642
KISUMU,NYAKACH,63,294,390,684
KISUMU,NYAKACH,64,215,298,513
KISUMU,NYAKACH,60-64,1473,2255,3728
KISUMU,NYAKACH,65,336,487,823
KISUMU,NYAKACH,66,211,327,538
KISUMU,NYAKACH,67,369,491,860
KISUMU,NYAKACH,68,130,184,314
KISUMU,NYAKACH,69,240,294,534
KISUMU,NYAKACH,65-69,1286,1783,3069
KISUMU,NYAKACH,70,348,516,864
KISUMU,NYAKACH,71,273,257,530
KISUMU,NYAKACH,72,215,236,451
KISUMU,NYAKACH,73,172,188,360
KISUMU,NYAKACH,74,157,214,371
KISUMU,NYAKACH,70-74,1165,1411,2576
KISUMU,NYAKACH,75,131,193,324
KISUMU,NYAKACH,76,120,146,266
KISUMU,NYAKACH,77,126,184,310
KISUMU,NYAKACH,78,69,85,154
KISUMU,NYAKACH,79,90,173,263
KISUMU,NYAKACH,75-79,536,781,1317
KISUMU,NYAKACH,80,108,237,345
KISUMU,NYAKACH,81,69,107,176
KISUMU,NYAKACH,82,67,93,160
KISUMU,NYAKACH,83,69,90,159
KISUMU,NYAKACH,84,73,94,167
KISUMU,NYAKACH,80-84,386,621,1007
KISUMU,NYAKACH,85,46,83,129
KISUMU,NYAKACH,86,41,46,87
KISUMU,NYAKACH,87,50,87,137
KISUMU,NYAKACH,88,21,32,53
KISUMU,NYAKACH,89,32,103,135
KISUMU,NYAKACH,85-89,190,351,541
KISUMU,NYAKACH,90,24,57,81
KISUMU,NYAKACH,91,17,30,47
KISUMU,NYAKACH,92,16,19,35
KISUMU,NYAKACH,93,13,19,32
KISUMU,NYAKACH,94,8,14,22
KISUMU,NYAKACH,90-94,78,139,217
KISUMU,NYAKACH,95,15,16,31
KISUMU,NYAKACH,96,2,13,15
KISUMU,NYAKACH,97,4,10,14
KISUMU,NYAKACH,98,6,9,15
KISUMU,NYAKACH,99,4,23,27
KISUMU,NYAKACH,95-99,31,71,102
KISUMU,NYAKACH,100+,12,28,40
KISUMU,NYAKACH,Not Stated,1,1,2
KITUI,ALL,Total,549003,587151,1136154
KITUI,ALL,0,11522,11378,22900
KITUI,ALL,1,12622,12372,24994
KITUI,ALL,2,12778,12696,25474
KITUI,ALL,3,13214,13095,26309
KITUI,ALL,4,13436,13077,26513
KITUI,ALL,0 - 4,63572,62618,126190
KITUI,ALL,5,14125,13808,27933
KITUI,ALL,6,14179,13945,28124
KITUI,ALL,7,13599,13295,26894
KITUI,ALL,8,15343,15118,30461
KITUI,ALL,9,15761,15299,31060
KITUI,ALL,05-Sep,73007,71465,144472
KITUI,ALL,10,16734,16201,32935
KITUI,ALL,11,17057,17687,34744
KITUI,ALL,12,18535,17215,35750
KITUI,ALL,13,17838,17513,35351
KITUI,ALL,14,17560,17106,34666
KITUI,ALL,Oct-14,87724,85722,173446
KITUI,ALL,15,17786,17159,34945
KITUI,ALL,16,16926,16661,33587
KITUI,ALL,17,16725,15746,32471
KITUI,ALL,18,12815,11867,24682
KITUI,ALL,19,13293,12170,25463
KITUI,ALL,15-19,77545,73603,151148
KITUI,ALL,20,11354,11057,22411
KITUI,ALL,21,9090,9347,18437
KITUI,ALL,22,7845,8414,16259
KITUI,ALL,23,7840,9064,16904
KITUI,ALL,24,6859,7850,14709
KITUI,ALL,20-24,42988,45732,88720
KITUI,ALL,25,7857,8534,16391
KITUI,ALL,26,5661,6847,12508
KITUI,ALL,27,6430,7066,13496
KITUI,ALL,28,5152,6196,11348
KITUI,ALL,29,6175,7591,13766
KITUI,ALL,25-29,31275,36234,67509
KITUI,ALL,30,7097,9085,16182
KITUI,ALL,31,5582,6685,12267
KITUI,ALL,32,6510,8280,14790
KITUI,ALL,33,5977,7748,13725
KITUI,ALL,34,5081,6646,11727
KITUI,ALL,30-34,30247,38444,68691
KITUI,ALL,35,6899,8505,15404
KITUI,ALL,36,4680,5701,10381
KITUI,ALL,37,5372,5937,11309
KITUI,ALL,38,3729,4534,8263
KITUI,ALL,39,5326,5995,11321
KITUI,ALL,35-39,26006,30672,56678
KITUI,ALL,40,5271,5825,11096
KITUI,ALL,41,5457,5758,11215
KITUI,ALL,42,4593,5232,9825
KITUI,ALL,43,4283,5420,9703
KITUI,ALL,44,4157,5348,9505
KITUI,ALL,40-44,23761,27583,51344
KITUI,ALL,45,6177,7417,13594
KITUI,ALL,46,4337,4988,9325
KITUI,ALL,47,4236,4966,9202
KITUI,ALL,48,3060,3563,6623
KITUI,ALL,49,4073,4835,8908
KITUI,ALL,45-49,21883,25769,47652
KITUI,ALL,50,3930,4964,8894
KITUI,ALL,51,3604,4350,7954
KITUI,ALL,52,2885,3210,6095
KITUI,ALL,53,2207,2469,4676
KITUI,ALL,54,3091,3109,6200
KITUI,ALL,50-54,15717,18102,33819
KITUI,ALL,55,3231,3113,6344
KITUI,ALL,56,3481,3612,7093
KITUI,ALL,57,2591,3098,5689
KITUI,ALL,58,1838,2484,4322
KITUI,ALL,59,2635,3621,6256
KITUI,ALL,55-59,13776,15928,29704
KITUI,ALL,60,3176,3872,7048
KITUI,ALL,61,2532,2993,5525
KITUI,ALL,62,2051,2207,4258
KITUI,ALL,63,2093,2437,4530
KITUI,ALL,64,1680,1963,3643
KITUI,ALL,60-64,11532,13472,25004
KITUI,ALL,65,2401,2884,5285
KITUI,ALL,66,1687,1692,3379
KITUI,ALL,67,2828,3116,5944
KITUI,ALL,68,1371,1597,2968
KITUI,ALL,69,1922,3129,5051
KITUI,ALL,65-69,10209,12418,22627
KITUI,ALL,70,2337,3765,6102
KITUI,ALL,71,1650,2114,3764
KITUI,ALL,72,1165,1418,2583
KITUI,ALL,73,1392,2511,3903
KITUI,ALL,74,1161,1943,3104
KITUI,ALL,70-74,7705,11751,19456
KITUI,ALL,75,1165,1479,2644
KITUI,ALL,76,756,939,1695
KITUI,ALL,77,930,1105,2035
KITUI,ALL,78,767,684,1451
KITUI,ALL,79,931,1763,2694
KITUI,ALL,75-79,4549,5970,10519
KITUI,ALL,80,1132,1938,3070
KITUI,ALL,81,604,873,1477
KITUI,ALL,82,537,479,1016
KITUI,ALL,83,595,771,1366
KITUI,ALL,84,723,1264,1987
KITUI,ALL,80-84,3591,5325,8916
KITUI,ALL,85,458,623,1081
KITUI,ALL,86,341,251,592
KITUI,ALL,87,381,463,844
KITUI,ALL,88,198,215,413
KITUI,ALL,89,498,1052,1550
KITUI,ALL,85-89,1876,2604,4480
KITUI,ALL,90,440,934,1374
KITUI,ALL,91,279,698,977
KITUI,ALL,92,201,292,493
KITUI,ALL,93,131,223,354
KITUI,ALL,94,155,225,380
KITUI,ALL,90-94,1206,2372,3578
KITUI,ALL,95,168,303,471
KITUI,ALL,96,72,96,168
KITUI,ALL,97,112,84,196
KITUI,ALL,98,60,106,166
KITUI,ALL,99,146,291,437
KITUI,ALL,95-99,558,880,1438
KITUI,ALL,100+,272,481,753
KITUI,ALL,Not Stated,4,6,10
KITUI,IKUTHA,Total,39986,42976,82962
KITUI,IKUTHA,0,755,816,1571
KITUI,IKUTHA,1,857,852,1709
KITUI,IKUTHA,2,826,799,1625
KITUI,IKUTHA,3,882,920,1802
KITUI,IKUTHA,4,1005,971,1976
KITUI,IKUTHA,0 - 4,4325,4358,8683
KITUI,IKUTHA,5,1094,1058,2152
KITUI,IKUTHA,6,1144,1094,2238
KITUI,IKUTHA,7,1091,1080,2171
KITUI,IKUTHA,8,1387,1335,2722
KITUI,IKUTHA,9,1381,1257,2638
KITUI,IKUTHA,05-Sep,6097,5824,11921
KITUI,IKUTHA,10,1393,1303,2696
KITUI,IKUTHA,11,1404,1508,2912
KITUI,IKUTHA,12,1609,1517,3126
KITUI,IKUTHA,13,1487,1410,2897
KITUI,IKUTHA,14,1378,1323,2701
KITUI,IKUTHA,Oct-14,7271,7061,14332
KITUI,IKUTHA,15,1444,1414,2858
KITUI,IKUTHA,16,1446,1382,2828
KITUI,IKUTHA,17,1339,1307,2646
KITUI,IKUTHA,18,1057,960,2017
KITUI,IKUTHA,19,990,915,1905
KITUI,IKUTHA,15-19,6276,5978,12254
KITUI,IKUTHA,20,865,811,1676
KITUI,IKUTHA,21,672,632,1304
KITUI,IKUTHA,22,454,477,931
KITUI,IKUTHA,23,454,522,976
KITUI,IKUTHA,24,404,483,887
KITUI,IKUTHA,20-24,2849,2925,5774
KITUI,IKUTHA,25,470,502,972
KITUI,IKUTHA,26,297,412,709
KITUI,IKUTHA,27,354,414,768
KITUI,IKUTHA,28,300,378,678
KITUI,IKUTHA,29,381,479,860
KITUI,IKUTHA,25-29,1802,2185,3987
KITUI,IKUTHA,30,411,635,1046
KITUI,IKUTHA,31,377,435,812
KITUI,IKUTHA,32,415,548,963
KITUI,IKUTHA,33,388,553,941
KITUI,IKUTHA,34,332,417,749
KITUI,IKUTHA,30-34,1923,2588,4511
KITUI,IKUTHA,35,459,582,1041
KITUI,IKUTHA,36,287,433,720
KITUI,IKUTHA,37,309,465,774
KITUI,IKUTHA,38,201,274,475
KITUI,IKUTHA,39,337,485,822
KITUI,IKUTHA,35-39,1593,2239,3832
KITUI,IKUTHA,40,293,341,634
KITUI,IKUTHA,41,362,426,788
KITUI,IKUTHA,42,322,315,637
KITUI,IKUTHA,43,286,393,679
KITUI,IKUTHA,44,251,364,615
KITUI,IKUTHA,40-44,1514,1839,3353
KITUI,IKUTHA,45,440,509,949
KITUI,IKUTHA,46,285,378,663
KITUI,IKUTHA,47,338,415,753
KITUI,IKUTHA,48,231,262,493
KITUI,IKUTHA,49,286,411,697
KITUI,IKUTHA,45-49,1580,1975,3555
KITUI,IKUTHA,50,271,375,646
KITUI,IKUTHA,51,229,258,487
KITUI,IKUTHA,52,189,206,395
KITUI,IKUTHA,53,166,112,278
KITUI,IKUTHA,54,248,173,421
KITUI,IKUTHA,50-54,1103,1124,2227
KITUI,IKUTHA,55,189,155,344
KITUI,IKUTHA,56,216,242,458
KITUI,IKUTHA,57,153,218,371
KITUI,IKUTHA,58,115,199,314
KITUI,IKUTHA,59,171,242,413
KITUI,IKUTHA,55-59,844,1056,1900
KITUI,IKUTHA,60,168,263,431
KITUI,IKUTHA,61,158,226,384
KITUI,IKUTHA,62,132,150,282
KITUI,IKUTHA,63,152,190,342
KITUI,IKUTHA,64,124,140,264
KITUI,IKUTHA,60-64,734,969,1703
KITUI,IKUTHA,65,164,208,372
KITUI,IKUTHA,66,112,133,245
KITUI,IKUTHA,67,234,231,465
KITUI,IKUTHA,68,101,80,181
KITUI,IKUTHA,69,128,174,302
KITUI,IKUTHA,65-69,739,826,1565
KITUI,IKUTHA,70,136,178,314
KITUI,IKUTHA,71,116,137,253
KITUI,IKUTHA,72,71,109,180
KITUI,IKUTHA,73,113,290,403
KITUI,IKUTHA,74,74,125,199
KITUI,IKUTHA,70-74,510,839,1349
KITUI,IKUTHA,75,71,107,178
KITUI,IKUTHA,76,60,70,130
KITUI,IKUTHA,77,73,61,134
KITUI,IKUTHA,78,53,46,99
KITUI,IKUTHA,79,67,95,162
KITUI,IKUTHA,75-79,324,379,703
KITUI,IKUTHA,80,72,90,162
KITUI,IKUTHA,81,35,43,78
KITUI,IKUTHA,82,37,26,63
KITUI,IKUTHA,83,40,43,83
KITUI,IKUTHA,84,52,164,216
KITUI,IKUTHA,80-84,236,366,602
KITUI,IKUTHA,85,30,42,72
KITUI,IKUTHA,86,17,8,25
KITUI,IKUTHA,87,30,21,51
KITUI,IKUTHA,88,15,11,26
KITUI,IKUTHA,89,31,62,93
KITUI,IKUTHA,85-89,123,144,267
KITUI,IKUTHA,90,23,66,89
KITUI,IKUTHA,91,21,60,81
KITUI,IKUTHA,92,13,21,34
KITUI,IKUTHA,93,16,30,46
KITUI,IKUTHA,94,13,23,36
KITUI,IKUTHA,90-94,86,200,286
KITUI,IKUTHA,95,9,16,25
KITUI,IKUTHA,96,3,11,14
KITUI,IKUTHA,97,8,10,18
KITUI,IKUTHA,98,2,5,7
KITUI,IKUTHA,99,15,22,37
KITUI,IKUTHA,95-99,37,64,101
KITUI,IKUTHA,100+,18,37,55
KITUI,IKUTHA,Not Stated,2,-,2
KITUI,KATULANI,Total,23150,23957,47107
KITUI,KATULANI,0,369,404,773
KITUI,KATULANI,1,473,475,948
KITUI,KATULANI,2,441,424,865
KITUI,KATULANI,3,452,470,922
KITUI,KATULANI,4,463,442,905
KITUI,KATULANI,0 - 4,2198,2215,4413
KITUI,KATULANI,5,511,410,921
KITUI,KATULANI,6,463,445,908
KITUI,KATULANI,7,486,454,940
KITUI,KATULANI,8,503,498,1001
KITUI,KATULANI,9,584,514,1098
KITUI,KATULANI,05-Sep,2547,2321,4868
KITUI,KATULANI,10,634,626,1260
KITUI,KATULANI,11,650,672,1322
KITUI,KATULANI,12,718,721,1439
KITUI,KATULANI,13,656,690,1346
KITUI,KATULANI,14,740,681,1421
KITUI,KATULANI,Oct-14,3398,3390,6788
KITUI,KATULANI,15,678,671,1349
KITUI,KATULANI,16,719,682,1401
KITUI,KATULANI,17,720,643,1363
KITUI,KATULANI,18,528,453,981
KITUI,KATULANI,19,625,527,1152
KITUI,KATULANI,15-19,3270,2976,6246
KITUI,KATULANI,20,526,446,972
KITUI,KATULANI,21,428,341,769
KITUI,KATULANI,22,383,279,662
KITUI,KATULANI,23,363,328,691
KITUI,KATULANI,24,307,309,616
KITUI,KATULANI,20-24,2007,1703,3710
KITUI,KATULANI,25,368,309,677
KITUI,KATULANI,26,270,276,546
KITUI,KATULANI,27,279,279,558
KITUI,KATULANI,28,211,232,443
KITUI,KATULANI,29,284,273,557
KITUI,KATULANI,25-29,1412,1369,2781
KITUI,KATULANI,30,310,306,616
KITUI,KATULANI,31,239,251,490
KITUI,KATULANI,32,307,357,664
KITUI,KATULANI,33,264,330,594
KITUI,KATULANI,34,230,290,520
KITUI,KATULANI,30-34,1350,1534,2884
KITUI,KATULANI,35,311,375,686
KITUI,KATULANI,36,209,268,477
KITUI,KATULANI,37,272,279,551
KITUI,KATULANI,38,188,238,426
KITUI,KATULANI,39,272,300,572
KITUI,KATULANI,35-39,1252,1460,2712
KITUI,KATULANI,40,281,294,575
KITUI,KATULANI,41,260,280,540
KITUI,KATULANI,42,219,246,465
KITUI,KATULANI,43,204,245,449
KITUI,KATULANI,44,210,261,471
KITUI,KATULANI,40-44,1174,1326,2500
KITUI,KATULANI,45,334,340,674
KITUI,KATULANI,46,185,207,392
KITUI,KATULANI,47,209,229,438
KITUI,KATULANI,48,145,167,312
KITUI,KATULANI,49,218,222,440
KITUI,KATULANI,45-49,1091,1165,2256
KITUI,KATULANI,50,187,242,429
KITUI,KATULANI,51,177,212,389
KITUI,KATULANI,52,141,164,305
KITUI,KATULANI,53,117,134,251
KITUI,KATULANI,54,131,142,273
KITUI,KATULANI,50-54,753,894,1647
KITUI,KATULANI,55,174,144,318
KITUI,KATULANI,56,145,170,315
KITUI,KATULANI,57,128,149,277
KITUI,KATULANI,58,84,140,224
KITUI,KATULANI,59,132,187,319
KITUI,KATULANI,55-59,663,790,1453
KITUI,KATULANI,60,159,203,362
KITUI,KATULANI,61,94,145,239
KITUI,KATULANI,62,97,99,196
KITUI,KATULANI,63,118,102,220
KITUI,KATULANI,64,92,79,171
KITUI,KATULANI,60-64,560,628,1188
KITUI,KATULANI,65,106,123,229
KITUI,KATULANI,66,75,77,152
KITUI,KATULANI,67,138,164,302
KITUI,KATULANI,68,74,77,151
KITUI,KATULANI,69,104,162,266
KITUI,KATULANI,65-69,497,603,1100
KITUI,KATULANI,70,123,194,317
KITUI,KATULANI,71,75,121,196
KITUI,KATULANI,72,59,58,117
KITUI,KATULANI,73,67,136,203
KITUI,KATULANI,74,39,73,112
KITUI,KATULANI,70-74,363,582,945
KITUI,KATULANI,75,55,65,120
KITUI,KATULANI,76,40,48,88
KITUI,KATULANI,77,52,65,117
KITUI,KATULANI,78,39,43,82
KITUI,KATULANI,79,41,116,157
KITUI,KATULANI,75-79,227,337,564
KITUI,KATULANI,80,65,98,163
KITUI,KATULANI,81,37,55,92
KITUI,KATULANI,82,35,18,53
KITUI,KATULANI,83,32,64,96
KITUI,KATULANI,84,35,63,98
KITUI,KATULANI,80-84,204,298,502
KITUI,KATULANI,85,22,36,58
KITUI,KATULANI,86,18,12,30
KITUI,KATULANI,87,10,22,32
KITUI,KATULANI,88,9,13,22
KITUI,KATULANI,89,23,70,93
KITUI,KATULANI,85-89,82,153,235
KITUI,KATULANI,90,18,33,51
KITUI,KATULANI,91,14,67,81
KITUI,KATULANI,92,11,10,21
KITUI,KATULANI,93,6,16,22
KITUI,KATULANI,94,5,7,12
KITUI,KATULANI,90-94,54,133,187
KITUI,KATULANI,95,5,18,23
KITUI,KATULANI,96,7,8,15
KITUI,KATULANI,97,6,8,14
KITUI,KATULANI,98,8,7,15
KITUI,KATULANI,99,4,18,22
KITUI,KATULANI,95-99,30,59,89
KITUI,KATULANI,100+,18,21,39
KITUI,KATULANI,Not Stated,-,-,-
KITUI,KISASI,Total,22646,23496,46142
KITUI,KISASI,0,392,343,735
KITUI,KISASI,1,561,539,1100
KITUI,KISASI,2,472,470,942
KITUI,KISASI,3,505,493,998
KITUI,KISASI,4,506,491,997
KITUI,KISASI,0 - 4,2436,2336,4772
KITUI,KISASI,5,550,554,1104
KITUI,KISASI,6,458,465,923
KITUI,KISASI,7,505,440,945
KITUI,KISASI,8,535,568,1103
KITUI,KISASI,9,606,586,1192
KITUI,KISASI,05-Sep,2654,2613,5267
KITUI,KISASI,10,675,642,1317
KITUI,KISASI,11,719,632,1351
KITUI,KISASI,12,727,659,1386
KITUI,KISASI,13,722,699,1421
KITUI,KISASI,14,701,720,1421
KITUI,KISASI,Oct-14,3544,3352,6896
KITUI,KISASI,15,752,692,1444
KITUI,KISASI,16,756,699,1455
KITUI,KISASI,17,733,687,1420
KITUI,KISASI,18,605,494,1099
KITUI,KISASI,19,595,531,1126
KITUI,KISASI,15-19,3441,3103,6544
KITUI,KISASI,20,469,452,921
KITUI,KISASI,21,352,330,682
KITUI,KISASI,22,340,323,663
KITUI,KISASI,23,339,350,689
KITUI,KISASI,24,308,296,604
KITUI,KISASI,20-24,1808,1751,3559
KITUI,KISASI,25,308,302,610
KITUI,KISASI,26,285,252,537
KITUI,KISASI,27,246,218,464
KITUI,KISASI,28,194,233,427
KITUI,KISASI,29,240,290,530
KITUI,KISASI,25-29,1273,1295,2568
KITUI,KISASI,30,331,363,694
KITUI,KISASI,31,259,268,527
KITUI,KISASI,32,289,340,629
KITUI,KISASI,33,243,306,549
KITUI,KISASI,34,226,264,490
KITUI,KISASI,30-34,1348,1541,2889
KITUI,KISASI,35,270,363,633
KITUI,KISASI,36,195,230,425
KITUI,KISASI,37,228,241,469
KITUI,KISASI,38,156,182,338
KITUI,KISASI,39,240,293,533
KITUI,KISASI,35-39,1089,1309,2398
KITUI,KISASI,40,247,231,478
KITUI,KISASI,41,242,238,480
KITUI,KISASI,42,203,217,420
KITUI,KISASI,43,191,216,407
KITUI,KISASI,44,160,255,415
KITUI,KISASI,40-44,1043,1157,2200
KITUI,KISASI,45,263,308,571
KITUI,KISASI,46,189,211,400
KITUI,KISASI,47,184,193,377
KITUI,KISASI,48,130,131,261
KITUI,KISASI,49,179,176,355
KITUI,KISASI,45-49,945,1019,1964
KITUI,KISASI,50,156,169,325
KITUI,KISASI,51,180,189,369
KITUI,KISASI,52,104,130,234
KITUI,KISASI,53,110,109,219
KITUI,KISASI,54,124,121,245
KITUI,KISASI,50-54,674,718,1392
KITUI,KISASI,55,155,136,291
KITUI,KISASI,56,154,165,319
KITUI,KISASI,57,117,126,243
KITUI,KISASI,58,76,117,193
KITUI,KISASI,59,122,190,312
KITUI,KISASI,55-59,624,734,1358
KITUI,KISASI,60,116,144,260
KITUI,KISASI,61,99,131,230
KITUI,KISASI,62,93,88,181
KITUI,KISASI,63,96,106,202
KITUI,KISASI,64,62,56,118
KITUI,KISASI,60-64,466,525,991
KITUI,KISASI,65,104,128,232
KITUI,KISASI,66,87,69,156
KITUI,KISASI,67,132,159,291
KITUI,KISASI,68,50,80,130
KITUI,KISASI,69,69,147,216
KITUI,KISASI,65-69,442,583,1025
KITUI,KISASI,70,101,148,249
KITUI,KISASI,71,70,76,146
KITUI,KISASI,72,47,55,102
KITUI,KISASI,73,73,181,254
KITUI,KISASI,74,52,97,149
KITUI,KISASI,70-74,343,557,900
KITUI,KISASI,75,48,83,131
KITUI,KISASI,76,26,58,84
KITUI,KISASI,77,38,52,90
KITUI,KISASI,78,22,41,63
KITUI,KISASI,79,37,89,126
KITUI,KISASI,75-79,171,323,494
KITUI,KISASI,80,44,113,157
KITUI,KISASI,81,27,46,73
KITUI,KISASI,82,27,22,49
KITUI,KISASI,83,27,39,66
KITUI,KISASI,84,32,68,100
KITUI,KISASI,80-84,157,288,445
KITUI,KISASI,85,24,23,47
KITUI,KISASI,86,17,12,29
KITUI,KISASI,87,12,12,24
KITUI,KISASI,88,10,7,17
KITUI,KISASI,89,25,44,69
KITUI,KISASI,85-89,88,98,186
KITUI,KISASI,90,24,39,63
KITUI,KISASI,91,20,62,82
KITUI,KISASI,92,7,11,18
KITUI,KISASI,93,8,14,22
KITUI,KISASI,94,8,5,13
KITUI,KISASI,90-94,67,131,198
KITUI,KISASI,95,6,13,19
KITUI,KISASI,96,4,1,5
KITUI,KISASI,97,7,3,10
KITUI,KISASI,98,1,3,4
KITUI,KISASI,99,5,9,14
KITUI,KISASI,95-99,23,29,52
KITUI,KISASI,100+,10,33,43
KITUI,KISASI,Not Stated,-,1,1
KITUI,KITUI CENTRAL,Total,52123,53863,105986
KITUI,KITUI CENTRAL,0,1059,1064,2123
KITUI,KITUI CENTRAL,1,1216,1203,2419
KITUI,KITUI CENTRAL,2,1128,1099,2227
KITUI,KITUI CENTRAL,3,1200,1132,2332
KITUI,KITUI CENTRAL,4,1130,1077,2207
KITUI,KITUI CENTRAL,0 - 4,5733,5575,11308
KITUI,KITUI CENTRAL,5,1119,1100,2219
KITUI,KITUI CENTRAL,6,1113,1056,2169
KITUI,KITUI CENTRAL,7,1128,1097,2225
KITUI,KITUI CENTRAL,8,1112,1145,2257
KITUI,KITUI CENTRAL,9,1214,1204,2418
KITUI,KITUI CENTRAL,05-Sep,5686,5602,11288
KITUI,KITUI CENTRAL,10,1291,1177,2468
KITUI,KITUI CENTRAL,11,1214,1280,2494
KITUI,KITUI CENTRAL,12,1331,1265,2596
KITUI,KITUI CENTRAL,13,1302,1333,2635
KITUI,KITUI CENTRAL,14,1219,1255,2474
KITUI,KITUI CENTRAL,Oct-14,6357,6310,12667
KITUI,KITUI CENTRAL,15,1275,1228,2503
KITUI,KITUI CENTRAL,16,1204,1202,2406
KITUI,KITUI CENTRAL,17,1250,1184,2434
KITUI,KITUI CENTRAL,18,1033,1004,2037
KITUI,KITUI CENTRAL,19,1250,1125,2375
KITUI,KITUI CENTRAL,15-19,6012,5743,11755
KITUI,KITUI CENTRAL,20,1106,1183,2289
KITUI,KITUI CENTRAL,21,1021,1149,2170
KITUI,KITUI CENTRAL,22,982,1108,2090
KITUI,KITUI CENTRAL,23,1038,1216,2254
KITUI,KITUI CENTRAL,24,974,1057,2031
KITUI,KITUI CENTRAL,20-24,5121,5713,10834
KITUI,KITUI CENTRAL,25,1053,1080,2133
KITUI,KITUI CENTRAL,26,823,904,1727
KITUI,KITUI CENTRAL,27,948,923,1871
KITUI,KITUI CENTRAL,28,753,805,1558
KITUI,KITUI CENTRAL,29,873,904,1777
KITUI,KITUI CENTRAL,25-29,4450,4616,9066
KITUI,KITUI CENTRAL,30,1020,1063,2083
KITUI,KITUI CENTRAL,31,721,709,1430
KITUI,KITUI CENTRAL,32,864,897,1761
KITUI,KITUI CENTRAL,33,735,765,1500
KITUI,KITUI CENTRAL,34,698,693,1391
KITUI,KITUI CENTRAL,30-34,4038,4127,8165
KITUI,KITUI CENTRAL,35,808,830,1638
KITUI,KITUI CENTRAL,36,597,623,1220
KITUI,KITUI CENTRAL,37,646,618,1264
KITUI,KITUI CENTRAL,38,524,548,1072
KITUI,KITUI CENTRAL,39,598,575,1173
KITUI,KITUI CENTRAL,35-39,3173,3194,6367
KITUI,KITUI CENTRAL,40,659,705,1364
KITUI,KITUI CENTRAL,41,647,567,1214
KITUI,KITUI CENTRAL,42,542,558,1100
KITUI,KITUI CENTRAL,43,486,482,968
KITUI,KITUI CENTRAL,44,445,516,961
KITUI,KITUI CENTRAL,40-44,2779,2828,5607
KITUI,KITUI CENTRAL,45,610,678,1288
KITUI,KITUI CENTRAL,46,431,433,864
KITUI,KITUI CENTRAL,47,437,465,902
KITUI,KITUI CENTRAL,48,295,353,648
KITUI,KITUI CENTRAL,49,449,479,928
KITUI,KITUI CENTRAL,45-49,2222,2408,4630
KITUI,KITUI CENTRAL,50,417,512,929
KITUI,KITUI CENTRAL,51,376,349,725
KITUI,KITUI CENTRAL,52,320,305,625
KITUI,KITUI CENTRAL,53,204,225,429
KITUI,KITUI CENTRAL,54,330,326,656
KITUI,KITUI CENTRAL,50-54,1647,1717,3364
KITUI,KITUI CENTRAL,55,363,310,673
KITUI,KITUI CENTRAL,56,345,370,715
KITUI,KITUI CENTRAL,57,289,284,573
KITUI,KITUI CENTRAL,58,185,257,442
KITUI,KITUI CENTRAL,59,249,314,563
KITUI,KITUI CENTRAL,55-59,1431,1535,2966
KITUI,KITUI CENTRAL,60,311,338,649
KITUI,KITUI CENTRAL,61,258,260,518
KITUI,KITUI CENTRAL,62,199,185,384
KITUI,KITUI CENTRAL,63,173,206,379
KITUI,KITUI CENTRAL,64,153,157,310
KITUI,KITUI CENTRAL,60-64,1094,1146,2240
KITUI,KITUI CENTRAL,65,230,247,477
KITUI,KITUI CENTRAL,66,138,143,281
KITUI,KITUI CENTRAL,67,245,261,506
KITUI,KITUI CENTRAL,68,113,136,249
KITUI,KITUI CENTRAL,69,150,212,362
KITUI,KITUI CENTRAL,65-69,876,999,1875
KITUI,KITUI CENTRAL,70,181,313,494
KITUI,KITUI CENTRAL,71,126,146,272
KITUI,KITUI CENTRAL,72,88,128,216
KITUI,KITUI CENTRAL,73,110,180,290
KITUI,KITUI CENTRAL,74,99,176,275
KITUI,KITUI CENTRAL,70-74,604,943,1547
KITUI,KITUI CENTRAL,75,95,115,210
KITUI,KITUI CENTRAL,76,46,71,117
KITUI,KITUI CENTRAL,77,81,87,168
KITUI,KITUI CENTRAL,78,64,45,109
KITUI,KITUI CENTRAL,79,56,149,205
KITUI,KITUI CENTRAL,75-79,342,467,809
KITUI,KITUI CENTRAL,80,74,153,227
KITUI,KITUI CENTRAL,81,42,62,104
KITUI,KITUI CENTRAL,82,41,33,74
KITUI,KITUI CENTRAL,83,49,52,101
KITUI,KITUI CENTRAL,84,48,55,103
KITUI,KITUI CENTRAL,80-84,254,355,609
KITUI,KITUI CENTRAL,85,44,58,102
KITUI,KITUI CENTRAL,86,24,34,58
KITUI,KITUI CENTRAL,87,23,48,71
KITUI,KITUI CENTRAL,88,14,15,29
KITUI,KITUI CENTRAL,89,40,89,129
KITUI,KITUI CENTRAL,85-89,145,244,389
KITUI,KITUI CENTRAL,90,36,102,138
KITUI,KITUI CENTRAL,91,25,66,91
KITUI,KITUI CENTRAL,92,21,19,40
KITUI,KITUI CENTRAL,93,11,16,27
KITUI,KITUI CENTRAL,94,7,16,23
KITUI,KITUI CENTRAL,90-94,100,219,319
KITUI,KITUI CENTRAL,95,12,23,35
KITUI,KITUI CENTRAL,96,1,6,7
KITUI,KITUI CENTRAL,97,9,8,17
KITUI,KITUI CENTRAL,98,6,11,17
KITUI,KITUI CENTRAL,99,9,24,33
KITUI,KITUI CENTRAL,95-99,37,72,109
KITUI,KITUI CENTRAL,100+,21,49,70
KITUI,KITUI CENTRAL,Not Stated,1,1,2
KITUI,KITUI WEST,Total,33887,36983,70870
KITUI,KITUI WEST,0,738,716,1454
KITUI,KITUI WEST,1,717,710,1427
KITUI,KITUI WEST,2,772,798,1570
KITUI,KITUI WEST,3,758,787,1545
KITUI,KITUI WEST,4,749,817,1566
KITUI,KITUI WEST,0 - 4,3734,3828,7562
KITUI,KITUI WEST,5,760,784,1544
KITUI,KITUI WEST,6,858,780,1638
KITUI,KITUI WEST,7,856,754,1610
KITUI,KITUI WEST,8,864,862,1726
KITUI,KITUI WEST,9,909,875,1784
KITUI,KITUI WEST,05-Sep,4247,4055,8302
KITUI,KITUI WEST,10,951,940,1891
KITUI,KITUI WEST,11,982,993,1975
KITUI,KITUI WEST,12,1024,986,2010
KITUI,KITUI WEST,13,1008,976,1984
KITUI,KITUI WEST,14,1065,965,2030
KITUI,KITUI WEST,Oct-14,5030,4860,9890
KITUI,KITUI WEST,15,1038,940,1978
KITUI,KITUI WEST,16,961,967,1928
KITUI,KITUI WEST,17,1016,930,1946
KITUI,KITUI WEST,18,825,756,1581
KITUI,KITUI WEST,19,778,765,1543
KITUI,KITUI WEST,15-19,4618,4358,8976
KITUI,KITUI WEST,20,716,617,1333
KITUI,KITUI WEST,21,629,583,1212
KITUI,KITUI WEST,22,451,512,963
KITUI,KITUI WEST,23,517,566,1083
KITUI,KITUI WEST,24,385,470,855
KITUI,KITUI WEST,20-24,2698,2748,5446
KITUI,KITUI WEST,25,459,538,997
KITUI,KITUI WEST,26,333,421,754
KITUI,KITUI WEST,27,399,467,866
KITUI,KITUI WEST,28,375,419,794
KITUI,KITUI WEST,29,423,493,916
KITUI,KITUI WEST,25-29,1989,2338,4327
KITUI,KITUI WEST,30,455,608,1063
KITUI,KITUI WEST,31,349,402,751
KITUI,KITUI WEST,32,434,549,983
KITUI,KITUI WEST,33,397,476,873
KITUI,KITUI WEST,34,345,444,789
KITUI,KITUI WEST,30-34,1980,2479,4459
KITUI,KITUI WEST,35,476,586,1062
KITUI,KITUI WEST,36,339,408,747
KITUI,KITUI WEST,37,410,456,866
KITUI,KITUI WEST,38,243,317,560
KITUI,KITUI WEST,39,384,411,795
KITUI,KITUI WEST,35-39,1852,2178,4030
KITUI,KITUI WEST,40,351,389,740
KITUI,KITUI WEST,41,339,383,722
KITUI,KITUI WEST,42,284,360,644
KITUI,KITUI WEST,43,288,380,668
KITUI,KITUI WEST,44,290,376,666
KITUI,KITUI WEST,40-44,1552,1888,3440
KITUI,KITUI WEST,45,350,496,846
KITUI,KITUI WEST,46,282,398,680
KITUI,KITUI WEST,47,269,346,615
KITUI,KITUI WEST,48,209,255,464
KITUI,KITUI WEST,49,288,357,645
KITUI,KITUI WEST,45-49,1398,1852,3250
KITUI,KITUI WEST,50,214,406,620
KITUI,KITUI WEST,51,239,326,565
KITUI,KITUI WEST,52,218,233,451
KITUI,KITUI WEST,53,141,175,316
KITUI,KITUI WEST,54,212,222,434
KITUI,KITUI WEST,50-54,1024,1362,2386
KITUI,KITUI WEST,55,211,248,459
KITUI,KITUI WEST,56,237,242,479
KITUI,KITUI WEST,57,165,259,424
KITUI,KITUI WEST,58,137,180,317
KITUI,KITUI WEST,59,181,243,424
KITUI,KITUI WEST,55-59,931,1172,2103
KITUI,KITUI WEST,60,246,275,521
KITUI,KITUI WEST,61,190,204,394
KITUI,KITUI WEST,62,172,193,365
KITUI,KITUI WEST,63,133,176,309
KITUI,KITUI WEST,64,115,122,237
KITUI,KITUI WEST,60-64,856,970,1826
KITUI,KITUI WEST,65,144,218,362
KITUI,KITUI WEST,66,120,125,245
KITUI,KITUI WEST,67,201,211,412
KITUI,KITUI WEST,68,93,118,211
KITUI,KITUI WEST,69,145,204,349
KITUI,KITUI WEST,65-69,703,876,1579
KITUI,KITUI WEST,70,151,305,456
KITUI,KITUI WEST,71,115,136,251
KITUI,KITUI WEST,72,91,104,195
KITUI,KITUI WEST,73,83,111,194
KITUI,KITUI WEST,74,68,121,189
KITUI,KITUI WEST,70-74,508,777,1285
KITUI,KITUI WEST,75,69,75,144
KITUI,KITUI WEST,76,54,60,114
KITUI,KITUI WEST,77,67,80,147
KITUI,KITUI WEST,78,56,48,104
KITUI,KITUI WEST,79,59,131,190
KITUI,KITUI WEST,75-79,305,394,699
KITUI,KITUI WEST,80,77,147,224
KITUI,KITUI WEST,81,43,74,117
KITUI,KITUI WEST,82,31,36,67
KITUI,KITUI WEST,83,54,52,106
KITUI,KITUI WEST,84,30,68,98
KITUI,KITUI WEST,80-84,235,377,612
KITUI,KITUI WEST,85,22,38,60
KITUI,KITUI WEST,86,18,19,37
KITUI,KITUI WEST,87,27,42,69
KITUI,KITUI WEST,88,6,20,26
KITUI,KITUI WEST,89,26,77,103
KITUI,KITUI WEST,85-89,99,196,295
KITUI,KITUI WEST,90,37,81,118
KITUI,KITUI WEST,91,15,49,64
KITUI,KITUI WEST,92,8,19,27
KITUI,KITUI WEST,93,4,10,14
KITUI,KITUI WEST,94,12,15,27
KITUI,KITUI WEST,90-94,76,174,250
KITUI,KITUI WEST,95,6,19,25
KITUI,KITUI WEST,96,7,8,15
KITUI,KITUI WEST,97,7,5,12
KITUI,KITUI WEST,98,3,7,10
KITUI,KITUI WEST,99,12,22,34
KITUI,KITUI WEST,95-99,35,61,96
KITUI,KITUI WEST,100+,17,40,57
KITUI,KITUI WEST,Not Stated,-,-,-
KITUI,KYUSO,Total,36789,40077,76866
KITUI,KYUSO,0,820,830,1650
KITUI,KYUSO,1,948,883,1831
KITUI,KYUSO,2,961,985,1946
KITUI,KYUSO,3,1056,1019,2075
KITUI,KYUSO,4,1016,1016,2032
KITUI,KYUSO,0 - 4,4801,4733,9534
KITUI,KYUSO,5,1154,1069,2223
KITUI,KYUSO,6,1104,1101,2205
KITUI,KYUSO,7,964,980,1944
KITUI,KYUSO,8,1185,1125,2310
KITUI,KYUSO,9,1124,1116,2240
KITUI,KYUSO,05-Sep,5531,5391,10922
KITUI,KYUSO,10,1159,1150,2309
KITUI,KYUSO,11,1311,1296,2607
KITUI,KYUSO,12,1307,1231,2538
KITUI,KYUSO,13,1258,1315,2573
KITUI,KYUSO,14,1275,1290,2565
KITUI,KYUSO,Oct-14,6310,6282,12592
KITUI,KYUSO,15,1262,1183,2445
KITUI,KYUSO,16,1166,1192,2358
KITUI,KYUSO,17,1088,1056,2144
KITUI,KYUSO,18,838,811,1649
KITUI,KYUSO,19,829,816,1645
KITUI,KYUSO,15-19,5183,5058,10241
KITUI,KYUSO,20,739,739,1478
KITUI,KYUSO,21,608,631,1239
KITUI,KYUSO,22,465,599,1064
KITUI,KYUSO,23,437,630,1067
KITUI,KYUSO,24,414,501,915
KITUI,KYUSO,20-24,2663,3100,5763
KITUI,KYUSO,25,475,560,1035
KITUI,KYUSO,26,341,424,765
KITUI,KYUSO,27,356,440,796
KITUI,KYUSO,28,281,411,692
KITUI,KYUSO,29,352,471,823
KITUI,KYUSO,25-29,1805,2306,4111
KITUI,KYUSO,30,375,587,962
KITUI,KYUSO,31,335,473,808
KITUI,KYUSO,32,347,518,865
KITUI,KYUSO,33,346,536,882
KITUI,KYUSO,34,281,479,760
KITUI,KYUSO,30-34,1684,2593,4277
KITUI,KYUSO,35,427,565,992
KITUI,KYUSO,36,274,306,580
KITUI,KYUSO,37,348,324,672
KITUI,KYUSO,38,213,243,456
KITUI,KYUSO,39,310,350,660
KITUI,KYUSO,35-39,1572,1788,3360
KITUI,KYUSO,40,301,301,602
KITUI,KYUSO,41,337,329,666
KITUI,KYUSO,42,262,301,563
KITUI,KYUSO,43,244,353,597
KITUI,KYUSO,44,276,350,626
KITUI,KYUSO,40-44,1420,1634,3054
KITUI,KYUSO,45,416,480,896
KITUI,KYUSO,46,268,307,575
KITUI,KYUSO,47,255,300,555
KITUI,KYUSO,48,196,213,409
KITUI,KYUSO,49,244,297,541
KITUI,KYUSO,45-49,1379,1597,2976
KITUI,KYUSO,50,247,257,504
KITUI,KYUSO,51,176,276,452
KITUI,KYUSO,52,193,200,393
KITUI,KYUSO,53,125,169,294
KITUI,KYUSO,54,153,195,348
KITUI,KYUSO,50-54,894,1097,1991
KITUI,KYUSO,55,210,200,410
KITUI,KYUSO,56,200,247,447
KITUI,KYUSO,57,173,165,338
KITUI,KYUSO,58,100,157,257
KITUI,KYUSO,59,161,236,397
KITUI,KYUSO,55-59,844,1005,1849
KITUI,KYUSO,60,195,266,461
KITUI,KYUSO,61,148,170,318
KITUI,KYUSO,62,126,137,263
KITUI,KYUSO,63,134,155,289
KITUI,KYUSO,64,123,123,246
KITUI,KYUSO,60-64,726,851,1577
KITUI,KYUSO,65,176,205,381
KITUI,KYUSO,66,117,89,206
KITUI,KYUSO,67,171,200,371
KITUI,KYUSO,68,90,107,197
KITUI,KYUSO,69,138,246,384
KITUI,KYUSO,65-69,692,847,1539
KITUI,KYUSO,70,151,309,460
KITUI,KYUSO,71,106,132,238
KITUI,KYUSO,72,65,97,162
KITUI,KYUSO,73,82,83,165
KITUI,KYUSO,74,73,131,204
KITUI,KYUSO,70-74,477,752,1229
KITUI,KYUSO,75,79,86,165
KITUI,KYUSO,76,51,61,112
KITUI,KYUSO,77,63,55,118
KITUI,KYUSO,78,49,49,98
KITUI,KYUSO,79,61,122,183
KITUI,KYUSO,75-79,303,373,676
KITUI,KYUSO,80,80,153,233
KITUI,KYUSO,81,45,60,105
KITUI,KYUSO,82,35,36,71
KITUI,KYUSO,83,40,35,75
KITUI,KYUSO,84,37,56,93
KITUI,KYUSO,80-84,237,340,577
KITUI,KYUSO,85,25,41,66
KITUI,KYUSO,86,20,10,30
KITUI,KYUSO,87,31,28,59
KITUI,KYUSO,88,16,16,32
KITUI,KYUSO,89,45,61,106
KITUI,KYUSO,85-89,137,156,293
KITUI,KYUSO,90,28,42,70
KITUI,KYUSO,91,15,20,35
KITUI,KYUSO,92,9,14,23
KITUI,KYUSO,93,9,11,20
KITUI,KYUSO,94,7,9,16
KITUI,KYUSO,90-94,68,96,164
KITUI,KYUSO,95,11,15,26
KITUI,KYUSO,96,4,5,9
KITUI,KYUSO,97,8,1,9
KITUI,KYUSO,98,4,11,15
KITUI,KYUSO,99,16,20,36
KITUI,KYUSO,95-99,43,52,95
KITUI,KYUSO,100+,20,25,45
KITUI,KYUSO,Not Stated,-,1,1
KITUI,LOWER YATTA,Total,31701,31628,63329
KITUI,LOWER YATTA,0,573,594,1167
KITUI,LOWER YATTA,1,631,623,1254
KITUI,LOWER YATTA,2,680,661,1341
KITUI,LOWER YATTA,3,647,660,1307
KITUI,LOWER YATTA,4,618,620,1238
KITUI,LOWER YATTA,0 - 4,3149,3158,6307
KITUI,LOWER YATTA,5,677,641,1318
KITUI,LOWER YATTA,6,665,570,1235
KITUI,LOWER YATTA,7,699,654,1353
KITUI,LOWER YATTA,8,753,795,1548
KITUI,LOWER YATTA,9,837,822,1659
KITUI,LOWER YATTA,05-Sep,3631,3482,7113
KITUI,LOWER YATTA,10,908,853,1761
KITUI,LOWER YATTA,11,962,936,1898
KITUI,LOWER YATTA,12,1010,937,1947
KITUI,LOWER YATTA,13,1038,955,1993
KITUI,LOWER YATTA,14,1018,947,1965
KITUI,LOWER YATTA,Oct-14,4936,4628,9564
KITUI,LOWER YATTA,15,1014,950,1964
KITUI,LOWER YATTA,16,934,939,1873
KITUI,LOWER YATTA,17,1007,928,1935
KITUI,LOWER YATTA,18,749,653,1402
KITUI,LOWER YATTA,19,790,698,1488
KITUI,LOWER YATTA,15-19,4494,4168,8662
KITUI,LOWER YATTA,20,723,618,1341
KITUI,LOWER YATTA,21,510,469,979
KITUI,LOWER YATTA,22,421,404,825
KITUI,LOWER YATTA,23,476,478,954
KITUI,LOWER YATTA,24,366,423,789
KITUI,LOWER YATTA,20-24,2496,2392,4888
KITUI,LOWER YATTA,25,501,485,986
KITUI,LOWER YATTA,26,347,360,707
KITUI,LOWER YATTA,27,416,373,789
KITUI,LOWER YATTA,28,361,350,711
KITUI,LOWER YATTA,29,403,383,786
KITUI,LOWER YATTA,25-29,2028,1951,3979
KITUI,LOWER YATTA,30,499,501,1000
KITUI,LOWER YATTA,31,341,323,664
KITUI,LOWER YATTA,32,494,483,977
KITUI,LOWER YATTA,33,438,418,856
KITUI,LOWER YATTA,34,363,385,748
KITUI,LOWER YATTA,30-34,2135,2110,4245
KITUI,LOWER YATTA,35,493,463,956
KITUI,LOWER YATTA,36,308,327,635
KITUI,LOWER YATTA,37,344,322,666
KITUI,LOWER YATTA,38,223,249,472
KITUI,LOWER YATTA,39,349,346,695
KITUI,LOWER YATTA,35-39,1717,1707,3424
KITUI,LOWER YATTA,40,369,353,722
KITUI,LOWER YATTA,41,383,339,722
KITUI,LOWER YATTA,42,292,306,598
KITUI,LOWER YATTA,43,265,327,592
KITUI,LOWER YATTA,44,223,305,528
KITUI,LOWER YATTA,40-44,1532,1630,3162
KITUI,LOWER YATTA,45,392,374,766
KITUI,LOWER YATTA,46,235,249,484
KITUI,LOWER YATTA,47,266,286,552
KITUI,LOWER YATTA,48,192,180,372
KITUI,LOWER YATTA,49,295,277,572
KITUI,LOWER YATTA,45-49,1380,1366,2746
KITUI,LOWER YATTA,50,253,284,537
KITUI,LOWER YATTA,51,233,265,498
KITUI,LOWER YATTA,52,191,187,378
KITUI,LOWER YATTA,53,138,131,269
KITUI,LOWER YATTA,54,175,162,337
KITUI,LOWER YATTA,50-54,990,1029,2019
KITUI,LOWER YATTA,55,191,205,396
KITUI,LOWER YATTA,56,201,222,423
KITUI,LOWER YATTA,57,179,160,339
KITUI,LOWER YATTA,58,111,138,249
KITUI,LOWER YATTA,59,146,201,347
KITUI,LOWER YATTA,55-59,828,926,1754
KITUI,LOWER YATTA,60,185,205,390
KITUI,LOWER YATTA,61,142,157,299
KITUI,LOWER YATTA,62,127,125,252
KITUI,LOWER YATTA,63,131,114,245
KITUI,LOWER YATTA,64,88,76,164
KITUI,LOWER YATTA,60-64,673,677,1350
KITUI,LOWER YATTA,65,146,141,287
KITUI,LOWER YATTA,66,99,107,206
KITUI,LOWER YATTA,67,190,228,418
KITUI,LOWER YATTA,68,71,88,159
KITUI,LOWER YATTA,69,109,249,358
KITUI,LOWER YATTA,65-69,615,813,1428
KITUI,LOWER YATTA,70,134,185,319
KITUI,LOWER YATTA,71,97,147,244
KITUI,LOWER YATTA,72,69,66,135
KITUI,LOWER YATTA,73,73,148,221
KITUI,LOWER YATTA,74,62,102,164
KITUI,LOWER YATTA,70-74,435,648,1083
KITUI,LOWER YATTA,75,44,71,115
KITUI,LOWER YATTA,76,43,45,88
KITUI,LOWER YATTA,77,55,68,123
KITUI,LOWER YATTA,78,50,30,80
KITUI,LOWER YATTA,79,51,60,111
KITUI,LOWER YATTA,75-79,243,274,517
KITUI,LOWER YATTA,80,56,92,148
KITUI,LOWER YATTA,81,27,37,64
KITUI,LOWER YATTA,82,25,27,52
KITUI,LOWER YATTA,83,37,47,84
KITUI,LOWER YATTA,84,30,45,75
KITUI,LOWER YATTA,80-84,175,248,423
KITUI,LOWER YATTA,85,16,28,44
KITUI,LOWER YATTA,86,19,17,36
KITUI,LOWER YATTA,87,25,20,45
KITUI,LOWER YATTA,88,11,8,19
KITUI,LOWER YATTA,89,27,58,85
KITUI,LOWER YATTA,85-89,98,131,229
KITUI,LOWER YATTA,90,29,59,88
KITUI,LOWER YATTA,91,31,79,110
KITUI,LOWER YATTA,92,10,37,47
KITUI,LOWER YATTA,93,8,17,25
KITUI,LOWER YATTA,94,7,17,24
KITUI,LOWER YATTA,90-94,85,209,294
KITUI,LOWER YATTA,95,9,24,33
KITUI,LOWER YATTA,96,6,6,12
KITUI,LOWER YATTA,97,10,7,17
KITUI,LOWER YATTA,98,1,6,7
KITUI,LOWER YATTA,99,5,13,18
KITUI,LOWER YATTA,95-99,31,56,87
KITUI,LOWER YATTA,100+,30,25,55
KITUI,LOWER YATTA,Not Stated,-,-,-
KITUI,MATINYANI,Total,23362,24448,47810
KITUI,MATINYANI,0,465,486,951
KITUI,MATINYANI,1,523,543,1066
KITUI,MATINYANI,2,499,508,1007
KITUI,MATINYANI,3,496,487,983
KITUI,MATINYANI,4,520,540,1060
KITUI,MATINYANI,0 - 4,2503,2564,5067
KITUI,MATINYANI,5,543,517,1060
KITUI,MATINYANI,6,540,505,1045
KITUI,MATINYANI,7,492,513,1005
KITUI,MATINYANI,8,585,540,1125
KITUI,MATINYANI,9,592,583,1175
KITUI,MATINYANI,05-Sep,2752,2658,5410
KITUI,MATINYANI,10,596,564,1160
KITUI,MATINYANI,11,638,611,1249
KITUI,MATINYANI,12,693,660,1353
KITUI,MATINYANI,13,705,634,1339
KITUI,MATINYANI,14,682,695,1377
KITUI,MATINYANI,Oct-14,3314,3164,6478
KITUI,MATINYANI,15,720,690,1410
KITUI,MATINYANI,16,644,632,1276
KITUI,MATINYANI,17,664,612,1276
KITUI,MATINYANI,18,516,421,937
KITUI,MATINYANI,19,579,488,1067
KITUI,MATINYANI,15-19,3123,2843,5966
KITUI,MATINYANI,20,482,441,923
KITUI,MATINYANI,21,402,389,791
KITUI,MATINYANI,22,374,343,717
KITUI,MATINYANI,23,382,362,744
KITUI,MATINYANI,24,302,285,587
KITUI,MATINYANI,20-24,1942,1820,3762
KITUI,MATINYANI,25,361,338,699
KITUI,MATINYANI,26,244,283,527
KITUI,MATINYANI,27,307,300,607
KITUI,MATINYANI,28,272,263,535
KITUI,MATINYANI,29,269,336,605
KITUI,MATINYANI,25-29,1453,1520,2973
KITUI,MATINYANI,30,330,376,706
KITUI,MATINYANI,31,280,265,545
KITUI,MATINYANI,32,316,381,697
KITUI,MATINYANI,33,270,315,585
KITUI,MATINYANI,34,234,264,498
KITUI,MATINYANI,30-34,1430,1601,3031
KITUI,MATINYANI,35,330,347,677
KITUI,MATINYANI,36,246,278,524
KITUI,MATINYANI,37,238,244,482
KITUI,MATINYANI,38,210,213,423
KITUI,MATINYANI,39,270,241,511
KITUI,MATINYANI,35-39,1294,1323,2617
KITUI,MATINYANI,40,249,284,533
KITUI,MATINYANI,41,283,267,550
KITUI,MATINYANI,42,200,243,443
KITUI,MATINYANI,43,199,248,447
KITUI,MATINYANI,44,184,211,395
KITUI,MATINYANI,40-44,1115,1253,2368
KITUI,MATINYANI,45,277,292,569
KITUI,MATINYANI,46,196,235,431
KITUI,MATINYANI,47,184,235,419
KITUI,MATINYANI,48,125,191,316
KITUI,MATINYANI,49,179,260,439
KITUI,MATINYANI,45-49,961,1213,2174
KITUI,MATINYANI,50,222,279,501
KITUI,MATINYANI,51,166,185,351
KITUI,MATINYANI,52,119,144,263
KITUI,MATINYANI,53,114,115,229
KITUI,MATINYANI,54,169,155,324
KITUI,MATINYANI,50-54,790,878,1668
KITUI,MATINYANI,55,193,180,373
KITUI,MATINYANI,56,196,206,402
KITUI,MATINYANI,57,116,169,285
KITUI,MATINYANI,58,89,109,198
KITUI,MATINYANI,59,136,171,307
KITUI,MATINYANI,55-59,730,835,1565
KITUI,MATINYANI,60,161,207,368
KITUI,MATINYANI,61,133,163,296
KITUI,MATINYANI,62,114,111,225
KITUI,MATINYANI,63,110,148,258
KITUI,MATINYANI,64,66,74,140
KITUI,MATINYANI,60-64,584,703,1287
KITUI,MATINYANI,65,111,126,237
KITUI,MATINYANI,66,77,70,147
KITUI,MATINYANI,67,124,154,278
KITUI,MATINYANI,68,65,81,146
KITUI,MATINYANI,69,87,156,243
KITUI,MATINYANI,65-69,464,587,1051
KITUI,MATINYANI,70,136,249,385
KITUI,MATINYANI,71,82,143,225
KITUI,MATINYANI,72,57,81,138
KITUI,MATINYANI,73,53,110,163
KITUI,MATINYANI,74,49,90,139
KITUI,MATINYANI,70-74,377,673,1050
KITUI,MATINYANI,75,58,63,121
KITUI,MATINYANI,76,42,39,81
KITUI,MATINYANI,77,47,45,92
KITUI,MATINYANI,78,42,25,67
KITUI,MATINYANI,79,34,71,105
KITUI,MATINYANI,75-79,223,243,466
KITUI,MATINYANI,80,46,87,133
KITUI,MATINYANI,81,31,45,76
KITUI,MATINYANI,82,28,17,45
KITUI,MATINYANI,83,19,26,45
KITUI,MATINYANI,84,24,46,70
KITUI,MATINYANI,80-84,148,221,369
KITUI,MATINYANI,85,16,32,48
KITUI,MATINYANI,86,12,8,20
KITUI,MATINYANI,87,15,28,43
KITUI,MATINYANI,88,6,13,19
KITUI,MATINYANI,89,19,53,72
KITUI,MATINYANI,85-89,68,134,202
KITUI,MATINYANI,90,25,57,82
KITUI,MATINYANI,91,23,68,91
KITUI,MATINYANI,92,3,19,22
KITUI,MATINYANI,93,9,14,23
KITUI,MATINYANI,94,8,10,18
KITUI,MATINYANI,90-94,68,168,236
KITUI,MATINYANI,95,8,21,29
KITUI,MATINYANI,96,2,2,4
KITUI,MATINYANI,97,2,3,5
KITUI,MATINYANI,98,3,6,9
KITUI,MATINYANI,99,-,6,6
KITUI,MATINYANI,95-99,15,38,53
KITUI,MATINYANI,100+,8,9,17
KITUI,MATINYANI,Not Stated,-,-,-
KITUI,MIGWANI,Total,37525,41726,79251
KITUI,MIGWANI,0,833,785,1618
KITUI,MIGWANI,1,941,890,1831
KITUI,MIGWANI,2,891,922,1813
KITUI,MIGWANI,3,877,886,1763
KITUI,MIGWANI,4,936,898,1834
KITUI,MIGWANI,0 - 4,4478,4381,8859
KITUI,MIGWANI,5,930,985,1915
KITUI,MIGWANI,6,955,926,1881
KITUI,MIGWANI,7,891,913,1804
KITUI,MIGWANI,8,981,1007,1988
KITUI,MIGWANI,9,1009,990,1999
KITUI,MIGWANI,05-Sep,4766,4821,9587
KITUI,MIGWANI,10,1179,1028,2207
KITUI,MIGWANI,11,1165,1154,2319
KITUI,MIGWANI,12,1236,1096,2332
KITUI,MIGWANI,13,1145,1120,2265
KITUI,MIGWANI,14,1180,1147,2327
KITUI,MIGWANI,Oct-14,5905,5545,11450
KITUI,MIGWANI,15,1142,1107,2249
KITUI,MIGWANI,16,1108,1128,2236
KITUI,MIGWANI,17,1171,1029,2200
KITUI,MIGWANI,18,891,787,1678
KITUI,MIGWANI,19,906,803,1709
KITUI,MIGWANI,15-19,5218,4854,10072
KITUI,MIGWANI,20,801,755,1556
KITUI,MIGWANI,21,698,642,1340
KITUI,MIGWANI,22,543,633,1176
KITUI,MIGWANI,23,566,652,1218
KITUI,MIGWANI,24,495,629,1124
KITUI,MIGWANI,20-24,3103,3311,6414
KITUI,MIGWANI,25,532,596,1128
KITUI,MIGWANI,26,382,476,858
KITUI,MIGWANI,27,468,543,1011
KITUI,MIGWANI,28,325,490,815
KITUI,MIGWANI,29,432,566,998
KITUI,MIGWANI,25-29,2139,2671,4810
KITUI,MIGWANI,30,443,690,1133
KITUI,MIGWANI,31,399,550,949
KITUI,MIGWANI,32,445,590,1035
KITUI,MIGWANI,33,377,558,935
KITUI,MIGWANI,34,347,495,842
KITUI,MIGWANI,30-34,2011,2883,4894
KITUI,MIGWANI,35,478,606,1084
KITUI,MIGWANI,36,322,413,735
KITUI,MIGWANI,37,410,415,825
KITUI,MIGWANI,38,231,336,567
KITUI,MIGWANI,39,321,437,758
KITUI,MIGWANI,35-39,1762,2207,3969
KITUI,MIGWANI,40,316,471,787
KITUI,MIGWANI,41,375,417,792
KITUI,MIGWANI,42,288,366,654
KITUI,MIGWANI,43,301,397,698
KITUI,MIGWANI,44,291,373,664
KITUI,MIGWANI,40-44,1571,2024,3595
KITUI,MIGWANI,45,367,549,916
KITUI,MIGWANI,46,255,377,632
KITUI,MIGWANI,47,263,405,668
KITUI,MIGWANI,48,171,294,465
KITUI,MIGWANI,49,248,396,644
KITUI,MIGWANI,45-49,1304,2021,3325
KITUI,MIGWANI,50,295,414,709
KITUI,MIGWANI,51,209,375,584
KITUI,MIGWANI,52,180,260,440
KITUI,MIGWANI,53,160,198,358
KITUI,MIGWANI,54,227,261,488
KITUI,MIGWANI,50-54,1071,1508,2579
KITUI,MIGWANI,55,221,298,519
KITUI,MIGWANI,56,277,300,577
KITUI,MIGWANI,57,204,253,457
KITUI,MIGWANI,58,146,187,333
KITUI,MIGWANI,59,208,270,478
KITUI,MIGWANI,55-59,1056,1308,2364
KITUI,MIGWANI,60,260,307,567
KITUI,MIGWANI,61,199,281,480
KITUI,MIGWANI,62,150,180,330
KITUI,MIGWANI,63,174,192,366
KITUI,MIGWANI,64,108,162,270
KITUI,MIGWANI,60-64,891,1122,2013
KITUI,MIGWANI,65,192,228,420
KITUI,MIGWANI,66,151,155,306
KITUI,MIGWANI,67,225,273,498
KITUI,MIGWANI,68,87,115,202
KITUI,MIGWANI,69,137,178,315
KITUI,MIGWANI,65-69,792,949,1741
KITUI,MIGWANI,70,165,320,485
KITUI,MIGWANI,71,118,167,285
KITUI,MIGWANI,72,74,100,174
KITUI,MIGWANI,73,94,98,192
KITUI,MIGWANI,74,73,122,195
KITUI,MIGWANI,70-74,524,807,1331
KITUI,MIGWANI,75,105,109,214
KITUI,MIGWANI,76,36,60,96
KITUI,MIGWANI,77,75,107,182
KITUI,MIGWANI,78,55,46,101
KITUI,MIGWANI,79,72,123,195
KITUI,MIGWANI,75-79,343,445,788
KITUI,MIGWANI,80,81,154,235
KITUI,MIGWANI,81,54,68,122
KITUI,MIGWANI,82,49,32,81
KITUI,MIGWANI,83,44,46,90
KITUI,MIGWANI,84,54,67,121
KITUI,MIGWANI,80-84,282,367,649
KITUI,MIGWANI,85,40,37,77
KITUI,MIGWANI,86,26,19,45
KITUI,MIGWANI,87,30,49,79
KITUI,MIGWANI,88,16,18,34
KITUI,MIGWANI,89,30,81,111
KITUI,MIGWANI,85-89,142,204,346
KITUI,MIGWANI,90,29,82,111
KITUI,MIGWANI,91,11,28,39
KITUI,MIGWANI,92,26,29,55
KITUI,MIGWANI,93,13,14,27
KITUI,MIGWANI,94,11,23,34
KITUI,MIGWANI,90-94,90,176,266
KITUI,MIGWANI,95,12,25,37
KITUI,MIGWANI,96,9,5,14
KITUI,MIGWANI,97,13,4,17
KITUI,MIGWANI,98,7,8,15
KITUI,MIGWANI,99,13,20,33
KITUI,MIGWANI,95-99,54,62,116
KITUI,MIGWANI,100+,23,59,82
KITUI,MIGWANI,Not Stated,-,1,1
KITUI,MUMONI,Total,13748,15596,29344
KITUI,MUMONI,0,311,329,640
KITUI,MUMONI,1,336,332,668
KITUI,MUMONI,2,350,345,695
KITUI,MUMONI,3,408,399,807
KITUI,MUMONI,4,379,355,734
KITUI,MUMONI,0 - 4,1784,1760,3544
KITUI,MUMONI,5,378,421,799
KITUI,MUMONI,6,409,439,848
KITUI,MUMONI,7,340,349,689
KITUI,MUMONI,8,453,426,879
KITUI,MUMONI,9,412,414,826
KITUI,MUMONI,05-Sep,1992,2049,4041
KITUI,MUMONI,10,472,472,944
KITUI,MUMONI,11,469,517,986
KITUI,MUMONI,12,507,478,985
KITUI,MUMONI,13,541,537,1078
KITUI,MUMONI,14,482,511,993
KITUI,MUMONI,Oct-14,2471,2515,4986
KITUI,MUMONI,15,506,512,1018
KITUI,MUMONI,16,467,482,949
KITUI,MUMONI,17,422,424,846
KITUI,MUMONI,18,341,340,681
KITUI,MUMONI,19,291,307,598
KITUI,MUMONI,15-19,2027,2065,4092
KITUI,MUMONI,20,291,302,593
KITUI,MUMONI,21,186,240,426
KITUI,MUMONI,22,174,194,368
KITUI,MUMONI,23,173,223,396
KITUI,MUMONI,24,139,193,332
KITUI,MUMONI,20-24,963,1152,2115
KITUI,MUMONI,25,172,219,391
KITUI,MUMONI,26,105,192,297
KITUI,MUMONI,27,118,168,286
KITUI,MUMONI,28,117,136,253
KITUI,MUMONI,29,119,210,329
KITUI,MUMONI,25-29,631,925,1556
KITUI,MUMONI,30,118,231,349
KITUI,MUMONI,31,125,186,311
KITUI,MUMONI,32,126,195,321
KITUI,MUMONI,33,131,209,340
KITUI,MUMONI,34,102,182,284
KITUI,MUMONI,30-34,602,1003,1605
KITUI,MUMONI,35,165,218,383
KITUI,MUMONI,36,87,131,218
KITUI,MUMONI,37,116,109,225
KITUI,MUMONI,38,93,83,176
KITUI,MUMONI,39,126,120,246
KITUI,MUMONI,35-39,587,661,1248
KITUI,MUMONI,40,107,123,230
KITUI,MUMONI,41,107,129,236
KITUI,MUMONI,42,95,110,205
KITUI,MUMONI,43,87,125,212
KITUI,MUMONI,44,106,120,226
KITUI,MUMONI,40-44,502,607,1109
KITUI,MUMONI,45,135,173,308
KITUI,MUMONI,46,91,117,208
KITUI,MUMONI,47,80,122,202
KITUI,MUMONI,48,66,77,143
KITUI,MUMONI,49,103,115,218
KITUI,MUMONI,45-49,475,604,1079
KITUI,MUMONI,50,75,113,188
KITUI,MUMONI,51,72,123,195
KITUI,MUMONI,52,62,80,142
KITUI,MUMONI,53,62,73,135
KITUI,MUMONI,54,54,81,135
KITUI,MUMONI,50-54,325,470,795
KITUI,MUMONI,55,73,53,126
KITUI,MUMONI,56,68,81,149
KITUI,MUMONI,57,51,90,141
KITUI,MUMONI,58,48,63,111
KITUI,MUMONI,59,64,77,141
KITUI,MUMONI,55-59,304,364,668
KITUI,MUMONI,60,92,113,205
KITUI,MUMONI,61,73,62,135
KITUI,MUMONI,62,42,43,85
KITUI,MUMONI,63,51,60,111
KITUI,MUMONI,64,40,46,86
KITUI,MUMONI,60-64,298,324,622
KITUI,MUMONI,65,64,81,145
KITUI,MUMONI,66,41,45,86
KITUI,MUMONI,67,55,77,132
KITUI,MUMONI,68,54,65,119
KITUI,MUMONI,69,40,104,144
KITUI,MUMONI,65-69,254,372,626
KITUI,MUMONI,70,63,125,188
KITUI,MUMONI,71,46,47,93
KITUI,MUMONI,72,33,28,61
KITUI,MUMONI,73,42,25,67
KITUI,MUMONI,74,39,45,84
KITUI,MUMONI,70-74,223,270,493
KITUI,MUMONI,75,31,38,69
KITUI,MUMONI,76,15,21,36
KITUI,MUMONI,77,18,17,35
KITUI,MUMONI,78,21,14,35
KITUI,MUMONI,79,28,60,88
KITUI,MUMONI,75-79,113,150,263
KITUI,MUMONI,80,29,62,91
KITUI,MUMONI,81,13,27,40
KITUI,MUMONI,82,11,12,23
KITUI,MUMONI,83,13,13,26
KITUI,MUMONI,84,20,18,38
KITUI,MUMONI,80-84,86,132,218
KITUI,MUMONI,85,18,18,36
KITUI,MUMONI,86,14,8,22
KITUI,MUMONI,87,10,13,23
KITUI,MUMONI,88,7,7,14
KITUI,MUMONI,89,17,37,54
KITUI,MUMONI,85-89,66,83,149
KITUI,MUMONI,90,7,21,28
KITUI,MUMONI,91,8,5,13
KITUI,MUMONI,92,5,9,14
KITUI,MUMONI,93,2,7,9
KITUI,MUMONI,94,6,5,11
KITUI,MUMONI,90-94,28,47,75
KITUI,MUMONI,95,-,8,8
KITUI,MUMONI,96,3,4,7
KITUI,MUMONI,97,3,-,3
KITUI,MUMONI,98,1,4,5
KITUI,MUMONI,99,5,11,16
KITUI,MUMONI,95-99,12,27,39
KITUI,MUMONI,100+,5,16,21
KITUI,MUMONI,Not Stated,-,-,-
KITUI,MUTITU,Total,26388,28896,55284
KITUI,MUTITU,0,576,533,1109
KITUI,MUTITU,1,604,605,1209
KITUI,MUTITU,2,676,679,1355
KITUI,MUTITU,3,704,679,1383
KITUI,MUTITU,4,766,701,1467
KITUI,MUTITU,0 - 4,3326,3197,6523
KITUI,MUTITU,5,764,758,1522
KITUI,MUTITU,6,785,820,1605
KITUI,MUTITU,7,768,740,1508
KITUI,MUTITU,8,841,815,1656
KITUI,MUTITU,9,832,858,1690
KITUI,MUTITU,05-Sep,3990,3991,7981
KITUI,MUTITU,10,965,892,1857
KITUI,MUTITU,11,895,984,1879
KITUI,MUTITU,12,1003,1012,2015
KITUI,MUTITU,13,923,974,1897
KITUI,MUTITU,14,953,932,1885
KITUI,MUTITU,Oct-14,4739,4794,9533
KITUI,MUTITU,15,979,961,1940
KITUI,MUTITU,16,886,908,1794
KITUI,MUTITU,17,832,770,1602
KITUI,MUTITU,18,609,568,1177
KITUI,MUTITU,19,620,557,1177
KITUI,MUTITU,15-19,3926,3764,7690
KITUI,MUTITU,20,481,436,917
KITUI,MUTITU,21,283,372,655
KITUI,MUTITU,22,309,346,655
KITUI,MUTITU,23,276,361,637
KITUI,MUTITU,24,245,320,565
KITUI,MUTITU,20-24,1594,1835,3429
KITUI,MUTITU,25,331,386,717
KITUI,MUTITU,26,198,328,526
KITUI,MUTITU,27,231,310,541
KITUI,MUTITU,28,204,246,450
KITUI,MUTITU,29,223,339,562
KITUI,MUTITU,25-29,1187,1609,2796
KITUI,MUTITU,30,275,392,667
KITUI,MUTITU,31,200,282,482
KITUI,MUTITU,32,243,366,609
KITUI,MUTITU,33,272,353,625
KITUI,MUTITU,34,202,281,483
KITUI,MUTITU,30-34,1192,1674,2866
KITUI,MUTITU,35,279,438,717
KITUI,MUTITU,36,219,252,471
KITUI,MUTITU,37,223,291,514
KITUI,MUTITU,38,150,212,362
KITUI,MUTITU,39,209,257,466
KITUI,MUTITU,35-39,1080,1450,2530
KITUI,MUTITU,40,207,237,444
KITUI,MUTITU,41,247,265,512
KITUI,MUTITU,42,250,237,487
KITUI,MUTITU,43,207,248,455
KITUI,MUTITU,44,210,272,482
KITUI,MUTITU,40-44,1121,1259,2380
KITUI,MUTITU,45,315,392,707
KITUI,MUTITU,46,217,215,432
KITUI,MUTITU,47,210,234,444
KITUI,MUTITU,48,122,159,281
KITUI,MUTITU,49,163,180,343
KITUI,MUTITU,45-49,1027,1180,2207
KITUI,MUTITU,50,160,219,379
KITUI,MUTITU,51,198,218,416
KITUI,MUTITU,52,114,125,239
KITUI,MUTITU,53,85,102,187
KITUI,MUTITU,54,171,146,317
KITUI,MUTITU,50-54,728,810,1538
KITUI,MUTITU,55,123,123,246
KITUI,MUTITU,56,137,120,257
KITUI,MUTITU,57,79,114,193
KITUI,MUTITU,58,78,87,165
KITUI,MUTITU,59,109,200,309
KITUI,MUTITU,55-59,526,644,1170
KITUI,MUTITU,60,139,180,319
KITUI,MUTITU,61,129,156,285
KITUI,MUTITU,62,79,112,191
KITUI,MUTITU,63,101,112,213
KITUI,MUTITU,64,97,126,223
KITUI,MUTITU,60-64,545,686,1231
KITUI,MUTITU,65,112,140,252
KITUI,MUTITU,66,81,67,148
KITUI,MUTITU,67,122,111,233
KITUI,MUTITU,68,56,68,124
KITUI,MUTITU,69,77,119,196
KITUI,MUTITU,65-69,448,505,953
KITUI,MUTITU,70,122,180,302
KITUI,MUTITU,71,72,120,192
KITUI,MUTITU,72,55,59,114
KITUI,MUTITU,73,65,149,214
KITUI,MUTITU,74,64,121,185
KITUI,MUTITU,70-74,378,629,1007
KITUI,MUTITU,75,56,64,120
KITUI,MUTITU,76,24,34,58
KITUI,MUTITU,77,33,59,92
KITUI,MUTITU,78,40,38,78
KITUI,MUTITU,79,62,88,150
KITUI,MUTITU,75-79,215,283,498
KITUI,MUTITU,80,43,108,151
KITUI,MUTITU,81,40,48,88
KITUI,MUTITU,82,19,24,43
KITUI,MUTITU,83,29,59,88
KITUI,MUTITU,84,53,70,123
KITUI,MUTITU,80-84,184,309,493
KITUI,MUTITU,85,22,30,52
KITUI,MUTITU,86,12,11,23
KITUI,MUTITU,87,21,17,38
KITUI,MUTITU,88,13,9,22
KITUI,MUTITU,89,26,47,73
KITUI,MUTITU,85-89,94,114,208
KITUI,MUTITU,90,22,46,68
KITUI,MUTITU,91,10,17,27
KITUI,MUTITU,92,8,7,15
KITUI,MUTITU,93,4,9,13
KITUI,MUTITU,94,5,9,14
KITUI,MUTITU,90-94,49,88,137
KITUI,MUTITU,95,19,39,58
KITUI,MUTITU,96,2,3,5
KITUI,MUTITU,97,3,6,9
KITUI,MUTITU,98,2,5,7
KITUI,MUTITU,99,7,8,15
KITUI,MUTITU,95-99,33,61,94
KITUI,MUTITU,100+,6,13,19
KITUI,MUTITU,Not Stated,-,1,1
KITUI,MUTITU NORTH,Total,10337,10877,21214
KITUI,MUTITU NORTH,0,217,219,436
KITUI,MUTITU NORTH,1,221,205,426
KITUI,MUTITU NORTH,2,220,232,452
KITUI,MUTITU NORTH,3,229,207,436
KITUI,MUTITU NORTH,4,241,237,478
KITUI,MUTITU NORTH,0 - 4,1128,1100,2228
KITUI,MUTITU NORTH,5,271,233,504
KITUI,MUTITU NORTH,6,287,235,522
KITUI,MUTITU NORTH,7,257,241,498
KITUI,MUTITU NORTH,8,316,260,576
KITUI,MUTITU NORTH,9,287,311,598
KITUI,MUTITU NORTH,05-Sep,1418,1280,2698
KITUI,MUTITU NORTH,10,299,323,622
KITUI,MUTITU NORTH,11,324,354,678
KITUI,MUTITU NORTH,12,344,298,642
KITUI,MUTITU NORTH,13,354,409,763
KITUI,MUTITU NORTH,14,339,310,649
KITUI,MUTITU NORTH,Oct-14,1660,1694,3354
KITUI,MUTITU NORTH,15,376,346,722
KITUI,MUTITU NORTH,16,325,314,639
KITUI,MUTITU NORTH,17,307,306,613
KITUI,MUTITU NORTH,18,241,212,453
KITUI,MUTITU NORTH,19,233,199,432
KITUI,MUTITU NORTH,15-19,1482,1377,2859
KITUI,MUTITU NORTH,20,203,160,363
KITUI,MUTITU NORTH,21,130,149,279
KITUI,MUTITU NORTH,22,121,128,249
KITUI,MUTITU NORTH,23,122,148,270
KITUI,MUTITU NORTH,24,111,108,219
KITUI,MUTITU NORTH,20-24,687,693,1380
KITUI,MUTITU NORTH,25,142,147,289
KITUI,MUTITU NORTH,26,105,125,230
KITUI,MUTITU NORTH,27,108,119,227
KITUI,MUTITU NORTH,28,75,102,177
KITUI,MUTITU NORTH,29,101,149,250
KITUI,MUTITU NORTH,25-29,531,642,1173
KITUI,MUTITU NORTH,30,89,137,226
KITUI,MUTITU NORTH,31,84,119,203
KITUI,MUTITU NORTH,32,121,141,262
KITUI,MUTITU NORTH,33,103,140,243
KITUI,MUTITU NORTH,34,87,116,203
KITUI,MUTITU NORTH,30-34,484,653,1137
KITUI,MUTITU NORTH,35,128,160,288
KITUI,MUTITU NORTH,36,97,78,175
KITUI,MUTITU NORTH,37,111,115,226
KITUI,MUTITU NORTH,38,64,73,137
KITUI,MUTITU NORTH,39,116,94,210
KITUI,MUTITU NORTH,35-39,516,520,1036
KITUI,MUTITU NORTH,40,117,118,235
KITUI,MUTITU NORTH,41,101,119,220
KITUI,MUTITU NORTH,42,89,89,178
KITUI,MUTITU NORTH,43,83,121,204
KITUI,MUTITU NORTH,44,72,102,174
KITUI,MUTITU NORTH,40-44,462,549,1011
KITUI,MUTITU NORTH,45,122,154,276
KITUI,MUTITU NORTH,46,94,103,197
KITUI,MUTITU NORTH,47,67,93,160
KITUI,MUTITU NORTH,48,50,51,101
KITUI,MUTITU NORTH,49,81,88,169
KITUI,MUTITU NORTH,45-49,414,489,903
KITUI,MUTITU NORTH,50,78,71,149
KITUI,MUTITU NORTH,51,85,90,175
KITUI,MUTITU NORTH,52,64,74,138
KITUI,MUTITU NORTH,53,51,57,108
KITUI,MUTITU NORTH,54,74,45,119
KITUI,MUTITU NORTH,50-54,352,337,689
KITUI,MUTITU NORTH,55,78,74,152
KITUI,MUTITU NORTH,56,67,80,147
KITUI,MUTITU NORTH,57,55,70,125
KITUI,MUTITU NORTH,58,33,47,80
KITUI,MUTITU NORTH,59,68,70,138
KITUI,MUTITU NORTH,55-59,301,341,642
KITUI,MUTITU NORTH,60,55,83,138
KITUI,MUTITU NORTH,61,53,68,121
KITUI,MUTITU NORTH,62,54,60,114
KITUI,MUTITU NORTH,63,37,51,88
KITUI,MUTITU NORTH,64,32,26,58
KITUI,MUTITU NORTH,60-64,231,288,519
KITUI,MUTITU NORTH,65,48,52,100
KITUI,MUTITU NORTH,66,29,36,65
KITUI,MUTITU NORTH,67,79,55,134
KITUI,MUTITU NORTH,68,32,47,79
KITUI,MUTITU NORTH,69,48,66,114
KITUI,MUTITU NORTH,65-69,236,256,492
KITUI,MUTITU NORTH,70,45,92,137
KITUI,MUTITU NORTH,71,39,53,92
KITUI,MUTITU NORTH,72,30,37,67
KITUI,MUTITU NORTH,73,19,27,46
KITUI,MUTITU NORTH,74,22,49,71
KITUI,MUTITU NORTH,70-74,155,258,413
KITUI,MUTITU NORTH,75,28,55,83
KITUI,MUTITU NORTH,76,25,27,52
KITUI,MUTITU NORTH,77,18,18,36
KITUI,MUTITU NORTH,78,11,16,27
KITUI,MUTITU NORTH,79,17,42,59
KITUI,MUTITU NORTH,75-79,99,158,257
KITUI,MUTITU NORTH,80,27,39,66
KITUI,MUTITU NORTH,81,15,18,33
KITUI,MUTITU NORTH,82,18,11,29
KITUI,MUTITU NORTH,83,16,21,37
KITUI,MUTITU NORTH,84,19,18,37
KITUI,MUTITU NORTH,80-84,95,107,202
KITUI,MUTITU NORTH,85,15,20,35
KITUI,MUTITU NORTH,86,18,9,27
KITUI,MUTITU NORTH,87,9,19,28
KITUI,MUTITU NORTH,88,11,10,21
KITUI,MUTITU NORTH,89,3,21,24
KITUI,MUTITU NORTH,85-89,56,79,135
KITUI,MUTITU NORTH,90,8,18,26
KITUI,MUTITU NORTH,91,4,5,9
KITUI,MUTITU NORTH,92,2,-,2
KITUI,MUTITU NORTH,93,4,6,10
KITUI,MUTITU NORTH,94,-,3,3
KITUI,MUTITU NORTH,90-94,18,32,50
KITUI,MUTITU NORTH,95,1,6,7
KITUI,MUTITU NORTH,96,1,2,3
KITUI,MUTITU NORTH,97,3,3,6
KITUI,MUTITU NORTH,98,1,1,2
KITUI,MUTITU NORTH,99,1,5,6
KITUI,MUTITU NORTH,95-99,7,17,24
KITUI,MUTITU NORTH,100+,5,7,12
KITUI,MUTITU NORTH,Not Stated,-,-,-
KITUI,MUTOMO,Total,54819,58531,113350
KITUI,MUTOMO,0,1223,1147,2370
KITUI,MUTOMO,1,1192,1169,2361
KITUI,MUTOMO,2,1307,1254,2561
KITUI,MUTOMO,3,1329,1309,2638
KITUI,MUTOMO,4,1384,1359,2743
KITUI,MUTOMO,0 - 4,6435,6238,12673
KITUI,MUTOMO,5,1523,1486,3009
KITUI,MUTOMO,6,1503,1541,3044
KITUI,MUTOMO,7,1480,1479,2959
KITUI,MUTOMO,8,1734,1740,3474
KITUI,MUTOMO,9,1721,1673,3394
KITUI,MUTOMO,05-Sep,7961,7919,15880
KITUI,MUTOMO,10,1869,1856,3725
KITUI,MUTOMO,11,1817,1953,3770
KITUI,MUTOMO,12,2103,1911,4014
KITUI,MUTOMO,13,1900,1846,3746
KITUI,MUTOMO,14,1793,1729,3522
KITUI,MUTOMO,Oct-14,9482,9295,18777
KITUI,MUTOMO,15,1875,1864,3739
KITUI,MUTOMO,16,1871,1777,3648
KITUI,MUTOMO,17,1910,1742,3652
KITUI,MUTOMO,18,1433,1283,2716
KITUI,MUTOMO,19,1320,1176,2496
KITUI,MUTOMO,15-19,8409,7842,16251
KITUI,MUTOMO,20,1112,1119,2231
KITUI,MUTOMO,21,840,768,1608
KITUI,MUTOMO,22,698,712,1410
KITUI,MUTOMO,23,671,774,1445
KITUI,MUTOMO,24,568,619,1187
KITUI,MUTOMO,20-24,3889,3992,7881
KITUI,MUTOMO,25,673,751,1424
KITUI,MUTOMO,26,457,585,1042
KITUI,MUTOMO,27,558,598,1156
KITUI,MUTOMO,28,409,518,927
KITUI,MUTOMO,29,539,668,1207
KITUI,MUTOMO,25-29,2636,3120,5756
KITUI,MUTOMO,30,608,798,1406
KITUI,MUTOMO,31,479,607,1086
KITUI,MUTOMO,32,591,771,1362
KITUI,MUTOMO,33,542,678,1220
KITUI,MUTOMO,34,394,567,961
KITUI,MUTOMO,30-34,2614,3421,6035
KITUI,MUTOMO,35,572,773,1345
KITUI,MUTOMO,36,423,525,948
KITUI,MUTOMO,37,443,585,1028
KITUI,MUTOMO,38,294,439,733
KITUI,MUTOMO,39,469,635,1104
KITUI,MUTOMO,35-39,2201,2957,5158
KITUI,MUTOMO,40,484,550,1034
KITUI,MUTOMO,41,497,580,1077
KITUI,MUTOMO,42,435,547,982
KITUI,MUTOMO,43,395,514,909
KITUI,MUTOMO,44,403,521,924
KITUI,MUTOMO,40-44,2214,2712,4926
KITUI,MUTOMO,45,655,772,1427
KITUI,MUTOMO,46,420,501,921
KITUI,MUTOMO,47,416,487,903
KITUI,MUTOMO,48,350,349,699
KITUI,MUTOMO,49,357,476,833
KITUI,MUTOMO,45-49,2198,2585,4783
KITUI,MUTOMO,50,363,449,812
KITUI,MUTOMO,51,370,399,769
KITUI,MUTOMO,52,263,245,508
KITUI,MUTOMO,53,197,219,416
KITUI,MUTOMO,54,281,267,548
KITUI,MUTOMO,50-54,1474,1579,3053
KITUI,MUTOMO,55,244,243,487
KITUI,MUTOMO,56,334,285,619
KITUI,MUTOMO,57,249,295,544
KITUI,MUTOMO,58,162,249,411
KITUI,MUTOMO,59,242,352,594
KITUI,MUTOMO,55-59,1231,1424,2655
KITUI,MUTOMO,60,303,358,661
KITUI,MUTOMO,61,232,289,521
KITUI,MUTOMO,62,194,186,380
KITUI,MUTOMO,63,202,253,455
KITUI,MUTOMO,64,184,327,511
KITUI,MUTOMO,60-64,1115,1413,2528
KITUI,MUTOMO,65,218,266,484
KITUI,MUTOMO,66,151,136,287
KITUI,MUTOMO,67,261,247,508
KITUI,MUTOMO,68,108,104,212
KITUI,MUTOMO,69,186,234,420
KITUI,MUTOMO,65-69,924,987,1911
KITUI,MUTOMO,70,206,263,469
KITUI,MUTOMO,71,148,203,351
KITUI,MUTOMO,72,117,155,272
KITUI,MUTOMO,73,213,479,692
KITUI,MUTOMO,74,135,188,323
KITUI,MUTOMO,70-74,819,1288,2107
KITUI,MUTOMO,75,127,157,284
KITUI,MUTOMO,76,88,127,215
KITUI,MUTOMO,77,87,117,204
KITUI,MUTOMO,78,71,67,138
KITUI,MUTOMO,79,71,174,245
KITUI,MUTOMO,75-79,444,642,1086
KITUI,MUTOMO,80,113,148,261
KITUI,MUTOMO,81,52,92,144
KITUI,MUTOMO,82,53,42,95
KITUI,MUTOMO,83,61,96,157
KITUI,MUTOMO,84,98,220,318
KITUI,MUTOMO,80-84,377,598,975
KITUI,MUTOMO,85,49,56,105
KITUI,MUTOMO,86,42,15,57
KITUI,MUTOMO,87,38,33,71
KITUI,MUTOMO,88,18,14,32
KITUI,MUTOMO,89,46,86,132
KITUI,MUTOMO,85-89,193,204,397
KITUI,MUTOMO,90,54,99,153
KITUI,MUTOMO,91,27,48,75
KITUI,MUTOMO,92,18,22,40
KITUI,MUTOMO,93,9,18,27
KITUI,MUTOMO,94,21,26,47
KITUI,MUTOMO,90-94,129,213,342
KITUI,MUTOMO,95,18,19,37
KITUI,MUTOMO,96,7,7,14
KITUI,MUTOMO,97,10,8,18
KITUI,MUTOMO,98,9,10,19
KITUI,MUTOMO,99,12,23,35
KITUI,MUTOMO,95-99,56,67,123
KITUI,MUTOMO,100+,18,34,52
KITUI,MUTOMO,Not Stated,-,1,1
KITUI,MWINGI CENTRAL,Total,52539,56174,108713
KITUI,MWINGI CENTRAL,0,1258,1161,2419
KITUI,MWINGI CENTRAL,1,1259,1242,2501
KITUI,MWINGI CENTRAL,2,1318,1240,2558
KITUI,MWINGI CENTRAL,3,1319,1293,2612
KITUI,MWINGI CENTRAL,4,1302,1224,2526
KITUI,MWINGI CENTRAL,0 - 4,6456,6160,12616
KITUI,MWINGI CENTRAL,5,1351,1367,2718
KITUI,MWINGI CENTRAL,6,1363,1373,2736
KITUI,MWINGI CENTRAL,7,1261,1295,2556
KITUI,MWINGI CENTRAL,8,1388,1335,2723
KITUI,MWINGI CENTRAL,9,1534,1364,2898
KITUI,MWINGI CENTRAL,05-Sep,6897,6734,13631
KITUI,MWINGI CENTRAL,10,1463,1470,2933
KITUI,MWINGI CENTRAL,11,1529,1550,3079
KITUI,MWINGI CENTRAL,12,1711,1467,3178
KITUI,MWINGI CENTRAL,13,1600,1613,3213
KITUI,MWINGI CENTRAL,14,1643,1559,3202
KITUI,MWINGI CENTRAL,Oct-14,7946,7659,15605
KITUI,MWINGI CENTRAL,15,1647,1588,3235
KITUI,MWINGI CENTRAL,16,1522,1577,3099
KITUI,MWINGI CENTRAL,17,1570,1511,3081
KITUI,MWINGI CENTRAL,18,1133,1095,2228
KITUI,MWINGI CENTRAL,19,1250,1189,2439
KITUI,MWINGI CENTRAL,15-19,7122,6960,14082
KITUI,MWINGI CENTRAL,20,1094,1240,2334
KITUI,MWINGI CENTRAL,21,955,1094,2049
KITUI,MWINGI CENTRAL,22,902,975,1877
KITUI,MWINGI CENTRAL,23,854,1041,1895
KITUI,MWINGI CENTRAL,24,781,933,1714
KITUI,MWINGI CENTRAL,20-24,4586,5283,9869
KITUI,MWINGI CENTRAL,25,934,1053,1987
KITUI,MWINGI CENTRAL,26,613,750,1363
KITUI,MWINGI CENTRAL,27,716,786,1502
KITUI,MWINGI CENTRAL,28,577,674,1251
KITUI,MWINGI CENTRAL,29,632,859,1491
KITUI,MWINGI CENTRAL,25-29,3472,4122,7594
KITUI,MWINGI CENTRAL,30,789,1016,1805
KITUI,MWINGI CENTRAL,31,555,682,1237
KITUI,MWINGI CENTRAL,32,622,876,1498
KITUI,MWINGI CENTRAL,33,579,782,1361
KITUI,MWINGI CENTRAL,34,479,658,1137
KITUI,MWINGI CENTRAL,30-34,3024,4014,7038
KITUI,MWINGI CENTRAL,35,658,772,1430
KITUI,MWINGI CENTRAL,36,433,534,967
KITUI,MWINGI CENTRAL,37,518,593,1111
KITUI,MWINGI CENTRAL,38,383,461,844
KITUI,MWINGI CENTRAL,39,494,533,1027
KITUI,MWINGI CENTRAL,35-39,2486,2893,5379
KITUI,MWINGI CENTRAL,40,527,554,1081
KITUI,MWINGI CENTRAL,41,497,555,1052
KITUI,MWINGI CENTRAL,42,394,510,904
KITUI,MWINGI CENTRAL,43,357,487,844
KITUI,MWINGI CENTRAL,44,375,467,842
KITUI,MWINGI CENTRAL,40-44,2150,2573,4723
KITUI,MWINGI CENTRAL,45,537,663,1200
KITUI,MWINGI CENTRAL,46,440,458,898
KITUI,MWINGI CENTRAL,47,360,406,766
KITUI,MWINGI CENTRAL,48,332,319,651
KITUI,MWINGI CENTRAL,49,379,416,795
KITUI,MWINGI CENTRAL,45-49,2048,2262,4310
KITUI,MWINGI CENTRAL,50,386,479,865
KITUI,MWINGI CENTRAL,51,290,355,645
KITUI,MWINGI CENTRAL,52,275,292,567
KITUI,MWINGI CENTRAL,53,200,233,433
KITUI,MWINGI CENTRAL,54,318,339,657
KITUI,MWINGI CENTRAL,50-54,1469,1698,3167
KITUI,MWINGI CENTRAL,55,320,287,607
KITUI,MWINGI CENTRAL,56,338,349,687
KITUI,MWINGI CENTRAL,57,247,265,512
KITUI,MWINGI CENTRAL,58,169,180,349
KITUI,MWINGI CENTRAL,59,255,270,525
KITUI,MWINGI CENTRAL,55-59,1329,1351,2680
KITUI,MWINGI CENTRAL,60,266,337,603
KITUI,MWINGI CENTRAL,61,224,248,472
KITUI,MWINGI CENTRAL,62,174,175,349
KITUI,MWINGI CENTRAL,63,159,194,353
KITUI,MWINGI CENTRAL,64,136,169,305
KITUI,MWINGI CENTRAL,60-64,959,1123,2082
KITUI,MWINGI CENTRAL,65,206,257,463
KITUI,MWINGI CENTRAL,66,152,158,310
KITUI,MWINGI CENTRAL,67,235,251,486
KITUI,MWINGI CENTRAL,68,121,143,264
KITUI,MWINGI CENTRAL,69,159,307,466
KITUI,MWINGI CENTRAL,65-69,873,1116,1989
KITUI,MWINGI CENTRAL,70,209,264,473
KITUI,MWINGI CENTRAL,71,149,135,284
KITUI,MWINGI CENTRAL,72,116,118,234
KITUI,MWINGI CENTRAL,73,99,136,235
KITUI,MWINGI CENTRAL,74,106,149,255
KITUI,MWINGI CENTRAL,70-74,679,802,1481
KITUI,MWINGI CENTRAL,75,88,110,198
KITUI,MWINGI CENTRAL,76,80,74,154
KITUI,MWINGI CENTRAL,77,84,100,184
KITUI,MWINGI CENTRAL,78,71,61,132
KITUI,MWINGI CENTRAL,79,87,164,251
KITUI,MWINGI CENTRAL,75-79,410,509,919
KITUI,MWINGI CENTRAL,80,108,151,259
KITUI,MWINGI CENTRAL,81,42,74,116
KITUI,MWINGI CENTRAL,82,47,48,95
KITUI,MWINGI CENTRAL,83,50,64,114
KITUI,MWINGI CENTRAL,84,62,101,163
KITUI,MWINGI CENTRAL,80-84,309,438,747
KITUI,MWINGI CENTRAL,85,35,46,81
KITUI,MWINGI CENTRAL,86,24,26,50
KITUI,MWINGI CENTRAL,87,29,31,60
KITUI,MWINGI CENTRAL,88,12,18,30
KITUI,MWINGI CENTRAL,89,53,74,127
KITUI,MWINGI CENTRAL,85-89,153,195,348
KITUI,MWINGI CENTRAL,90,30,57,87
KITUI,MWINGI CENTRAL,91,19,41,60
KITUI,MWINGI CENTRAL,92,24,31,55
KITUI,MWINGI CENTRAL,93,6,9,15
KITUI,MWINGI CENTRAL,94,11,22,33
KITUI,MWINGI CENTRAL,90-94,90,160,250
KITUI,MWINGI CENTRAL,95,22,18,40
KITUI,MWINGI CENTRAL,96,5,7,12
KITUI,MWINGI CENTRAL,97,6,7,13
KITUI,MWINGI CENTRAL,98,5,7,12
KITUI,MWINGI CENTRAL,99,17,38,55
KITUI,MWINGI CENTRAL,95-99,55,77,132
KITUI,MWINGI CENTRAL,100+,26,45,71
KITUI,MWINGI CENTRAL,Not Stated,-,-,-
KITUI,MWINGI EAST,Total,40314,44820,85134
KITUI,MWINGI EAST,0,897,887,1784
KITUI,MWINGI EAST,1,923,978,1901
KITUI,MWINGI EAST,2,1022,1068,2090
KITUI,MWINGI EAST,3,1156,1126,2282
KITUI,MWINGI EAST,4,1147,1092,2239
KITUI,MWINGI EAST,0 - 4,5145,5151,10296
KITUI,MWINGI EAST,5,1181,1148,2329
KITUI,MWINGI EAST,6,1259,1282,2541
KITUI,MWINGI EAST,7,1190,1090,2280
KITUI,MWINGI EAST,8,1279,1266,2545
KITUI,MWINGI EAST,9,1290,1307,2597
KITUI,MWINGI EAST,05-Sep,6199,6093,12292
KITUI,MWINGI EAST,10,1381,1369,2750
KITUI,MWINGI EAST,11,1415,1579,2994
KITUI,MWINGI EAST,12,1518,1394,2912
KITUI,MWINGI EAST,13,1528,1439,2967
KITUI,MWINGI EAST,14,1509,1434,2943
KITUI,MWINGI EAST,Oct-14,7351,7215,14566
KITUI,MWINGI EAST,15,1472,1452,2924
KITUI,MWINGI EAST,16,1388,1353,2741
KITUI,MWINGI EAST,17,1263,1231,2494
KITUI,MWINGI EAST,18,917,941,1858
KITUI,MWINGI EAST,19,965,896,1861
KITUI,MWINGI EAST,15-19,6005,5873,11878
KITUI,MWINGI EAST,20,752,735,1487
KITUI,MWINGI EAST,21,571,606,1177
KITUI,MWINGI EAST,22,480,592,1072
KITUI,MWINGI EAST,23,476,579,1055
KITUI,MWINGI EAST,24,408,530,938
KITUI,MWINGI EAST,20-24,2687,3042,5729
KITUI,MWINGI EAST,25,399,526,925
KITUI,MWINGI EAST,26,335,441,776
KITUI,MWINGI EAST,27,344,478,822
KITUI,MWINGI EAST,28,279,407,686
KITUI,MWINGI EAST,29,325,494,819
KITUI,MWINGI EAST,25-29,1682,2346,4028
KITUI,MWINGI EAST,30,419,605,1024
KITUI,MWINGI EAST,31,332,493,825
KITUI,MWINGI EAST,32,356,566,922
KITUI,MWINGI EAST,33,330,602,932
KITUI,MWINGI EAST,34,307,518,825
KITUI,MWINGI EAST,30-34,1744,2784,4528
KITUI,MWINGI EAST,35,397,579,976
KITUI,MWINGI EAST,36,257,390,647
KITUI,MWINGI EAST,37,329,398,727
KITUI,MWINGI EAST,38,228,291,519
KITUI,MWINGI EAST,39,326,396,722
KITUI,MWINGI EAST,35-39,1537,2054,3591
KITUI,MWINGI EAST,40,296,363,659
KITUI,MWINGI EAST,41,317,379,696
KITUI,MWINGI EAST,42,290,365,655
KITUI,MWINGI EAST,43,286,412,698
KITUI,MWINGI EAST,44,259,378,637
KITUI,MWINGI EAST,40-44,1448,1897,3345
KITUI,MWINGI EAST,45,410,586,996
KITUI,MWINGI EAST,46,345,362,707
KITUI,MWINGI EAST,47,289,330,619
KITUI,MWINGI EAST,48,189,267,456
KITUI,MWINGI EAST,49,257,309,566
KITUI,MWINGI EAST,45-49,1490,1854,3344
KITUI,MWINGI EAST,50,245,318,563
KITUI,MWINGI EAST,51,255,342,597
KITUI,MWINGI EAST,52,160,254,414
KITUI,MWINGI EAST,53,155,193,348
KITUI,MWINGI EAST,54,175,241,416
KITUI,MWINGI EAST,50-54,990,1348,2338
KITUI,MWINGI EAST,55,232,226,458
KITUI,MWINGI EAST,56,251,254,505
KITUI,MWINGI EAST,57,166,216,382
KITUI,MWINGI EAST,58,131,164,295
KITUI,MWINGI EAST,59,143,248,391
KITUI,MWINGI EAST,55-59,923,1108,2031
KITUI,MWINGI EAST,60,207,233,440
KITUI,MWINGI EAST,61,165,187,352
KITUI,MWINGI EAST,62,138,181,319
KITUI,MWINGI EAST,63,136,164,300
KITUI,MWINGI EAST,64,120,139,259
KITUI,MWINGI EAST,60-64,766,904,1670
KITUI,MWINGI EAST,65,161,210,371
KITUI,MWINGI EAST,66,126,133,259
KITUI,MWINGI EAST,67,193,217,410
KITUI,MWINGI EAST,68,130,145,275
KITUI,MWINGI EAST,69,154,262,416
KITUI,MWINGI EAST,65-69,764,967,1731
KITUI,MWINGI EAST,70,156,258,414
KITUI,MWINGI EAST,71,121,154,275
KITUI,MWINGI EAST,72,85,101,186
KITUI,MWINGI EAST,73,107,152,259
KITUI,MWINGI EAST,74,80,160,240
KITUI,MWINGI EAST,70-74,549,825,1374
KITUI,MWINGI EAST,75,102,152,254
KITUI,MWINGI EAST,76,67,77,144
KITUI,MWINGI EAST,77,65,85,150
KITUI,MWINGI EAST,78,59,64,123
KITUI,MWINGI EAST,79,83,117,200
KITUI,MWINGI EAST,75-79,376,495,871
KITUI,MWINGI EAST,80,100,145,245
KITUI,MWINGI EAST,81,49,59,108
KITUI,MWINGI EAST,82,43,46,89
KITUI,MWINGI EAST,83,50,62,112
KITUI,MWINGI EAST,84,62,109,171
KITUI,MWINGI EAST,80-84,304,421,725
KITUI,MWINGI EAST,85,44,56,100
KITUI,MWINGI EAST,86,32,15,47
KITUI,MWINGI EAST,87,36,34,70
KITUI,MWINGI EAST,88,19,21,40
KITUI,MWINGI EAST,89,39,69,108
KITUI,MWINGI EAST,85-89,170,195,365
KITUI,MWINGI EAST,90,40,54,94
KITUI,MWINGI EAST,91,19,35,54
KITUI,MWINGI EAST,92,17,30,47
KITUI,MWINGI EAST,93,15,13,28
KITUI,MWINGI EAST,94,18,18,36
KITUI,MWINGI EAST,90-94,109,150,259
KITUI,MWINGI EAST,95,19,15,34
KITUI,MWINGI EAST,96,4,14,18
KITUI,MWINGI EAST,97,8,7,15
KITUI,MWINGI EAST,98,1,6,7
KITUI,MWINGI EAST,99,13,20,33
KITUI,MWINGI EAST,95-99,45,62,107
KITUI,MWINGI EAST,100+,29,36,65
KITUI,MWINGI EAST,Not Stated,1,-,1
KITUI,NZAMBANI,Total,22929,23857,46786
KITUI,NZAMBANI,0,487,457,944
KITUI,NZAMBANI,1,529,498,1027
KITUI,NZAMBANI,2,517,541,1058
KITUI,NZAMBANI,3,491,498,989
KITUI,NZAMBANI,4,568,508,1076
KITUI,NZAMBANI,0 - 4,2592,2502,5094
KITUI,NZAMBANI,5,558,545,1103
KITUI,NZAMBANI,6,499,515,1014
KITUI,NZAMBANI,7,529,500,1029
KITUI,NZAMBANI,8,557,557,1114
KITUI,NZAMBANI,9,573,615,1188
KITUI,NZAMBANI,05-Sep,2716,2732,5448
KITUI,NZAMBANI,10,624,656,1280
KITUI,NZAMBANI,11,655,656,1311
KITUI,NZAMBANI,12,741,663,1404
KITUI,NZAMBANI,13,727,677,1404
KITUI,NZAMBANI,14,661,681,1342
KITUI,NZAMBANI,Oct-14,3408,3333,6741
KITUI,NZAMBANI,15,715,669,1384
KITUI,NZAMBANI,16,669,595,1264
KITUI,NZAMBANI,17,687,609,1296
KITUI,NZAMBANI,18,499,457,956
KITUI,NZAMBANI,19,591,512,1103
KITUI,NZAMBANI,15-19,3161,2842,6003
KITUI,NZAMBANI,20,459,414,873
KITUI,NZAMBANI,21,346,429,775
KITUI,NZAMBANI,22,372,375,747
KITUI,NZAMBANI,23,342,377,719
KITUI,NZAMBANI,24,330,338,668
KITUI,NZAMBANI,20-24,1849,1933,3782
KITUI,NZAMBANI,25,326,353,679
KITUI,NZAMBANI,26,277,316,593
KITUI,NZAMBANI,27,306,295,601
KITUI,NZAMBANI,28,211,271,482
KITUI,NZAMBANI,29,322,328,650
KITUI,NZAMBANI,25-29,1442,1563,3005
KITUI,NZAMBANI,30,296,333,629
KITUI,NZAMBANI,31,257,281,538
KITUI,NZAMBANI,32,318,357,675
KITUI,NZAMBANI,33,292,332,624
KITUI,NZAMBANI,34,227,259,486
KITUI,NZAMBANI,30-34,1390,1562,2952
KITUI,NZAMBANI,35,313,356,669
KITUI,NZAMBANI,36,208,255,463
KITUI,NZAMBANI,37,253,263,516
KITUI,NZAMBANI,38,183,201,384
KITUI,NZAMBANI,39,271,266,537
KITUI,NZAMBANI,35-39,1228,1341,2569
KITUI,NZAMBANI,40,239,248,487
KITUI,NZAMBANI,41,251,265,516
KITUI,NZAMBANI,42,224,236,460
KITUI,NZAMBANI,43,204,228,432
KITUI,NZAMBANI,44,192,225,417
KITUI,NZAMBANI,40-44,1110,1202,2312
KITUI,NZAMBANI,45,263,314,577
KITUI,NZAMBANI,46,187,203,390
KITUI,NZAMBANI,47,201,207,408
KITUI,NZAMBANI,48,125,143,268
KITUI,NZAMBANI,49,202,184,386
KITUI,NZAMBANI,45-49,978,1051,2029
KITUI,NZAMBANI,50,190,176,366
KITUI,NZAMBANI,51,157,221,378
KITUI,NZAMBANI,52,141,154,295
KITUI,NZAMBANI,53,90,117,207
KITUI,NZAMBANI,54,135,125,260
KITUI,NZAMBANI,50-54,713,793,1506
KITUI,NZAMBANI,55,132,141,273
KITUI,NZAMBANI,56,166,156,322
KITUI,NZAMBANI,57,109,143,252
KITUI,NZAMBANI,58,83,102,185
KITUI,NZAMBANI,59,110,148,258
KITUI,NZAMBANI,55-59,600,690,1290
KITUI,NZAMBANI,60,124,146,270
KITUI,NZAMBANI,61,130,138,268
KITUI,NZAMBANI,62,77,98,175
KITUI,NZAMBANI,63,81,94,175
KITUI,NZAMBANI,64,70,71,141
KITUI,NZAMBANI,60-64,482,547,1029
KITUI,NZAMBANI,65,105,112,217
KITUI,NZAMBANI,66,69,51,120
KITUI,NZAMBANI,67,111,130,241
KITUI,NZAMBANI,68,62,59,121
KITUI,NZAMBANI,69,92,142,234
KITUI,NZAMBANI,65-69,439,494,933
KITUI,NZAMBANI,70,106,149,255
KITUI,NZAMBANI,71,74,85,159
KITUI,NZAMBANI,72,43,60,103
KITUI,NZAMBANI,73,59,127,186
KITUI,NZAMBANI,74,58,115,173
KITUI,NZAMBANI,70-74,340,536,876
KITUI,NZAMBANI,75,54,65,119
KITUI,NZAMBANI,76,23,27,50
KITUI,NZAMBANI,77,31,42,73
KITUI,NZAMBANI,78,38,23,61
KITUI,NZAMBANI,79,41,72,113
KITUI,NZAMBANI,75-79,187,229,416
KITUI,NZAMBANI,80,54,87,141
KITUI,NZAMBANI,81,28,34,62
KITUI,NZAMBANI,82,20,17,37
KITUI,NZAMBANI,83,17,18,35
KITUI,NZAMBANI,84,29,58,87
KITUI,NZAMBANI,80-84,148,214,362
KITUI,NZAMBANI,85,18,26,44
KITUI,NZAMBANI,86,12,13,25
KITUI,NZAMBANI,87,13,17,30
KITUI,NZAMBANI,88,8,7,15
KITUI,NZAMBANI,89,15,57,72
KITUI,NZAMBANI,85-89,66,120,186
KITUI,NZAMBANI,90,12,45,57
KITUI,NZAMBANI,91,12,39,51
KITUI,NZAMBANI,92,16,10,26
KITUI,NZAMBANI,93,3,14,17
KITUI,NZAMBANI,94,6,10,16
KITUI,NZAMBANI,90-94,49,118,167
KITUI,NZAMBANI,95,7,13,20
KITUI,NZAMBANI,96,3,2,5
KITUI,NZAMBANI,97,5,1,6
KITUI,NZAMBANI,98,3,6,9
KITUI,NZAMBANI,99,5,16,21
KITUI,NZAMBANI,95-99,23,38,61
KITUI,NZAMBANI,100+,8,17,25
KITUI,NZAMBANI,Not Stated,-,-,-
KITUI,THAGICU,Total,7141,7994,15135
KITUI,THAGICU,0,169,193,362
KITUI,THAGICU,1,181,168,349
KITUI,THAGICU,2,182,178,360
KITUI,THAGICU,3,188,197,385
KITUI,THAGICU,4,192,192,384
KITUI,THAGICU,0 - 4,912,928,1840
KITUI,THAGICU,5,204,186,390
KITUI,THAGICU,6,188,211,399
KITUI,THAGICU,7,193,190,383
KITUI,THAGICU,8,234,205,439
KITUI,THAGICU,9,227,205,432
KITUI,THAGICU,05-Sep,1046,997,2043
KITUI,THAGICU,10,244,251,495
KITUI,THAGICU,11,226,263,489
KITUI,THAGICU,12,261,253,514
KITUI,THAGICU,13,256,232,488
KITUI,THAGICU,14,257,259,516
KITUI,THAGICU,Oct-14,1244,1258,2502
KITUI,THAGICU,15,227,214,441
KITUI,THAGICU,16,208,196,404
KITUI,THAGICU,17,190,253,443
KITUI,THAGICU,18,158,175,333
KITUI,THAGICU,19,161,186,347
KITUI,THAGICU,15-19,944,1024,1968
KITUI,THAGICU,20,128,164,292
KITUI,THAGICU,21,127,155,282
KITUI,THAGICU,22,93,128,221
KITUI,THAGICU,23,99,140,239
KITUI,THAGICU,24,102,104,206
KITUI,THAGICU,20-24,549,691,1240
KITUI,THAGICU,25,98,104,202
KITUI,THAGICU,26,75,88,163
KITUI,THAGICU,27,72,91,163
KITUI,THAGICU,28,63,79,142
KITUI,THAGICU,29,72,124,196
KITUI,THAGICU,25-29,380,486,866
KITUI,THAGICU,30,85,122,207
KITUI,THAGICU,31,73,73,146
KITUI,THAGICU,32,65,105,170
KITUI,THAGICU,33,74,107,181
KITUI,THAGICU,34,62,95,157
KITUI,THAGICU,30-34,359,502,861
KITUI,THAGICU,35,93,145,238
KITUI,THAGICU,36,66,102,168
KITUI,THAGICU,37,49,68,117
KITUI,THAGICU,38,45,54,99
KITUI,THAGICU,39,70,86,156
KITUI,THAGICU,35-39,323,455,778
KITUI,THAGICU,40,61,66,127
KITUI,THAGICU,41,50,52,102
KITUI,THAGICU,42,48,58,106
KITUI,THAGICU,43,53,49,102
KITUI,THAGICU,44,59,46,105
KITUI,THAGICU,40-44,271,271,542
KITUI,THAGICU,45,68,81,149
KITUI,THAGICU,46,67,57,124
KITUI,THAGICU,47,60,52,112
KITUI,THAGICU,48,27,45,72
KITUI,THAGICU,49,37,48,85
KITUI,THAGICU,45-49,259,283,542
KITUI,THAGICU,50,39,51,90
KITUI,THAGICU,51,52,47,99
KITUI,THAGICU,52,47,35,82
KITUI,THAGICU,53,25,25,50
KITUI,THAGICU,54,35,29,64
KITUI,THAGICU,50-54,198,187,385
KITUI,THAGICU,55,33,25,58
KITUI,THAGICU,56,43,45,88
KITUI,THAGICU,57,24,34,58
KITUI,THAGICU,58,24,40,64
KITUI,THAGICU,59,32,58,90
KITUI,THAGICU,55-59,156,202,358
KITUI,THAGICU,60,42,54,96
KITUI,THAGICU,61,34,34,68
KITUI,THAGICU,62,22,21,43
KITUI,THAGICU,63,26,34,60
KITUI,THAGICU,64,21,21,42
KITUI,THAGICU,60-64,145,164,309
KITUI,THAGICU,65,20,48,68
KITUI,THAGICU,66,12,20,32
KITUI,THAGICU,67,24,32,56
KITUI,THAGICU,68,24,26,50
KITUI,THAGICU,69,31,75,106
KITUI,THAGICU,65-69,111,201,312
KITUI,THAGICU,70,38,53,91
KITUI,THAGICU,71,29,34,63
KITUI,THAGICU,72,14,15,29
KITUI,THAGICU,73,10,23,33
KITUI,THAGICU,74,16,18,34
KITUI,THAGICU,70-74,107,143,250
KITUI,THAGICU,75,13,13,26
KITUI,THAGICU,76,7,6,13
KITUI,THAGICU,77,11,7,18
KITUI,THAGICU,78,10,5,15
KITUI,THAGICU,79,15,22,37
KITUI,THAGICU,75-79,56,53,109
KITUI,THAGICU,80,17,27,44
KITUI,THAGICU,81,7,9,16
KITUI,THAGICU,82,7,9,16
KITUI,THAGICU,83,3,7,10
KITUI,THAGICU,84,7,12,19
KITUI,THAGICU,80-84,41,64,105
KITUI,THAGICU,85,4,14,18
KITUI,THAGICU,86,2,3,5
KITUI,THAGICU,87,5,7,12
KITUI,THAGICU,88,1,1,2
KITUI,THAGICU,89,9,28,37
KITUI,THAGICU,85-89,21,53,74
KITUI,THAGICU,90,5,7,12
KITUI,THAGICU,91,3,5,8
KITUI,THAGICU,92,1,1,2
KITUI,THAGICU,93,-,1,1
KITUI,THAGICU,94,3,3,6
KITUI,THAGICU,90-94,12,17,29
KITUI,THAGICU,95,1,3,4
KITUI,THAGICU,96,-,1,1
KITUI,THAGICU,97,1,-,1
KITUI,THAGICU,98,-,1,1
KITUI,THAGICU,99,1,4,5
KITUI,THAGICU,95-99,3,9,12
KITUI,THAGICU,100+,4,6,10
KITUI,THAGICU,Not Stated,-,-,-
KITUI,TSEIKURU,Total,19619,21252,40871
KITUI,TSEIKURU,0,380,414,794
KITUI,TSEIKURU,1,510,457,967
KITUI,TSEIKURU,2,516,493,1009
KITUI,TSEIKURU,3,517,533,1050
KITUI,TSEIKURU,4,514,537,1051
KITUI,TSEIKURU,0 - 4,2437,2434,4871
KITUI,TSEIKURU,5,557,546,1103
KITUI,TSEIKURU,6,586,587,1173
KITUI,TSEIKURU,7,469,526,995
KITUI,TSEIKURU,8,636,639,1275
KITUI,TSEIKURU,9,629,605,1234
KITUI,TSEIKURU,05-Sep,2877,2903,5780
KITUI,TSEIKURU,10,631,629,1260
KITUI,TSEIKURU,11,682,749,1431
KITUI,TSEIKURU,12,692,667,1359
KITUI,TSEIKURU,13,688,654,1342
KITUI,TSEIKURU,14,665,668,1333
KITUI,TSEIKURU,Oct-14,3358,3367,6725
KITUI,TSEIKURU,15,664,678,1342
KITUI,TSEIKURU,16,652,636,1288
KITUI,TSEIKURU,17,556,524,1080
KITUI,TSEIKURU,18,442,457,899
KITUI,TSEIKURU,19,520,480,1000
KITUI,TSEIKURU,15-19,2834,2775,5609
KITUI,TSEIKURU,20,407,425,832
KITUI,TSEIKURU,21,332,368,700
KITUI,TSEIKURU,22,283,286,569
KITUI,TSEIKURU,23,255,317,572
KITUI,TSEIKURU,24,220,252,472
KITUI,TSEIKURU,20-24,1497,1648,3145
KITUI,TSEIKURU,25,255,285,540
KITUI,TSEIKURU,26,174,214,388
KITUI,TSEIKURU,27,204,264,468
KITUI,TSEIKURU,28,145,182,327
KITUI,TSEIKURU,29,185,225,410
KITUI,TSEIKURU,25-29,963,1170,2133
KITUI,TSEIKURU,30,244,322,566
KITUI,TSEIKURU,31,177,286,463
KITUI,TSEIKURU,32,157,240,397
KITUI,TSEIKURU,33,196,288,484
KITUI,TSEIKURU,34,165,239,404
KITUI,TSEIKURU,30-34,939,1375,2314
KITUI,TSEIKURU,35,242,347,589
KITUI,TSEIKURU,36,113,148,261
KITUI,TSEIKURU,37,125,151,276
KITUI,TSEIKURU,38,100,120,220
KITUI,TSEIKURU,39,164,170,334
KITUI,TSEIKURU,35-39,744,936,1680
KITUI,TSEIKURU,40,167,197,364
KITUI,TSEIKURU,41,162,168,330
KITUI,TSEIKURU,42,156,168,324
KITUI,TSEIKURU,43,147,195,342
KITUI,TSEIKURU,44,151,206,357
KITUI,TSEIKURU,40-44,783,934,1717
KITUI,TSEIKURU,45,223,256,479
KITUI,TSEIKURU,46,150,177,327
KITUI,TSEIKURU,47,148,161,309
KITUI,TSEIKURU,48,105,107,212
KITUI,TSEIKURU,49,108,144,252
KITUI,TSEIKURU,45-49,734,845,1579
KITUI,TSEIKURU,50,132,150,282
KITUI,TSEIKURU,51,140,120,260
KITUI,TSEIKURU,52,104,122,226
KITUI,TSEIKURU,53,67,82,149
KITUI,TSEIKURU,54,79,79,158
KITUI,TSEIKURU,50-54,522,553,1075
KITUI,TSEIKURU,55,89,65,154
KITUI,TSEIKURU,56,106,78,184
KITUI,TSEIKURU,57,87,88,175
KITUI,TSEIKURU,58,67,68,135
KITUI,TSEIKURU,59,106,144,250
KITUI,TSEIKURU,55-59,455,443,898
KITUI,TSEIKURU,60,147,160,307
KITUI,TSEIKURU,61,71,74,145
KITUI,TSEIKURU,62,61,63,124
KITUI,TSEIKURU,63,79,86,165
KITUI,TSEIKURU,64,49,49,98
KITUI,TSEIKURU,60-64,407,432,839
KITUI,TSEIKURU,65,94,94,188
KITUI,TSEIKURU,66,50,78,128
KITUI,TSEIKURU,67,88,115,203
KITUI,TSEIKURU,68,40,58,98
KITUI,TSEIKURU,69,68,92,160
KITUI,TSEIKURU,65-69,340,437,777
KITUI,TSEIKURU,70,114,180,294
KITUI,TSEIKURU,71,67,78,145
KITUI,TSEIKURU,72,51,47,98
KITUI,TSEIKURU,73,30,56,86
KITUI,TSEIKURU,74,52,61,113
KITUI,TSEIKURU,70-74,314,422,736
KITUI,TSEIKURU,75,42,51,93
KITUI,TSEIKURU,76,29,34,63
KITUI,TSEIKURU,77,32,40,72
KITUI,TSEIKURU,78,16,23,39
KITUI,TSEIKURU,79,49,68,117
KITUI,TSEIKURU,75-79,168,216,384
KITUI,TSEIKURU,80,46,84,130
KITUI,TSEIKURU,81,17,22,39
KITUI,TSEIKURU,82,11,23,34
KITUI,TSEIKURU,83,14,27,41
KITUI,TSEIKURU,84,31,26,57
KITUI,TSEIKURU,80-84,119,182,301
KITUI,TSEIKURU,85,14,22,36
KITUI,TSEIKURU,86,14,12,26
KITUI,TSEIKURU,87,17,22,39
KITUI,TSEIKURU,88,6,7,13
KITUI,TSEIKURU,89,24,38,62
KITUI,TSEIKURU,85-89,75,101,176
KITUI,TSEIKURU,90,13,26,39
KITUI,TSEIKURU,91,2,4,6
KITUI,TSEIKURU,92,2,3,5
KITUI,TSEIKURU,93,4,4,8
KITUI,TSEIKURU,94,7,4,11
KITUI,TSEIKURU,90-94,28,41,69
KITUI,TSEIKURU,95,3,8,11
KITUI,TSEIKURU,96,4,4,8
KITUI,TSEIKURU,97,3,3,6
KITUI,TSEIKURU,98,3,2,5
KITUI,TSEIKURU,99,6,12,18
KITUI,TSEIKURU,95-99,19,29,48
KITUI,TSEIKURU,100+,6,9,15
KITUI,TSEIKURU,Not Stated,-,-,-
KWALE,ALL,Total,425121,441681,866802
KWALE,ALL,0,12299,12331,24630
KWALE,ALL,1,12681,12369,25050
KWALE,ALL,2,13139,12927,26066
KWALE,ALL,3,13232,13391,26623
KWALE,ALL,4,14178,13743,27921
KWALE,ALL,0 - 4,65529,64761,130290
KWALE,ALL,5,14617,14090,28707
KWALE,ALL,6,13767,13384,27151
KWALE,ALL,7,13075,12628,25703
KWALE,ALL,8,12336,12373,24709
KWALE,ALL,9,12904,12568,25472
KWALE,ALL,05-Sep,66699,65043,131742
KWALE,ALL,10,13154,13022,26176
KWALE,ALL,11,11892,12012,23904
KWALE,ALL,12,13224,12692,25916
KWALE,ALL,13,13177,13028,26205
KWALE,ALL,14,11751,11337,23088
KWALE,ALL,Oct-14,63198,62091,125289
KWALE,ALL,15,10958,10500,21458
KWALE,ALL,16,10204,9978,20182
KWALE,ALL,17,10150,9284,19434
KWALE,ALL,18,9239,8656,17895
KWALE,ALL,19,8865,9270,18135
KWALE,ALL,15-19,49416,47688,97104
KWALE,ALL,20,8332,9523,17855
KWALE,ALL,21,6015,7024,13039
KWALE,ALL,22,6346,7794,14140
KWALE,ALL,23,6212,7735,13947
KWALE,ALL,24,5798,7016,12814
KWALE,ALL,20-24,32703,39092,71795
KWALE,ALL,25,7114,8147,15261
KWALE,ALL,26,5713,7025,12738
KWALE,ALL,27,5737,6623,12360
KWALE,ALL,28,4927,6257,11184
KWALE,ALL,29,4811,6336,11147
KWALE,ALL,25-29,28302,34388,62690
KWALE,ALL,30,6798,8858,15656
KWALE,ALL,31,4234,5303,9537
KWALE,ALL,32,5223,6372,11595
KWALE,ALL,33,4259,5315,9574
KWALE,ALL,34,4224,4867,9091
KWALE,ALL,30-34,24738,30715,55453
KWALE,ALL,35,5763,6312,12075
KWALE,ALL,36,3835,4168,8003
KWALE,ALL,37,3652,3776,7428
KWALE,ALL,38,2886,3076,5962
KWALE,ALL,39,3179,3167,6346
KWALE,ALL,35-39,19315,20499,39814
KWALE,ALL,40,4734,4956,9690
KWALE,ALL,41,3641,3860,7501
KWALE,ALL,42,3854,4262,8116
KWALE,ALL,43,3172,3625,6797
KWALE,ALL,44,2844,2867,5711
KWALE,ALL,40-44,18245,19570,37815
KWALE,ALL,45,4511,4288,8799
KWALE,ALL,46,2684,2820,5504
KWALE,ALL,47,2959,2694,5653
KWALE,ALL,48,2164,2008,4172
KWALE,ALL,49,2462,1943,4405
KWALE,ALL,45-49,14780,13753,28533
KWALE,ALL,50,3789,3654,7443
KWALE,ALL,51,2372,1791,4163
KWALE,ALL,52,1846,1401,3247
KWALE,ALL,53,1223,871,2094
KWALE,ALL,54,1513,1041,2554
KWALE,ALL,50-54,10743,8758,19501
KWALE,ALL,55,1752,1370,3122
KWALE,ALL,56,2012,1738,3750
KWALE,ALL,57,1722,1671,3393
KWALE,ALL,58,1418,1326,2744
KWALE,ALL,59,1680,2075,3755
KWALE,ALL,55-59,8584,8180,16764
KWALE,ALL,60,2433,3463,5896
KWALE,ALL,61,1316,1749,3065
KWALE,ALL,62,1349,1394,2743
KWALE,ALL,63,1374,1604,2978
KWALE,ALL,64,1102,1181,2283
KWALE,ALL,60-64,7574,9391,16965
KWALE,ALL,65,1784,2034,3818
KWALE,ALL,66,1076,912,1988
KWALE,ALL,67,1473,1332,2805
KWALE,ALL,68,816,773,1589
KWALE,ALL,69,1132,1521,2653
KWALE,ALL,65-69,6281,6572,12853
KWALE,ALL,70,1682,2590,4272
KWALE,ALL,71,648,780,1428
KWALE,ALL,72,657,707,1364
KWALE,ALL,73,577,520,1097
KWALE,ALL,74,606,670,1276
KWALE,ALL,70-74,4170,5267,9437
KWALE,ALL,75,738,736,1474
KWALE,ALL,76,375,361,736
KWALE,ALL,77,407,426,833
KWALE,ALL,78,331,272,603
KWALE,ALL,79,421,549,970
KWALE,ALL,75-79,2272,2344,4616
KWALE,ALL,80,565,985,1550
KWALE,ALL,81,218,241,459
KWALE,ALL,82,198,192,390
KWALE,ALL,83,179,228,407
KWALE,ALL,84,196,258,454
KWALE,ALL,80-84,1356,1904,3260
KWALE,ALL,85,202,296,498
KWALE,ALL,86,120,103,223
KWALE,ALL,87,127,152,279
KWALE,ALL,88,76,84,160
KWALE,ALL,89,174,270,444
KWALE,ALL,85-89,699,905,1604
KWALE,ALL,90,131,259,390
KWALE,ALL,91,49,58,107
KWALE,ALL,92,42,30,72
KWALE,ALL,93,22,29,51
KWALE,ALL,94,36,44,80
KWALE,ALL,90-94,280,420,700
KWALE,ALL,95,35,42,77
KWALE,ALL,96,23,25,48
KWALE,ALL,97,17,25,42
KWALE,ALL,98,15,24,39
KWALE,ALL,99,42,58,100
KWALE,ALL,95-99,132,174,306
KWALE,ALL,100+,99,160,259
KWALE,KINANGO,Not Stated,6,6,12
KWALE,KINANGO,5,1768,1784,3552
KWALE,KINANGO,6,1799,1684,3483
KWALE,KINANGO,7,1553,1553,3106
KWALE,KINANGO,8,1591,1594,3185
KWALE,KINANGO,9,1507,1476,2983
KWALE,KINANGO,05-Sep,8218,8091,16309
KWALE,KINANGO,10,1634,1562,3196
KWALE,KINANGO,11,1510,1530,3040
KWALE,KINANGO,12,1639,1574,3213
KWALE,KINANGO,13,1585,1440,3025
KWALE,KINANGO,14,1347,1284,2631
KWALE,KINANGO,Oct-14,7715,7390,15105
KWALE,KINANGO,15,1344,1242,2586
KWALE,KINANGO,16,1228,1195,2423
KWALE,KINANGO,17,1192,1016,2208
KWALE,KINANGO,18,1030,939,1969
KWALE,KINANGO,19,917,999,1916
KWALE,KINANGO,15-19,5711,5391,11102
KWALE,KINANGO,20,802,1026,1828
KWALE,KINANGO,21,577,667,1244
KWALE,KINANGO,22,527,723,1250
KWALE,KINANGO,23,564,776,1340
KWALE,KINANGO,24,471,665,1136
KWALE,KINANGO,20-24,2941,3857,6798
KWALE,KINANGO,25,551,751,1302
KWALE,KINANGO,26,456,663,1119
KWALE,KINANGO,27,462,580,1042
KWALE,KINANGO,28,411,610,1021
KWALE,KINANGO,29,423,630,1053
KWALE,KINANGO,25-29,2303,3234,5537
KWALE,KINANGO,30,514,808,1322
KWALE,KINANGO,31,329,551,880
KWALE,KINANGO,32,424,647,1071
KWALE,KINANGO,33,360,562,922
KWALE,KINANGO,34,372,526,898
KWALE,KINANGO,30-34,1999,3094,5093
KWALE,KINANGO,35,497,599,1096
KWALE,KINANGO,36,318,382,700
KWALE,KINANGO,37,277,321,598
KWALE,KINANGO,38,222,260,482
KWALE,KINANGO,39,242,259,501
KWALE,KINANGO,35-39,1556,1821,3377
KWALE,KINANGO,40,336,386,722
KWALE,KINANGO,41,306,385,691
KWALE,KINANGO,42,342,513,855
KWALE,KINANGO,43,292,417,709
KWALE,KINANGO,44,256,308,564
KWALE,KINANGO,40-44,1532,2009,3541
KWALE,KINANGO,45,369,393,762
KWALE,KINANGO,46,223,313,536
KWALE,KINANGO,47,221,253,474
KWALE,KINANGO,48,169,162,331
KWALE,KINANGO,49,204,185,389
KWALE,KINANGO,45-49,1186,1306,2492
KWALE,KINANGO,50,336,364,700
KWALE,KINANGO,51,241,188,429
KWALE,KINANGO,52,193,142,335
KWALE,KINANGO,53,118,66,184
KWALE,KINANGO,54,125,94,219
KWALE,KINANGO,50-54,1013,854,1867
KWALE,KINANGO,55,127,103,230
KWALE,KINANGO,56,162,120,282
KWALE,KINANGO,57,188,153,341
KWALE,KINANGO,58,105,129,234
KWALE,KINANGO,59,157,214,371
KWALE,KINANGO,55-59,739,719,1458
KWALE,KINANGO,60,249,356,605
KWALE,KINANGO,61,148,213,361
KWALE,KINANGO,62,143,166,309
KWALE,KINANGO,63,152,171,323
KWALE,KINANGO,64,116,166,282
KWALE,KINANGO,60-64,808,1072,1880
KWALE,KINANGO,65,165,222,387
KWALE,KINANGO,66,104,112,216
KWALE,KINANGO,67,155,162,317
KWALE,KINANGO,68,71,69,140
KWALE,KINANGO,69,142,185,327
KWALE,KINANGO,65-69,637,750,1387
KWALE,KINANGO,70,170,259,429
KWALE,KINANGO,71,62,78,140
KWALE,KINANGO,72,65,81,146
KWALE,KINANGO,73,55,66,121
KWALE,KINANGO,74,63,66,129
KWALE,KINANGO,70-74,415,550,965
KWALE,KINANGO,75,89,71,160
KWALE,KINANGO,76,47,32,79
KWALE,KINANGO,77,48,41,89
KWALE,KINANGO,78,28,18,46
KWALE,KINANGO,79,43,55,98
KWALE,KINANGO,75-79,255,217,472
KWALE,KINANGO,80,56,109,165
KWALE,KINANGO,81,22,24,46
KWALE,KINANGO,82,27,16,43
KWALE,KINANGO,83,21,21,42
KWALE,KINANGO,84,27,37,64
KWALE,KINANGO,80-84,153,207,360
KWALE,KINANGO,85,24,32,56
KWALE,KINANGO,86,13,17,30
KWALE,KINANGO,87,13,24,37
KWALE,KINANGO,88,5,11,16
KWALE,KINANGO,89,29,39,68
KWALE,KINANGO,85-89,84,123,207
KWALE,KINANGO,90,20,29,49
KWALE,KINANGO,91,7,6,13
KWALE,KINANGO,92,4,3,7
KWALE,KINANGO,93,2,7,9
KWALE,KINANGO,94,1,8,9
KWALE,KINANGO,90-94,34,53,87
KWALE,KINANGO,95,5,4,9
KWALE,KINANGO,96,5,4,9
KWALE,KINANGO,97,2,2,4
KWALE,KINANGO,98,-,2,2
KWALE,KINANGO,99,8,11,19
KWALE,KINANGO,95-99,20,23,43
KWALE,KINANGO,100+,15,24,39
KWALE,KINANGO,Not Stated,-,-,-
KWALE,LUNGA LUNGA,Total,97174,101245,198419
KWALE,LUNGA LUNGA,0,2910,2878,5788
KWALE,LUNGA LUNGA,1,3023,3039,6062
KWALE,LUNGA LUNGA,2,3194,3098,6292
KWALE,LUNGA LUNGA,3,3180,3406,6586
KWALE,LUNGA LUNGA,4,3568,3362,6930
KWALE,LUNGA LUNGA,0 - 4,15875,15783,31658
KWALE,LUNGA LUNGA,5,3503,3311,6814
KWALE,LUNGA LUNGA,6,3460,3477,6937
KWALE,LUNGA LUNGA,7,3233,3164,6397
KWALE,LUNGA LUNGA,8,3130,3116,6246
KWALE,LUNGA LUNGA,9,3260,3216,6476
KWALE,LUNGA LUNGA,05-Sep,16586,16284,32870
KWALE,LUNGA LUNGA,10,3335,3305,6640
KWALE,LUNGA LUNGA,11,2931,2862,5793
KWALE,LUNGA LUNGA,12,3407,3167,6574
KWALE,LUNGA LUNGA,13,3228,3157,6385
KWALE,LUNGA LUNGA,14,2918,2727,5645
KWALE,LUNGA LUNGA,Oct-14,15819,15218,31037
KWALE,LUNGA LUNGA,15,2723,2556,5279
KWALE,LUNGA LUNGA,16,2463,2381,4844
KWALE,LUNGA LUNGA,17,2393,2092,4485
KWALE,LUNGA LUNGA,18,2140,1935,4075
KWALE,LUNGA LUNGA,19,2066,2143,4209
KWALE,LUNGA LUNGA,15-19,11785,11107,22892
KWALE,LUNGA LUNGA,20,1870,2136,4006
KWALE,LUNGA LUNGA,21,1221,1393,2614
KWALE,LUNGA LUNGA,22,1223,1536,2759
KWALE,LUNGA LUNGA,23,1183,1477,2660
KWALE,LUNGA LUNGA,24,1070,1323,2393
KWALE,LUNGA LUNGA,20-24,6567,7865,14432
KWALE,LUNGA LUNGA,25,1390,1650,3040
KWALE,LUNGA LUNGA,26,1043,1438,2481
KWALE,LUNGA LUNGA,27,1039,1241,2280
KWALE,LUNGA LUNGA,28,881,1252,2133
KWALE,LUNGA LUNGA,29,911,1340,2251
KWALE,LUNGA LUNGA,25-29,5264,6921,12185
KWALE,LUNGA LUNGA,30,1370,1968,3338
KWALE,LUNGA LUNGA,31,727,995,1722
KWALE,LUNGA LUNGA,32,1013,1164,2177
KWALE,LUNGA LUNGA,33,840,940,1780
KWALE,LUNGA LUNGA,34,757,817,1574
KWALE,LUNGA LUNGA,30-34,4707,5884,10591
KWALE,LUNGA LUNGA,35,1206,1438,2644
KWALE,LUNGA LUNGA,36,751,825,1576
KWALE,LUNGA LUNGA,37,694,792,1486
KWALE,LUNGA LUNGA,38,555,643,1198
KWALE,LUNGA LUNGA,39,670,717,1387
KWALE,LUNGA LUNGA,35-39,3876,4415,8291
KWALE,LUNGA LUNGA,40,1021,1242,2263
KWALE,LUNGA LUNGA,41,753,856,1609
KWALE,LUNGA LUNGA,42,863,984,1847
KWALE,LUNGA LUNGA,43,665,825,1490
KWALE,LUNGA LUNGA,44,561,595,1156
KWALE,LUNGA LUNGA,40-44,3863,4502,8365
KWALE,LUNGA LUNGA,45,1000,975,1975
KWALE,LUNGA LUNGA,46,521,569,1090
KWALE,LUNGA LUNGA,47,632,601,1233
KWALE,LUNGA LUNGA,48,439,474,913
KWALE,LUNGA LUNGA,49,457,431,888
KWALE,LUNGA LUNGA,45-49,3049,3050,6099
KWALE,LUNGA LUNGA,50,878,909,1787
KWALE,LUNGA LUNGA,51,493,380,873
KWALE,LUNGA LUNGA,52,387,296,683
KWALE,LUNGA LUNGA,53,260,161,421
KWALE,LUNGA LUNGA,54,302,226,528
KWALE,LUNGA LUNGA,50-54,2320,1972,4292
KWALE,LUNGA LUNGA,55,424,351,775
KWALE,LUNGA LUNGA,56,434,376,810
KWALE,LUNGA LUNGA,57,392,368,760
KWALE,LUNGA LUNGA,58,326,295,621
KWALE,LUNGA LUNGA,59,404,476,880
KWALE,LUNGA LUNGA,55-59,1980,1866,3846
KWALE,LUNGA LUNGA,60,570,870,1440
KWALE,LUNGA LUNGA,61,278,357,635
KWALE,LUNGA LUNGA,62,310,291,601
KWALE,LUNGA LUNGA,63,272,308,580
KWALE,LUNGA LUNGA,64,228,227,455
KWALE,LUNGA LUNGA,60-64,1658,2053,3711
KWALE,LUNGA LUNGA,65,451,504,955
KWALE,LUNGA LUNGA,66,239,218,457
KWALE,LUNGA LUNGA,67,339,302,641
KWALE,LUNGA LUNGA,68,209,211,420
KWALE,LUNGA LUNGA,69,273,344,617
KWALE,LUNGA LUNGA,65-69,1511,1579,3090
KWALE,LUNGA LUNGA,70,512,673,1185
KWALE,LUNGA LUNGA,71,147,166,313
KWALE,LUNGA LUNGA,72,157,194,351
KWALE,LUNGA LUNGA,73,116,105,221
KWALE,LUNGA LUNGA,74,148,149,297
KWALE,LUNGA LUNGA,70-74,1080,1287,2367
KWALE,LUNGA LUNGA,75,183,189,372
KWALE,LUNGA LUNGA,76,86,69,155
KWALE,LUNGA LUNGA,77,103,97,200
KWALE,LUNGA LUNGA,78,86,81,167
KWALE,LUNGA LUNGA,79,110,144,254
KWALE,LUNGA LUNGA,75-79,568,580,1148
KWALE,LUNGA LUNGA,80,161,249,410
KWALE,LUNGA LUNGA,81,56,49,105
KWALE,LUNGA LUNGA,82,52,48,100
KWALE,LUNGA LUNGA,83,33,59,92
KWALE,LUNGA LUNGA,84,44,49,93
KWALE,LUNGA LUNGA,80-84,346,454,800
KWALE,LUNGA LUNGA,85,64,73,137
KWALE,LUNGA LUNGA,86,27,24,51
KWALE,LUNGA LUNGA,87,31,40,71
KWALE,LUNGA LUNGA,88,22,26,48
KWALE,LUNGA LUNGA,89,53,62,115
KWALE,LUNGA LUNGA,85-89,197,225,422
KWALE,LUNGA LUNGA,90,30,74,104
KWALE,LUNGA LUNGA,91,9,14,23
KWALE,LUNGA LUNGA,92,11,7,18
KWALE,LUNGA LUNGA,93,7,7,14
KWALE,LUNGA LUNGA,94,10,9,19
KWALE,LUNGA LUNGA,90-94,67,111,178
KWALE,LUNGA LUNGA,95,8,11,19
KWALE,LUNGA LUNGA,96,2,7,9
KWALE,LUNGA LUNGA,97,6,3,9
KWALE,LUNGA LUNGA,98,1,8,9
KWALE,LUNGA LUNGA,99,15,15,30
KWALE,LUNGA LUNGA,95-99,32,44,76
KWALE,LUNGA LUNGA,100+,24,45,69
KWALE,LUNGA LUNGA,Not Stated,-,-,-
KWALE,MATUGA,Total,95831,98419,194250
KWALE,MATUGA,0,2469,2478,4947
KWALE,MATUGA,1,2600,2538,5138
KWALE,MATUGA,2,2661,2600,5261
KWALE,MATUGA,3,2686,2722,5408
KWALE,MATUGA,4,2905,2752,5657
KWALE,MATUGA,0 - 4,13321,13090,26411
KWALE,MATUGA,5,3097,2898,5995
KWALE,MATUGA,6,2974,2784,5758
KWALE,MATUGA,7,2808,2596,5404
KWALE,MATUGA,8,2659,2550,5209
KWALE,MATUGA,9,2742,2581,5323
KWALE,MATUGA,05-Sep,14280,13409,27689
KWALE,MATUGA,10,2835,2771,5606
KWALE,MATUGA,11,2524,2547,5071
KWALE,MATUGA,12,2763,2762,5525
KWALE,MATUGA,13,3056,3025,6081
KWALE,MATUGA,14,2635,2577,5212
KWALE,MATUGA,Oct-14,13813,13682,27495
KWALE,MATUGA,15,2476,2415,4891
KWALE,MATUGA,16,2295,2284,4579
KWALE,MATUGA,17,2413,2243,4656
KWALE,MATUGA,18,2193,2055,4248
KWALE,MATUGA,19,2131,2134,4265
KWALE,MATUGA,15-19,11508,11131,22639
KWALE,MATUGA,20,1906,2096,4002
KWALE,MATUGA,21,1388,1547,2935
KWALE,MATUGA,22,1486,1752,3238
KWALE,MATUGA,23,1444,1713,3157
KWALE,MATUGA,24,1306,1555,2861
KWALE,MATUGA,20-24,7530,8663,16193
KWALE,MATUGA,25,1596,1767,3363
KWALE,MATUGA,26,1325,1552,2877
KWALE,MATUGA,27,1262,1455,2717
KWALE,MATUGA,28,1101,1381,2482
KWALE,MATUGA,29,1043,1332,2375
KWALE,MATUGA,25-29,6327,7487,13814
KWALE,MATUGA,30,1527,1879,3406
KWALE,MATUGA,31,1015,1141,2156
KWALE,MATUGA,32,1187,1401,2588
KWALE,MATUGA,33,975,1207,2182
KWALE,MATUGA,34,990,1103,2093
KWALE,MATUGA,30-34,5694,6731,12425
KWALE,MATUGA,35,1278,1410,2688
KWALE,MATUGA,36,900,963,1863
KWALE,MATUGA,37,892,854,1746
KWALE,MATUGA,38,679,700,1379
KWALE,MATUGA,39,791,776,1567
KWALE,MATUGA,35-39,4540,4703,9243
KWALE,MATUGA,40,1148,1137,2285
KWALE,MATUGA,41,894,951,1845
KWALE,MATUGA,42,861,976,1837
KWALE,MATUGA,43,736,861,1597
KWALE,MATUGA,44,638,659,1297
KWALE,MATUGA,40-44,4277,4584,8861
KWALE,MATUGA,45,1126,1078,2204
KWALE,MATUGA,46,649,755,1404
KWALE,MATUGA,47,728,700,1428
KWALE,MATUGA,48,562,523,1085
KWALE,MATUGA,49,624,531,1155
KWALE,MATUGA,45-49,3689,3587,7276
KWALE,MATUGA,50,932,881,1813
KWALE,MATUGA,51,582,515,1097
KWALE,MATUGA,52,440,373,813
KWALE,MATUGA,53,304,254,558
KWALE,MATUGA,54,403,299,702
KWALE,MATUGA,50-54,2661,2322,4983
KWALE,MATUGA,55,449,365,814
KWALE,MATUGA,56,525,484,1009
KWALE,MATUGA,57,410,434,844
KWALE,MATUGA,58,399,343,742
KWALE,MATUGA,59,424,503,927
KWALE,MATUGA,55-59,2207,2129,4336
KWALE,MATUGA,60,650,843,1493
KWALE,MATUGA,61,360,461,821
KWALE,MATUGA,62,366,372,738
KWALE,MATUGA,63,390,456,846
KWALE,MATUGA,64,321,329,650
KWALE,MATUGA,60-64,2087,2461,4548
KWALE,MATUGA,65,459,538,997
KWALE,MATUGA,66,286,232,518
KWALE,MATUGA,67,360,348,708
KWALE,MATUGA,68,205,212,417
KWALE,MATUGA,69,257,368,625
KWALE,MATUGA,65-69,1567,1698,3265
KWALE,MATUGA,70,381,680,1061
KWALE,MATUGA,71,195,195,390
KWALE,MATUGA,72,192,167,359
KWALE,MATUGA,73,157,109,266
KWALE,MATUGA,74,148,164,312
KWALE,MATUGA,70-74,1073,1315,2388
KWALE,MATUGA,75,191,188,379
KWALE,MATUGA,76,80,93,173
KWALE,MATUGA,77,113,100,213
KWALE,MATUGA,78,103,60,163
KWALE,MATUGA,79,107,123,230
KWALE,MATUGA,75-79,594,564,1158
KWALE,MATUGA,80,133,250,383
KWALE,MATUGA,81,64,57,121
KWALE,MATUGA,82,48,42,90
KWALE,MATUGA,83,58,49,107
KWALE,MATUGA,84,51,75,126
KWALE,MATUGA,80-84,354,473,827
KWALE,MATUGA,85,49,79,128
KWALE,MATUGA,86,30,26,56
KWALE,MATUGA,87,27,32,59
KWALE,MATUGA,88,21,18,39
KWALE,MATUGA,89,37,63,100
KWALE,MATUGA,85-89,164,218,382
KWALE,MATUGA,90,33,61,94
KWALE,MATUGA,91,12,15,27
KWALE,MATUGA,92,16,12,28
KWALE,MATUGA,93,6,6,12
KWALE,MATUGA,94,13,10,23
KWALE,MATUGA,90-94,80,104,184
KWALE,MATUGA,95,11,9,20
KWALE,MATUGA,96,7,5,12
KWALE,MATUGA,97,4,4,8
KWALE,MATUGA,98,10,4,14
KWALE,MATUGA,99,8,7,15
KWALE,MATUGA,95-99,40,29,69
KWALE,MATUGA,100+,25,36,61
KWALE,MATUGA,Not Stated,-,3,3
KWALE,MSAMBWENI,Total,89206,88480,177686
KWALE,MSAMBWENI,0,2283,2197,4480
KWALE,MSAMBWENI,1,2283,2189,4472
KWALE,MSAMBWENI,2,2211,2224,4435
KWALE,MSAMBWENI,3,2259,2154,4413
KWALE,MSAMBWENI,4,2485,2436,4921
KWALE,MSAMBWENI,0 - 4,11521,11200,22721
KWALE,MSAMBWENI,5,2503,2494,4997
KWALE,MSAMBWENI,6,2240,2175,4415
KWALE,MSAMBWENI,7,2181,2146,4327
KWALE,MSAMBWENI,8,1899,2012,3911
KWALE,MSAMBWENI,9,2107,2123,4230
KWALE,MSAMBWENI,05-Sep,10930,10950,21880
KWALE,MSAMBWENI,10,2166,2081,4247
KWALE,MSAMBWENI,11,1876,1943,3819
KWALE,MSAMBWENI,12,2014,2090,4104
KWALE,MSAMBWENI,13,2138,2225,4363
KWALE,MSAMBWENI,14,2056,2001,4057
KWALE,MSAMBWENI,Oct-14,10250,10340,20590
KWALE,MSAMBWENI,15,1832,1803,3635
KWALE,MSAMBWENI,16,1737,1745,3482
KWALE,MSAMBWENI,17,1780,1743,3523
KWALE,MSAMBWENI,18,1728,1693,3421
KWALE,MSAMBWENI,19,1776,1899,3675
KWALE,MSAMBWENI,15-19,8853,8883,17736
KWALE,MSAMBWENI,20,1819,2083,3902
KWALE,MSAMBWENI,21,1453,1726,3179
KWALE,MSAMBWENI,22,1709,1992,3701
KWALE,MSAMBWENI,23,1693,1974,3667
KWALE,MSAMBWENI,24,1692,1886,3578
KWALE,MSAMBWENI,20-24,8366,9661,18027
KWALE,MSAMBWENI,25,2031,2110,4141
KWALE,MSAMBWENI,26,1700,1844,3544
KWALE,MSAMBWENI,27,1719,1781,3500
KWALE,MSAMBWENI,28,1449,1618,3067
KWALE,MSAMBWENI,29,1377,1615,2992
KWALE,MSAMBWENI,25-29,8276,8968,17244
KWALE,MSAMBWENI,30,2061,2167,4228
KWALE,MSAMBWENI,31,1243,1264,2507
KWALE,MSAMBWENI,32,1537,1596,3133
KWALE,MSAMBWENI,33,1229,1358,2587
KWALE,MSAMBWENI,34,1174,1221,2395
KWALE,MSAMBWENI,30-34,7244,7606,14850
KWALE,MSAMBWENI,35,1658,1491,3149
KWALE,MSAMBWENI,36,1088,1058,2146
KWALE,MSAMBWENI,37,1100,1014,2114
KWALE,MSAMBWENI,38,876,842,1718
KWALE,MSAMBWENI,39,882,775,1657
KWALE,MSAMBWENI,35-39,5604,5180,10784
KWALE,MSAMBWENI,40,1355,1225,2580
KWALE,MSAMBWENI,41,983,905,1888
KWALE,MSAMBWENI,42,1005,897,1902
KWALE,MSAMBWENI,43,805,778,1583
KWALE,MSAMBWENI,44,783,672,1455
KWALE,MSAMBWENI,40-44,4931,4477,9408
KWALE,MSAMBWENI,45,1223,965,2188
KWALE,MSAMBWENI,46,730,625,1355
KWALE,MSAMBWENI,47,781,619,1400
KWALE,MSAMBWENI,48,582,460,1042
KWALE,MSAMBWENI,49,693,429,1122
KWALE,MSAMBWENI,45-49,4009,3098,7107
KWALE,MSAMBWENI,50,1005,873,1878
KWALE,MSAMBWENI,51,596,429,1025
KWALE,MSAMBWENI,52,511,323,834
KWALE,MSAMBWENI,53,348,224,572
KWALE,MSAMBWENI,54,441,218,659
KWALE,MSAMBWENI,50-54,2901,2067,4968
KWALE,MSAMBWENI,55,453,301,754
KWALE,MSAMBWENI,56,524,373,897
KWALE,MSAMBWENI,57,427,328,755
KWALE,MSAMBWENI,58,311,276,587
KWALE,MSAMBWENI,59,341,350,691
KWALE,MSAMBWENI,55-59,2056,1628,3684
KWALE,MSAMBWENI,60,524,618,1142
KWALE,MSAMBWENI,61,243,274,517
KWALE,MSAMBWENI,62,257,226,483
KWALE,MSAMBWENI,63,251,264,515
KWALE,MSAMBWENI,64,220,179,399
KWALE,MSAMBWENI,60-64,1495,1561,3056
KWALE,MSAMBWENI,65,356,347,703
KWALE,MSAMBWENI,66,214,173,387
KWALE,MSAMBWENI,67,324,228,552
KWALE,MSAMBWENI,68,170,123,293
KWALE,MSAMBWENI,69,181,212,393
KWALE,MSAMBWENI,65-69,1245,1083,2328
KWALE,MSAMBWENI,70,295,455,750
KWALE,MSAMBWENI,71,131,131,262
KWALE,MSAMBWENI,72,132,107,239
KWALE,MSAMBWENI,73,112,90,202
KWALE,MSAMBWENI,74,99,100,199
KWALE,MSAMBWENI,70-74,769,883,1652
KWALE,MSAMBWENI,75,133,116,249
KWALE,MSAMBWENI,76,70,57,127
KWALE,MSAMBWENI,77,58,71,129
KWALE,MSAMBWENI,78,47,50,97
KWALE,MSAMBWENI,79,60,80,140
KWALE,MSAMBWENI,75-79,368,374,742
KWALE,MSAMBWENI,80,104,165,269
KWALE,MSAMBWENI,81,37,45,82
KWALE,MSAMBWENI,82,34,36,70
KWALE,MSAMBWENI,83,23,34,57
KWALE,MSAMBWENI,84,33,34,67
KWALE,MSAMBWENI,80-84,231,314,545
KWALE,MSAMBWENI,85,24,39,63
KWALE,MSAMBWENI,86,30,17,47
KWALE,MSAMBWENI,87,21,15,36
KWALE,MSAMBWENI,88,10,15,25
KWALE,MSAMBWENI,89,14,27,41
KWALE,MSAMBWENI,85-89,99,113,212
KWALE,MSAMBWENI,90,17,45,62
KWALE,MSAMBWENI,91,9,5,14
KWALE,MSAMBWENI,92,5,1,6
KWALE,MSAMBWENI,93,1,1,2
KWALE,MSAMBWENI,94,3,4,7
KWALE,MSAMBWENI,90-94,35,56,91
KWALE,MSAMBWENI,95,4,4,8
KWALE,MSAMBWENI,96,3,3,6
KWALE,MSAMBWENI,97,1,4,5
KWALE,MSAMBWENI,98,1,3,4
KWALE,MSAMBWENI,99,2,5,7
KWALE,MSAMBWENI,95-99,11,19,30
KWALE,MSAMBWENI,100+,11,18,29
KWALE,MSAMBWENI,Not Stated,1,1,2
KWALE,SAMBURU,Total,97497,104731,202228
KWALE,SAMBURU,0,3143,3241,6384
KWALE,SAMBURU,1,3228,3146,6374
KWALE,SAMBURU,2,3451,3393,6844
KWALE,SAMBURU,3,3449,3388,6837
KWALE,SAMBURU,4,3462,3499,6961
KWALE,SAMBURU,0 - 4,16733,16667,33400
KWALE,SAMBURU,5,3746,3603,7349
KWALE,SAMBURU,6,3294,3264,6558
KWALE,SAMBURU,7,3300,3169,6469
KWALE,SAMBURU,8,3057,3101,6158
KWALE,SAMBURU,9,3288,3172,6460
KWALE,SAMBURU,05-Sep,16685,16309,32994
KWALE,SAMBURU,10,3184,3303,6487
KWALE,SAMBURU,11,3051,3130,6181
KWALE,SAMBURU,12,3401,3099,6500
KWALE,SAMBURU,13,3170,3181,6351
KWALE,SAMBURU,14,2795,2748,5543
KWALE,SAMBURU,Oct-14,15601,15461,31062
KWALE,SAMBURU,15,2583,2484,5067
KWALE,SAMBURU,16,2481,2373,4854
KWALE,SAMBURU,17,2372,2190,4562
KWALE,SAMBURU,18,2148,2034,4182
KWALE,SAMBURU,19,1975,2095,4070
KWALE,SAMBURU,15-19,11559,11176,22735
KWALE,SAMBURU,20,1935,2182,4117
KWALE,SAMBURU,21,1376,1691,3067
KWALE,SAMBURU,22,1401,1791,3192
KWALE,SAMBURU,23,1328,1795,3123
KWALE,SAMBURU,24,1259,1587,2846
KWALE,SAMBURU,20-24,7299,9046,16345
KWALE,SAMBURU,25,1546,1869,3415
KWALE,SAMBURU,26,1189,1528,2717
KWALE,SAMBURU,27,1255,1566,2821
KWALE,SAMBURU,28,1085,1396,2481
KWALE,SAMBURU,29,1057,1419,2476
KWALE,SAMBURU,25-29,6132,7778,13910
KWALE,SAMBURU,30,1326,2036,3362
KWALE,SAMBURU,31,920,1352,2272
KWALE,SAMBURU,32,1062,1564,2626
KWALE,SAMBURU,33,855,1248,2103
KWALE,SAMBURU,34,931,1200,2131
KWALE,SAMBURU,30-34,5094,7400,12494
KWALE,SAMBURU,35,1124,1374,2498
KWALE,SAMBURU,36,778,940,1718
KWALE,SAMBURU,37,689,795,1484
KWALE,SAMBURU,38,554,631,1185
KWALE,SAMBURU,39,594,640,1234
KWALE,SAMBURU,35-39,3739,4380,8119
KWALE,SAMBURU,40,874,966,1840
KWALE,SAMBURU,41,705,763,1468
KWALE,SAMBURU,42,783,892,1675
KWALE,SAMBURU,43,674,744,1418
KWALE,SAMBURU,44,606,633,1239
KWALE,SAMBURU,40-44,3642,3998,7640
KWALE,SAMBURU,45,793,877,1670
KWALE,SAMBURU,46,561,558,1119
KWALE,SAMBURU,47,597,521,1118
KWALE,SAMBURU,48,412,389,801
KWALE,SAMBURU,49,484,367,851
KWALE,SAMBURU,45-49,2847,2712,5559
KWALE,SAMBURU,50,638,627,1265
KWALE,SAMBURU,51,460,279,739
KWALE,SAMBURU,52,315,267,582
KWALE,SAMBURU,53,193,166,359
KWALE,SAMBURU,54,242,204,446
KWALE,SAMBURU,50-54,1848,1543,3391
KWALE,SAMBURU,55,299,250,549
KWALE,SAMBURU,56,367,385,752
KWALE,SAMBURU,57,305,388,693
KWALE,SAMBURU,58,277,283,560
KWALE,SAMBURU,59,354,532,886
KWALE,SAMBURU,55-59,1602,1838,3440
KWALE,SAMBURU,60,440,776,1216
KWALE,SAMBURU,61,287,444,731
KWALE,SAMBURU,62,273,339,612
KWALE,SAMBURU,63,309,405,714
KWALE,SAMBURU,64,217,280,497
KWALE,SAMBURU,60-64,1526,2244,3770
KWALE,SAMBURU,65,353,423,776
KWALE,SAMBURU,66,233,177,410
KWALE,SAMBURU,67,295,292,587
KWALE,SAMBURU,68,161,158,319
KWALE,SAMBURU,69,279,412,691
KWALE,SAMBURU,65-69,1321,1462,2783
KWALE,SAMBURU,70,324,523,847
KWALE,SAMBURU,71,113,210,323
KWALE,SAMBURU,72,111,158,269
KWALE,SAMBURU,73,137,150,287
KWALE,SAMBURU,74,148,191,339
KWALE,SAMBURU,70-74,833,1232,2065
KWALE,SAMBURU,75,142,172,314
KWALE,SAMBURU,76,92,110,202
KWALE,SAMBURU,77,85,117,202
KWALE,SAMBURU,78,67,63,130
KWALE,SAMBURU,79,101,147,248
KWALE,SAMBURU,75-79,487,609,1096
KWALE,SAMBURU,80,111,212,323
KWALE,SAMBURU,81,39,66,105
KWALE,SAMBURU,82,37,50,87
KWALE,SAMBURU,83,44,65,109
KWALE,SAMBURU,84,41,63,104
KWALE,SAMBURU,80-84,272,456,728
KWALE,SAMBURU,85,41,73,114
KWALE,SAMBURU,86,20,19,39
KWALE,SAMBURU,87,35,41,76
KWALE,SAMBURU,88,18,14,32
KWALE,SAMBURU,89,41,79,120
KWALE,SAMBURU,85-89,155,226,381
KWALE,SAMBURU,90,31,50,81
KWALE,SAMBURU,91,12,18,30
KWALE,SAMBURU,92,6,7,13
KWALE,SAMBURU,93,6,8,14
KWALE,SAMBURU,94,9,13,22
KWALE,SAMBURU,90-94,64,96,160
KWALE,SAMBURU,95,7,14,21
KWALE,SAMBURU,96,6,6,12
KWALE,SAMBURU,97,4,12,16
KWALE,SAMBURU,98,3,7,10
KWALE,SAMBURU,99,9,20,29
KWALE,SAMBURU,95-99,29,59,88
KWALE,SAMBURU,100+,24,37,61
KWALE,SAMBURU,Not Stated,5,2,7
LAIKIPIA,ALL,Total,259440,259102,518542
LAIKIPIA,ALL,0,6618,6446,13064
LAIKIPIA,ALL,1,6219,6071,12290
LAIKIPIA,ALL,2,6542,6395,12937
LAIKIPIA,ALL,3,6975,6811,13786
LAIKIPIA,ALL,4,6802,6662,13464
LAIKIPIA,ALL,0 - 4,33156,32385,65541
LAIKIPIA,ALL,5,6533,6421,12954
LAIKIPIA,ALL,6,6665,6464,13129
LAIKIPIA,ALL,7,6496,6481,12977
LAIKIPIA,ALL,8,6440,6217,12657
LAIKIPIA,ALL,9,6296,6231,12527
LAIKIPIA,ALL,05-Sep,32430,31814,64244
LAIKIPIA,ALL,10,7208,6962,14170
LAIKIPIA,ALL,11,5901,5808,11709
LAIKIPIA,ALL,12,7011,6412,13423
LAIKIPIA,ALL,13,6758,6627,13385
LAIKIPIA,ALL,14,6494,6116,12610
LAIKIPIA,ALL,Oct-14,33372,31925,65297
LAIKIPIA,ALL,15,6614,6067,12681
LAIKIPIA,ALL,16,5944,5746,11690
LAIKIPIA,ALL,17,6358,5675,12033
LAIKIPIA,ALL,18,5241,4776,10017
LAIKIPIA,ALL,19,5108,4931,10039
LAIKIPIA,ALL,15-19,29265,27195,56460
LAIKIPIA,ALL,20,4794,5032,9826
LAIKIPIA,ALL,21,4134,4299,8433
LAIKIPIA,ALL,22,4106,4587,8693
LAIKIPIA,ALL,23,4200,4502,8702
LAIKIPIA,ALL,24,3835,4081,7916
LAIKIPIA,ALL,20-24,21069,22501,43570
LAIKIPIA,ALL,25,4386,4406,8792
LAIKIPIA,ALL,26,3428,3791,7219
LAIKIPIA,ALL,27,3658,3771,7429
LAIKIPIA,ALL,28,3269,3502,6771
LAIKIPIA,ALL,29,3464,3598,7062
LAIKIPIA,ALL,25-29,18205,19068,37273
LAIKIPIA,ALL,30,4468,4993,9461
LAIKIPIA,ALL,31,3235,3361,6596
LAIKIPIA,ALL,32,3910,4249,8159
LAIKIPIA,ALL,33,3230,3449,6679
LAIKIPIA,ALL,34,3049,3283,6332
LAIKIPIA,ALL,30-34,17892,19335,37227
LAIKIPIA,ALL,35,4414,4392,8806
LAIKIPIA,ALL,36,2989,2837,5826
LAIKIPIA,ALL,37,2941,2694,5635
LAIKIPIA,ALL,38,2608,2364,4972
LAIKIPIA,ALL,39,2724,2657,5381
LAIKIPIA,ALL,35-39,15676,14944,30620
LAIKIPIA,ALL,40,3704,3328,7032
LAIKIPIA,ALL,41,2830,2773,5603
LAIKIPIA,ALL,42,2827,2709,5536
LAIKIPIA,ALL,43,2374,2305,4679
LAIKIPIA,ALL,44,1933,1969,3902
LAIKIPIA,ALL,40-44,13668,13084,26752
LAIKIPIA,ALL,45,3134,2906,6040
LAIKIPIA,ALL,46,2265,2266,4531
LAIKIPIA,ALL,47,2230,2186,4416
LAIKIPIA,ALL,48,1745,1647,3392
LAIKIPIA,ALL,49,1945,1915,3860
LAIKIPIA,ALL,45-49,11319,10920,22239
LAIKIPIA,ALL,50,2501,2559,5060
LAIKIPIA,ALL,51,1891,1730,3621
LAIKIPIA,ALL,52,1880,1838,3718
LAIKIPIA,ALL,53,1286,1349,2635
LAIKIPIA,ALL,54,1621,1605,3226
LAIKIPIA,ALL,50-54,9179,9081,18260
LAIKIPIA,ALL,55,1830,1685,3515
LAIKIPIA,ALL,56,1742,1673,3415
LAIKIPIA,ALL,57,1392,1548,2940
LAIKIPIA,ALL,58,1174,1341,2515
LAIKIPIA,ALL,59,1400,1467,2867
LAIKIPIA,ALL,55-59,7538,7714,15252
LAIKIPIA,ALL,60,1638,1834,3472
LAIKIPIA,ALL,61,1063,1142,2205
LAIKIPIA,ALL,62,1003,979,1982
LAIKIPIA,ALL,63,811,890,1701
LAIKIPIA,ALL,64,586,621,1207
LAIKIPIA,ALL,60-64,5101,5466,10567
LAIKIPIA,ALL,65,1006,1105,2111
LAIKIPIA,ALL,66,658,710,1368
LAIKIPIA,ALL,67,1090,1262,2352
LAIKIPIA,ALL,68,509,557,1066
LAIKIPIA,ALL,69,796,871,1667
LAIKIPIA,ALL,65-69,4059,4505,8564
LAIKIPIA,ALL,70,1105,1346,2451
LAIKIPIA,ALL,71,673,789,1462
LAIKIPIA,ALL,72,706,602,1308
LAIKIPIA,ALL,73,536,490,1026
LAIKIPIA,ALL,74,461,529,990
LAIKIPIA,ALL,70-74,3481,3756,7237
LAIKIPIA,ALL,75,457,577,1034
LAIKIPIA,ALL,76,471,767,1238
LAIKIPIA,ALL,77,352,402,754
LAIKIPIA,ALL,78,278,247,525
LAIKIPIA,ALL,79,306,385,691
LAIKIPIA,ALL,75-79,1864,2378,4242
LAIKIPIA,ALL,80,422,554,976
LAIKIPIA,ALL,81,194,275,469
LAIKIPIA,ALL,82,176,179,355
LAIKIPIA,ALL,83,196,200,396
LAIKIPIA,ALL,84,173,214,387
LAIKIPIA,ALL,80-84,1161,1422,2583
LAIKIPIA,ALL,85,149,181,330
LAIKIPIA,ALL,86,116,189,305
LAIKIPIA,ALL,87,122,131,253
LAIKIPIA,ALL,88,60,72,132
LAIKIPIA,ALL,89,139,222,361
LAIKIPIA,ALL,85-89,586,795,1381
LAIKIPIA,ALL,90,76,164,240
LAIKIPIA,ALL,91,84,115,199
LAIKIPIA,ALL,92,40,49,89
LAIKIPIA,ALL,93,24,43,67
LAIKIPIA,ALL,94,22,50,72
LAIKIPIA,ALL,90-94,246,421,667
LAIKIPIA,ALL,95,37,75,112
LAIKIPIA,ALL,96,15,35,50
LAIKIPIA,ALL,97,23,43,66
LAIKIPIA,ALL,98,17,24,41
LAIKIPIA,ALL,99,21,60,81
LAIKIPIA,ALL,95-99,113,237,350
LAIKIPIA,ALL,100+,57,154,211
LAIKIPIA,ALL,Not Stated,3,2,5
LAIKIPIA,LAIKIPIA CENTRAL,Total,47888,47705,95593
LAIKIPIA,LAIKIPIA CENTRAL,0,1031,986,2017
LAIKIPIA,LAIKIPIA CENTRAL,1,1049,1006,2055
LAIKIPIA,LAIKIPIA CENTRAL,2,1020,966,1986
LAIKIPIA,LAIKIPIA CENTRAL,3,1095,1062,2157
LAIKIPIA,LAIKIPIA CENTRAL,4,1098,1034,2132
LAIKIPIA,LAIKIPIA CENTRAL,0 - 4,5293,5054,10347
LAIKIPIA,LAIKIPIA CENTRAL,5,1037,1021,2058
LAIKIPIA,LAIKIPIA CENTRAL,6,1097,971,2068
LAIKIPIA,LAIKIPIA CENTRAL,7,1124,1037,2161
LAIKIPIA,LAIKIPIA CENTRAL,8,1029,1055,2084
LAIKIPIA,LAIKIPIA CENTRAL,9,1189,1109,2298
LAIKIPIA,LAIKIPIA CENTRAL,05-Sep,5476,5193,10669
LAIKIPIA,LAIKIPIA CENTRAL,10,1137,1042,2179
LAIKIPIA,LAIKIPIA CENTRAL,11,1026,1020,2046
LAIKIPIA,LAIKIPIA CENTRAL,12,1177,1094,2271
LAIKIPIA,LAIKIPIA CENTRAL,13,1207,1194,2401
LAIKIPIA,LAIKIPIA CENTRAL,14,1079,1037,2116
LAIKIPIA,LAIKIPIA CENTRAL,Oct-14,5626,5387,11013
LAIKIPIA,LAIKIPIA CENTRAL,15,1140,1001,2141
LAIKIPIA,LAIKIPIA CENTRAL,16,1050,1039,2089
LAIKIPIA,LAIKIPIA CENTRAL,17,1188,962,2150
LAIKIPIA,LAIKIPIA CENTRAL,18,903,790,1693
LAIKIPIA,LAIKIPIA CENTRAL,19,867,768,1635
LAIKIPIA,LAIKIPIA CENTRAL,15-19,5148,4560,9708
LAIKIPIA,LAIKIPIA CENTRAL,20,764,785,1549
LAIKIPIA,LAIKIPIA CENTRAL,21,676,718,1394
LAIKIPIA,LAIKIPIA CENTRAL,22,651,700,1351
LAIKIPIA,LAIKIPIA CENTRAL,23,756,754,1510
LAIKIPIA,LAIKIPIA CENTRAL,24,621,731,1352
LAIKIPIA,LAIKIPIA CENTRAL,20-24,3468,3688,7156
LAIKIPIA,LAIKIPIA CENTRAL,25,676,735,1411
LAIKIPIA,LAIKIPIA CENTRAL,26,606,686,1292
LAIKIPIA,LAIKIPIA CENTRAL,27,663,679,1342
LAIKIPIA,LAIKIPIA CENTRAL,28,591,606,1197
LAIKIPIA,LAIKIPIA CENTRAL,29,636,670,1306
LAIKIPIA,LAIKIPIA CENTRAL,25-29,3172,3376,6548
LAIKIPIA,LAIKIPIA CENTRAL,30,794,926,1720
LAIKIPIA,LAIKIPIA CENTRAL,31,599,594,1193
LAIKIPIA,LAIKIPIA CENTRAL,32,734,825,1559
LAIKIPIA,LAIKIPIA CENTRAL,33,642,657,1299
LAIKIPIA,LAIKIPIA CENTRAL,34,588,676,1264
LAIKIPIA,LAIKIPIA CENTRAL,30-34,3357,3678,7035
LAIKIPIA,LAIKIPIA CENTRAL,35,878,885,1763
LAIKIPIA,LAIKIPIA CENTRAL,36,640,616,1256
LAIKIPIA,LAIKIPIA CENTRAL,37,597,609,1206
LAIKIPIA,LAIKIPIA CENTRAL,38,605,530,1135
LAIKIPIA,LAIKIPIA CENTRAL,39,585,603,1188
LAIKIPIA,LAIKIPIA CENTRAL,35-39,3305,3243,6548
LAIKIPIA,LAIKIPIA CENTRAL,40,712,657,1369
LAIKIPIA,LAIKIPIA CENTRAL,41,579,592,1171
LAIKIPIA,LAIKIPIA CENTRAL,42,601,554,1155
LAIKIPIA,LAIKIPIA CENTRAL,43,509,493,1002
LAIKIPIA,LAIKIPIA CENTRAL,44,497,443,940
LAIKIPIA,LAIKIPIA CENTRAL,40-44,2898,2739,5637
LAIKIPIA,LAIKIPIA CENTRAL,45,684,647,1331
LAIKIPIA,LAIKIPIA CENTRAL,46,487,528,1015
LAIKIPIA,LAIKIPIA CENTRAL,47,519,457,976
LAIKIPIA,LAIKIPIA CENTRAL,48,412,427,839
LAIKIPIA,LAIKIPIA CENTRAL,49,449,460,909
LAIKIPIA,LAIKIPIA CENTRAL,45-49,2551,2519,5070
LAIKIPIA,LAIKIPIA CENTRAL,50,508,601,1109
LAIKIPIA,LAIKIPIA CENTRAL,51,430,408,838
LAIKIPIA,LAIKIPIA CENTRAL,52,423,443,866
LAIKIPIA,LAIKIPIA CENTRAL,53,295,344,639
LAIKIPIA,LAIKIPIA CENTRAL,54,373,389,762
LAIKIPIA,LAIKIPIA CENTRAL,50-54,2029,2185,4214
LAIKIPIA,LAIKIPIA CENTRAL,55,419,419,838
LAIKIPIA,LAIKIPIA CENTRAL,56,414,422,836
LAIKIPIA,LAIKIPIA CENTRAL,57,326,389,715
LAIKIPIA,LAIKIPIA CENTRAL,58,263,300,563
LAIKIPIA,LAIKIPIA CENTRAL,59,331,344,675
LAIKIPIA,LAIKIPIA CENTRAL,55-59,1753,1874,3627
LAIKIPIA,LAIKIPIA CENTRAL,60,380,380,760
LAIKIPIA,LAIKIPIA CENTRAL,61,236,295,531
LAIKIPIA,LAIKIPIA CENTRAL,62,258,215,473
LAIKIPIA,LAIKIPIA CENTRAL,63,189,202,391
LAIKIPIA,LAIKIPIA CENTRAL,64,108,138,246
LAIKIPIA,LAIKIPIA CENTRAL,60-64,1171,1230,2401
LAIKIPIA,LAIKIPIA CENTRAL,65,207,239,446
LAIKIPIA,LAIKIPIA CENTRAL,66,181,166,347
LAIKIPIA,LAIKIPIA CENTRAL,67,267,308,575
LAIKIPIA,LAIKIPIA CENTRAL,68,130,135,265
LAIKIPIA,LAIKIPIA CENTRAL,69,185,167,352
LAIKIPIA,LAIKIPIA CENTRAL,65-69,970,1015,1985
LAIKIPIA,LAIKIPIA CENTRAL,70,260,266,526
LAIKIPIA,LAIKIPIA CENTRAL,71,158,181,339
LAIKIPIA,LAIKIPIA CENTRAL,72,194,170,364
LAIKIPIA,LAIKIPIA CENTRAL,73,137,102,239
LAIKIPIA,LAIKIPIA CENTRAL,74,94,115,209
LAIKIPIA,LAIKIPIA CENTRAL,70-74,843,834,1677
LAIKIPIA,LAIKIPIA CENTRAL,75,97,127,224
LAIKIPIA,LAIKIPIA CENTRAL,76,108,180,288
LAIKIPIA,LAIKIPIA CENTRAL,77,72,88,160
LAIKIPIA,LAIKIPIA CENTRAL,78,62,56,118
LAIKIPIA,LAIKIPIA CENTRAL,79,67,71,138
LAIKIPIA,LAIKIPIA CENTRAL,75-79,406,522,928
LAIKIPIA,LAIKIPIA CENTRAL,80,87,113,200
LAIKIPIA,LAIKIPIA CENTRAL,81,31,44,75
LAIKIPIA,LAIKIPIA CENTRAL,82,37,41,78
LAIKIPIA,LAIKIPIA CENTRAL,83,47,42,89
LAIKIPIA,LAIKIPIA CENTRAL,84,41,40,81
LAIKIPIA,LAIKIPIA CENTRAL,80-84,243,280,523
LAIKIPIA,LAIKIPIA CENTRAL,85,31,26,57
LAIKIPIA,LAIKIPIA CENTRAL,86,21,41,62
LAIKIPIA,LAIKIPIA CENTRAL,87,26,25,51
LAIKIPIA,LAIKIPIA CENTRAL,88,6,16,22
LAIKIPIA,LAIKIPIA CENTRAL,89,27,37,64
LAIKIPIA,LAIKIPIA CENTRAL,85-89,111,145,256
LAIKIPIA,LAIKIPIA CENTRAL,90,11,44,55
LAIKIPIA,LAIKIPIA CENTRAL,91,11,30,41
LAIKIPIA,LAIKIPIA CENTRAL,92,7,6,13
LAIKIPIA,LAIKIPIA CENTRAL,93,5,8,13
LAIKIPIA,LAIKIPIA CENTRAL,94,2,10,12
LAIKIPIA,LAIKIPIA CENTRAL,90-94,36,98,134
LAIKIPIA,LAIKIPIA CENTRAL,95,8,13,21
LAIKIPIA,LAIKIPIA CENTRAL,96,1,12,13
LAIKIPIA,LAIKIPIA CENTRAL,97,2,9,11
LAIKIPIA,LAIKIPIA CENTRAL,98,4,6,10
LAIKIPIA,LAIKIPIA CENTRAL,99,2,12,14
LAIKIPIA,LAIKIPIA CENTRAL,95-99,17,52,69
LAIKIPIA,LAIKIPIA CENTRAL,100+,14,31,45
LAIKIPIA,LAIKIPIA CENTRAL,Not Stated,1,2,3
LAIKIPIA,LAIKIPIA EAST,Total,52078,50732,102810
LAIKIPIA,LAIKIPIA EAST,0,1210,1179,2389
LAIKIPIA,LAIKIPIA EAST,1,1286,1238,2524
LAIKIPIA,LAIKIPIA EAST,2,1214,1168,2382
LAIKIPIA,LAIKIPIA EAST,3,1276,1267,2543
LAIKIPIA,LAIKIPIA EAST,4,1186,1227,2413
LAIKIPIA,LAIKIPIA EAST,0 - 4,6172,6079,12251
LAIKIPIA,LAIKIPIA EAST,5,1185,1135,2320
LAIKIPIA,LAIKIPIA EAST,6,1116,1124,2240
LAIKIPIA,LAIKIPIA EAST,7,1138,1225,2363
LAIKIPIA,LAIKIPIA EAST,8,1126,1100,2226
LAIKIPIA,LAIKIPIA EAST,9,1078,1124,2202
LAIKIPIA,LAIKIPIA EAST,05-Sep,5643,5708,11351
LAIKIPIA,LAIKIPIA EAST,10,1196,1222,2418
LAIKIPIA,LAIKIPIA EAST,11,1018,1030,2048
LAIKIPIA,LAIKIPIA EAST,12,1212,1075,2287
LAIKIPIA,LAIKIPIA EAST,13,1169,1164,2333
LAIKIPIA,LAIKIPIA EAST,14,1134,1093,2227
LAIKIPIA,LAIKIPIA EAST,Oct-14,5729,5584,11313
LAIKIPIA,LAIKIPIA EAST,15,1120,1042,2162
LAIKIPIA,LAIKIPIA EAST,16,987,1065,2052
LAIKIPIA,LAIKIPIA EAST,17,1169,1067,2236
LAIKIPIA,LAIKIPIA EAST,18,974,919,1893
LAIKIPIA,LAIKIPIA EAST,19,903,955,1858
LAIKIPIA,LAIKIPIA EAST,15-19,5153,5048,10201
LAIKIPIA,LAIKIPIA EAST,20,852,999,1851
LAIKIPIA,LAIKIPIA EAST,21,881,959,1840
LAIKIPIA,LAIKIPIA EAST,22,948,997,1945
LAIKIPIA,LAIKIPIA EAST,23,979,1067,2046
LAIKIPIA,LAIKIPIA EAST,24,943,1023,1966
LAIKIPIA,LAIKIPIA EAST,20-24,4603,5045,9648
LAIKIPIA,LAIKIPIA EAST,25,1164,1016,2180
LAIKIPIA,LAIKIPIA EAST,26,872,936,1808
LAIKIPIA,LAIKIPIA EAST,27,910,883,1793
LAIKIPIA,LAIKIPIA EAST,28,856,885,1741
LAIKIPIA,LAIKIPIA EAST,29,903,849,1752
LAIKIPIA,LAIKIPIA EAST,25-29,4705,4569,9274
LAIKIPIA,LAIKIPIA EAST,30,1098,1108,2206
LAIKIPIA,LAIKIPIA EAST,31,851,804,1655
LAIKIPIA,LAIKIPIA EAST,32,985,1023,2008
LAIKIPIA,LAIKIPIA EAST,33,802,806,1608
LAIKIPIA,LAIKIPIA EAST,34,758,768,1526
LAIKIPIA,LAIKIPIA EAST,30-34,4494,4509,9003
LAIKIPIA,LAIKIPIA EAST,35,1035,915,1950
LAIKIPIA,LAIKIPIA EAST,36,747,644,1391
LAIKIPIA,LAIKIPIA EAST,37,728,601,1329
LAIKIPIA,LAIKIPIA EAST,38,637,536,1173
LAIKIPIA,LAIKIPIA EAST,39,654,601,1255
LAIKIPIA,LAIKIPIA EAST,35-39,3801,3297,7098
LAIKIPIA,LAIKIPIA EAST,40,899,740,1639
LAIKIPIA,LAIKIPIA EAST,41,596,570,1166
LAIKIPIA,LAIKIPIA EAST,42,633,593,1226
LAIKIPIA,LAIKIPIA EAST,43,524,471,995
LAIKIPIA,LAIKIPIA EAST,44,427,365,792
LAIKIPIA,LAIKIPIA EAST,40-44,3079,2739,5818
LAIKIPIA,LAIKIPIA EAST,45,680,598,1278
LAIKIPIA,LAIKIPIA EAST,46,509,396,905
LAIKIPIA,LAIKIPIA EAST,47,484,447,931
LAIKIPIA,LAIKIPIA EAST,48,385,302,687
LAIKIPIA,LAIKIPIA EAST,49,418,389,807
LAIKIPIA,LAIKIPIA EAST,45-49,2476,2132,4608
LAIKIPIA,LAIKIPIA EAST,50,532,444,976
LAIKIPIA,LAIKIPIA EAST,51,389,276,665
LAIKIPIA,LAIKIPIA EAST,52,343,331,674
LAIKIPIA,LAIKIPIA EAST,53,302,247,549
LAIKIPIA,LAIKIPIA EAST,54,327,292,619
LAIKIPIA,LAIKIPIA EAST,50-54,1893,1590,3483
LAIKIPIA,LAIKIPIA EAST,55,368,269,637
LAIKIPIA,LAIKIPIA EAST,56,359,304,663
LAIKIPIA,LAIKIPIA EAST,57,292,252,544
LAIKIPIA,LAIKIPIA EAST,58,245,220,465
LAIKIPIA,LAIKIPIA EAST,59,260,252,512
LAIKIPIA,LAIKIPIA EAST,55-59,1524,1297,2821
LAIKIPIA,LAIKIPIA EAST,60,290,331,621
LAIKIPIA,LAIKIPIA EAST,61,195,180,375
LAIKIPIA,LAIKIPIA EAST,62,181,167,348
LAIKIPIA,LAIKIPIA EAST,63,145,172,317
LAIKIPIA,LAIKIPIA EAST,64,115,101,216
LAIKIPIA,LAIKIPIA EAST,60-64,926,951,1877
LAIKIPIA,LAIKIPIA EAST,65,169,175,344
LAIKIPIA,LAIKIPIA EAST,66,128,116,244
LAIKIPIA,LAIKIPIA EAST,67,191,192,383
LAIKIPIA,LAIKIPIA EAST,68,76,102,178
LAIKIPIA,LAIKIPIA EAST,69,139,140,279
LAIKIPIA,LAIKIPIA EAST,65-69,703,725,1428
LAIKIPIA,LAIKIPIA EAST,70,184,241,425
LAIKIPIA,LAIKIPIA EAST,71,105,131,236
LAIKIPIA,LAIKIPIA EAST,72,126,101,227
LAIKIPIA,LAIKIPIA EAST,73,82,82,164
LAIKIPIA,LAIKIPIA EAST,74,82,74,156
LAIKIPIA,LAIKIPIA EAST,70-74,579,629,1208
LAIKIPIA,LAIKIPIA EAST,75,74,63,137
LAIKIPIA,LAIKIPIA EAST,76,66,107,173
LAIKIPIA,LAIKIPIA EAST,77,66,54,120
LAIKIPIA,LAIKIPIA EAST,78,41,36,77
LAIKIPIA,LAIKIPIA EAST,79,32,55,87
LAIKIPIA,LAIKIPIA EAST,75-79,279,315,594
LAIKIPIA,LAIKIPIA EAST,80,69,98,167
LAIKIPIA,LAIKIPIA EAST,81,22,33,55
LAIKIPIA,LAIKIPIA EAST,82,32,34,66
LAIKIPIA,LAIKIPIA EAST,83,24,33,57
LAIKIPIA,LAIKIPIA EAST,84,26,35,61
LAIKIPIA,LAIKIPIA EAST,80-84,173,233,406
LAIKIPIA,LAIKIPIA EAST,85,21,32,53
LAIKIPIA,LAIKIPIA EAST,86,20,30,50
LAIKIPIA,LAIKIPIA EAST,87,16,18,34
LAIKIPIA,LAIKIPIA EAST,88,8,18,26
LAIKIPIA,LAIKIPIA EAST,89,23,36,59
LAIKIPIA,LAIKIPIA EAST,85-89,88,134,222
LAIKIPIA,LAIKIPIA EAST,90,16,25,41
LAIKIPIA,LAIKIPIA EAST,91,17,18,35
LAIKIPIA,LAIKIPIA EAST,92,4,12,16
LAIKIPIA,LAIKIPIA EAST,93,-,10,10
LAIKIPIA,LAIKIPIA EAST,94,1,9,10
LAIKIPIA,LAIKIPIA EAST,90-94,38,74,112
LAIKIPIA,LAIKIPIA EAST,95,5,18,23
LAIKIPIA,LAIKIPIA EAST,96,2,3,5
LAIKIPIA,LAIKIPIA EAST,97,3,8,11
LAIKIPIA,LAIKIPIA EAST,98,1,4,5
LAIKIPIA,LAIKIPIA EAST,99,1,14,15
LAIKIPIA,LAIKIPIA EAST,95-99,12,47,59
LAIKIPIA,LAIKIPIA EAST,100+,7,27,34
LAIKIPIA,LAIKIPIA EAST,Not Stated,1,-,1
LAIKIPIA,LAIKIPIA NORTH,Total,18067,18116,36183
LAIKIPIA,LAIKIPIA NORTH,0,643,636,1279
LAIKIPIA,LAIKIPIA NORTH,1,517,509,1026
LAIKIPIA,LAIKIPIA NORTH,2,628,635,1263
LAIKIPIA,LAIKIPIA NORTH,3,719,665,1384
LAIKIPIA,LAIKIPIA NORTH,4,761,784,1545
LAIKIPIA,LAIKIPIA NORTH,0 - 4,3268,3229,6497
LAIKIPIA,LAIKIPIA NORTH,5,695,687,1382
LAIKIPIA,LAIKIPIA NORTH,6,734,649,1383
LAIKIPIA,LAIKIPIA NORTH,7,575,581,1156
LAIKIPIA,LAIKIPIA NORTH,8,645,636,1281
LAIKIPIA,LAIKIPIA NORTH,9,501,475,976
LAIKIPIA,LAIKIPIA NORTH,05-Sep,3150,3028,6178
LAIKIPIA,LAIKIPIA NORTH,10,769,732,1501
LAIKIPIA,LAIKIPIA NORTH,11,461,430,891
LAIKIPIA,LAIKIPIA NORTH,12,654,575,1229
LAIKIPIA,LAIKIPIA NORTH,13,551,461,1012
LAIKIPIA,LAIKIPIA NORTH,14,530,464,994
LAIKIPIA,LAIKIPIA NORTH,Oct-14,2965,2662,5627
LAIKIPIA,LAIKIPIA NORTH,15,576,502,1078
LAIKIPIA,LAIKIPIA NORTH,16,430,373,803
LAIKIPIA,LAIKIPIA NORTH,17,422,345,767
LAIKIPIA,LAIKIPIA NORTH,18,376,380,756
LAIKIPIA,LAIKIPIA NORTH,19,333,331,664
LAIKIPIA,LAIKIPIA NORTH,15-19,2137,1931,4068
LAIKIPIA,LAIKIPIA NORTH,20,414,473,887
LAIKIPIA,LAIKIPIA NORTH,21,276,314,590
LAIKIPIA,LAIKIPIA NORTH,22,260,407,667
LAIKIPIA,LAIKIPIA NORTH,23,248,311,559
LAIKIPIA,LAIKIPIA NORTH,24,263,277,540
LAIKIPIA,LAIKIPIA NORTH,20-24,1461,1782,3243
LAIKIPIA,LAIKIPIA NORTH,25,309,364,673
LAIKIPIA,LAIKIPIA NORTH,26,224,231,455
LAIKIPIA,LAIKIPIA NORTH,27,239,286,525
LAIKIPIA,LAIKIPIA NORTH,28,212,225,437
LAIKIPIA,LAIKIPIA NORTH,29,175,226,401
LAIKIPIA,LAIKIPIA NORTH,25-29,1159,1332,2491
LAIKIPIA,LAIKIPIA NORTH,30,310,383,693
LAIKIPIA,LAIKIPIA NORTH,31,175,249,424
LAIKIPIA,LAIKIPIA NORTH,32,201,235,436
LAIKIPIA,LAIKIPIA NORTH,33,135,162,297
LAIKIPIA,LAIKIPIA NORTH,34,138,129,267
LAIKIPIA,LAIKIPIA NORTH,30-34,959,1158,2117
LAIKIPIA,LAIKIPIA NORTH,35,262,222,484
LAIKIPIA,LAIKIPIA NORTH,36,99,67,166
LAIKIPIA,LAIKIPIA NORTH,37,98,82,180
LAIKIPIA,LAIKIPIA NORTH,38,66,57,123
LAIKIPIA,LAIKIPIA NORTH,39,71,62,133
LAIKIPIA,LAIKIPIA NORTH,35-39,596,490,1086
LAIKIPIA,LAIKIPIA NORTH,40,194,181,375
LAIKIPIA,LAIKIPIA NORTH,41,128,120,248
LAIKIPIA,LAIKIPIA NORTH,42,147,202,349
LAIKIPIA,LAIKIPIA NORTH,43,69,90,159
LAIKIPIA,LAIKIPIA NORTH,44,51,42,93
LAIKIPIA,LAIKIPIA NORTH,40-44,589,635,1224
LAIKIPIA,LAIKIPIA NORTH,45,142,157,299
LAIKIPIA,LAIKIPIA NORTH,46,99,101,200
LAIKIPIA,LAIKIPIA NORTH,47,84,76,160
LAIKIPIA,LAIKIPIA NORTH,48,62,50,112
LAIKIPIA,LAIKIPIA NORTH,49,49,83,132
LAIKIPIA,LAIKIPIA NORTH,45-49,436,467,903
LAIKIPIA,LAIKIPIA NORTH,50,116,149,265
LAIKIPIA,LAIKIPIA NORTH,51,66,78,144
LAIKIPIA,LAIKIPIA NORTH,52,71,50,121
LAIKIPIA,LAIKIPIA NORTH,53,50,32,82
LAIKIPIA,LAIKIPIA NORTH,54,60,49,109
LAIKIPIA,LAIKIPIA NORTH,50-54,363,358,721
LAIKIPIA,LAIKIPIA NORTH,55,90,72,162
LAIKIPIA,LAIKIPIA NORTH,56,49,40,89
LAIKIPIA,LAIKIPIA NORTH,57,43,26,69
LAIKIPIA,LAIKIPIA NORTH,58,33,26,59
LAIKIPIA,LAIKIPIA NORTH,59,52,58,110
LAIKIPIA,LAIKIPIA NORTH,55-59,267,222,489
LAIKIPIA,LAIKIPIA NORTH,60,108,151,259
LAIKIPIA,LAIKIPIA NORTH,61,58,42,100
LAIKIPIA,LAIKIPIA NORTH,62,33,39,72
LAIKIPIA,LAIKIPIA NORTH,63,45,40,85
LAIKIPIA,LAIKIPIA NORTH,64,24,29,53
LAIKIPIA,LAIKIPIA NORTH,60-64,268,301,569
LAIKIPIA,LAIKIPIA NORTH,65,56,54,110
LAIKIPIA,LAIKIPIA NORTH,66,19,12,31
LAIKIPIA,LAIKIPIA NORTH,67,32,35,67
LAIKIPIA,LAIKIPIA NORTH,68,20,23,43
LAIKIPIA,LAIKIPIA NORTH,69,37,52,89
LAIKIPIA,LAIKIPIA NORTH,65-69,164,176,340
LAIKIPIA,LAIKIPIA NORTH,70,51,77,128
LAIKIPIA,LAIKIPIA NORTH,71,17,33,50
LAIKIPIA,LAIKIPIA NORTH,72,17,20,37
LAIKIPIA,LAIKIPIA NORTH,73,9,10,19
LAIKIPIA,LAIKIPIA NORTH,74,10,24,34
LAIKIPIA,LAIKIPIA NORTH,70-74,104,164,268
LAIKIPIA,LAIKIPIA NORTH,75,25,31,56
LAIKIPIA,LAIKIPIA NORTH,76,8,9,17
LAIKIPIA,LAIKIPIA NORTH,77,13,12,25
LAIKIPIA,LAIKIPIA NORTH,78,13,10,23
LAIKIPIA,LAIKIPIA NORTH,79,12,15,27
LAIKIPIA,LAIKIPIA NORTH,75-79,71,77,148
LAIKIPIA,LAIKIPIA NORTH,80,29,22,51
LAIKIPIA,LAIKIPIA NORTH,81,11,13,24
LAIKIPIA,LAIKIPIA NORTH,82,4,3,7
LAIKIPIA,LAIKIPIA NORTH,83,6,2,8
LAIKIPIA,LAIKIPIA NORTH,84,3,8,11
LAIKIPIA,LAIKIPIA NORTH,80-84,53,48,101
LAIKIPIA,LAIKIPIA NORTH,85,10,9,19
LAIKIPIA,LAIKIPIA NORTH,86,2,2,4
LAIKIPIA,LAIKIPIA NORTH,87,4,2,6
LAIKIPIA,LAIKIPIA NORTH,88,3,2,5
LAIKIPIA,LAIKIPIA NORTH,89,6,4,10
LAIKIPIA,LAIKIPIA NORTH,85-89,25,19,44
LAIKIPIA,LAIKIPIA NORTH,90,7,12,19
LAIKIPIA,LAIKIPIA NORTH,91,5,3,8
LAIKIPIA,LAIKIPIA NORTH,92,2,-,2
LAIKIPIA,LAIKIPIA NORTH,93,1,1,2
LAIKIPIA,LAIKIPIA NORTH,94,1,2,3
LAIKIPIA,LAIKIPIA NORTH,90-94,16,18,34
LAIKIPIA,LAIKIPIA NORTH,95,4,5,9
LAIKIPIA,LAIKIPIA NORTH,96,1,-,1
LAIKIPIA,LAIKIPIA NORTH,97,2,2,4
LAIKIPIA,LAIKIPIA NORTH,98,-,2,2
LAIKIPIA,LAIKIPIA NORTH,99,2,3,5
LAIKIPIA,LAIKIPIA NORTH,95-99,9,12,21
LAIKIPIA,LAIKIPIA NORTH,100+,7,7,14
LAIKIPIA,LAIKIPIA NORTH,Not Stated,-,-,-
LAIKIPIA,LAIKIPIA WEST,Total,65158,64102,129260
LAIKIPIA,LAIKIPIA WEST,0,1892,1786,3678
LAIKIPIA,LAIKIPIA WEST,1,1688,1635,3323
LAIKIPIA,LAIKIPIA WEST,2,1943,1918,3861
LAIKIPIA,LAIKIPIA WEST,3,1962,1975,3937
LAIKIPIA,LAIKIPIA WEST,4,1898,1818,3716
LAIKIPIA,LAIKIPIA WEST,0 - 4,9383,9132,18515
LAIKIPIA,LAIKIPIA WEST,5,1853,1834,3687
LAIKIPIA,LAIKIPIA WEST,6,1949,1863,3812
LAIKIPIA,LAIKIPIA WEST,7,1787,1767,3554
LAIKIPIA,LAIKIPIA WEST,8,1843,1740,3583
LAIKIPIA,LAIKIPIA WEST,9,1676,1559,3235
LAIKIPIA,LAIKIPIA WEST,05-Sep,9108,8763,17871
LAIKIPIA,LAIKIPIA WEST,10,2072,2012,4084
LAIKIPIA,LAIKIPIA WEST,11,1616,1609,3225
LAIKIPIA,LAIKIPIA WEST,12,1950,1741,3691
LAIKIPIA,LAIKIPIA WEST,13,1826,1739,3565
LAIKIPIA,LAIKIPIA WEST,14,1750,1620,3370
LAIKIPIA,LAIKIPIA WEST,Oct-14,9214,8721,17935
LAIKIPIA,LAIKIPIA WEST,15,1840,1663,3503
LAIKIPIA,LAIKIPIA WEST,16,1569,1379,2948
LAIKIPIA,LAIKIPIA WEST,17,1628,1418,3046
LAIKIPIA,LAIKIPIA WEST,18,1373,1180,2553
LAIKIPIA,LAIKIPIA WEST,19,1267,1236,2503
LAIKIPIA,LAIKIPIA WEST,15-19,7677,6876,14553
LAIKIPIA,LAIKIPIA WEST,20,1238,1319,2557
LAIKIPIA,LAIKIPIA WEST,21,994,968,1962
LAIKIPIA,LAIKIPIA WEST,22,977,1094,2071
LAIKIPIA,LAIKIPIA WEST,23,971,1051,2022
LAIKIPIA,LAIKIPIA WEST,24,851,873,1724
LAIKIPIA,LAIKIPIA WEST,20-24,5031,5305,10336
LAIKIPIA,LAIKIPIA WEST,25,1058,1080,2138
LAIKIPIA,LAIKIPIA WEST,26,799,821,1620
LAIKIPIA,LAIKIPIA WEST,27,807,831,1638
LAIKIPIA,LAIKIPIA WEST,28,718,767,1485
LAIKIPIA,LAIKIPIA WEST,29,755,779,1534
LAIKIPIA,LAIKIPIA WEST,25-29,4137,4278,8415
LAIKIPIA,LAIKIPIA WEST,30,1100,1247,2347
LAIKIPIA,LAIKIPIA WEST,31,708,760,1468
LAIKIPIA,LAIKIPIA WEST,32,868,925,1793
LAIKIPIA,LAIKIPIA WEST,33,679,748,1427
LAIKIPIA,LAIKIPIA WEST,34,663,679,1342
LAIKIPIA,LAIKIPIA WEST,30-34,4018,4359,8377
LAIKIPIA,LAIKIPIA WEST,35,1002,1033,2035
LAIKIPIA,LAIKIPIA WEST,36,604,572,1176
LAIKIPIA,LAIKIPIA WEST,37,607,504,1111
LAIKIPIA,LAIKIPIA WEST,38,526,454,980
LAIKIPIA,LAIKIPIA WEST,39,561,493,1054
LAIKIPIA,LAIKIPIA WEST,35-39,3300,3056,6356
LAIKIPIA,LAIKIPIA WEST,40,860,744,1604
LAIKIPIA,LAIKIPIA WEST,41,656,589,1245
LAIKIPIA,LAIKIPIA WEST,42,633,538,1171
LAIKIPIA,LAIKIPIA WEST,43,546,487,1033
LAIKIPIA,LAIKIPIA WEST,44,394,436,830
LAIKIPIA,LAIKIPIA WEST,40-44,3089,2794,5883
LAIKIPIA,LAIKIPIA WEST,45,723,612,1335
LAIKIPIA,LAIKIPIA WEST,46,481,487,968
LAIKIPIA,LAIKIPIA WEST,47,501,435,936
LAIKIPIA,LAIKIPIA WEST,48,360,312,672
LAIKIPIA,LAIKIPIA WEST,49,401,372,773
LAIKIPIA,LAIKIPIA WEST,45-49,2466,2218,4684
LAIKIPIA,LAIKIPIA WEST,50,574,563,1137
LAIKIPIA,LAIKIPIA WEST,51,353,351,704
LAIKIPIA,LAIKIPIA WEST,52,382,371,753
LAIKIPIA,LAIKIPIA WEST,53,233,277,510
LAIKIPIA,LAIKIPIA WEST,54,327,355,682
LAIKIPIA,LAIKIPIA WEST,50-54,1869,1917,3786
LAIKIPIA,LAIKIPIA WEST,55,402,386,788
LAIKIPIA,LAIKIPIA WEST,56,372,369,741
LAIKIPIA,LAIKIPIA WEST,57,265,342,607
LAIKIPIA,LAIKIPIA WEST,58,247,287,534
LAIKIPIA,LAIKIPIA WEST,59,293,325,618
LAIKIPIA,LAIKIPIA WEST,55-59,1579,1709,3288
LAIKIPIA,LAIKIPIA WEST,60,365,457,822
LAIKIPIA,LAIKIPIA WEST,61,243,262,505
LAIKIPIA,LAIKIPIA WEST,62,224,232,456
LAIKIPIA,LAIKIPIA WEST,63,199,200,399
LAIKIPIA,LAIKIPIA WEST,64,143,176,319
LAIKIPIA,LAIKIPIA WEST,60-64,1174,1327,2501
LAIKIPIA,LAIKIPIA WEST,65,266,300,566
LAIKIPIA,LAIKIPIA WEST,66,159,189,348
LAIKIPIA,LAIKIPIA WEST,67,278,313,591
LAIKIPIA,LAIKIPIA WEST,68,121,131,252
LAIKIPIA,LAIKIPIA WEST,69,195,261,456
LAIKIPIA,LAIKIPIA WEST,65-69,1019,1194,2213
LAIKIPIA,LAIKIPIA WEST,70,325,383,708
LAIKIPIA,LAIKIPIA WEST,71,182,212,394
LAIKIPIA,LAIKIPIA WEST,72,165,135,300
LAIKIPIA,LAIKIPIA WEST,73,133,117,250
LAIKIPIA,LAIKIPIA WEST,74,127,144,271
LAIKIPIA,LAIKIPIA WEST,70-74,932,991,1923
LAIKIPIA,LAIKIPIA WEST,75,119,158,277
LAIKIPIA,LAIKIPIA WEST,76,126,179,305
LAIKIPIA,LAIKIPIA WEST,77,100,108,208
LAIKIPIA,LAIKIPIA WEST,78,88,64,152
LAIKIPIA,LAIKIPIA WEST,79,82,114,196
LAIKIPIA,LAIKIPIA WEST,75-79,515,623,1138
LAIKIPIA,LAIKIPIA WEST,80,140,160,300
LAIKIPIA,LAIKIPIA WEST,81,65,91,156
LAIKIPIA,LAIKIPIA WEST,82,47,49,96
LAIKIPIA,LAIKIPIA WEST,83,54,64,118
LAIKIPIA,LAIKIPIA WEST,84,42,52,94
LAIKIPIA,LAIKIPIA WEST,80-84,348,416,764
LAIKIPIA,LAIKIPIA WEST,85,38,49,87
LAIKIPIA,LAIKIPIA WEST,86,35,53,88
LAIKIPIA,LAIKIPIA WEST,87,25,36,61
LAIKIPIA,LAIKIPIA WEST,88,19,16,35
LAIKIPIA,LAIKIPIA WEST,89,44,75,119
LAIKIPIA,LAIKIPIA WEST,85-89,161,229,390
LAIKIPIA,LAIKIPIA WEST,90,20,41,61
LAIKIPIA,LAIKIPIA WEST,91,24,25,49
LAIKIPIA,LAIKIPIA WEST,92,14,16,30
LAIKIPIA,LAIKIPIA WEST,93,7,11,18
LAIKIPIA,LAIKIPIA WEST,94,9,8,17
LAIKIPIA,LAIKIPIA WEST,90-94,74,101,175
LAIKIPIA,LAIKIPIA WEST,95,11,16,27
LAIKIPIA,LAIKIPIA WEST,96,6,10,16
LAIKIPIA,LAIKIPIA WEST,97,11,13,24
LAIKIPIA,LAIKIPIA WEST,98,8,3,11
LAIKIPIA,LAIKIPIA WEST,99,9,14,23
LAIKIPIA,LAIKIPIA WEST,95-99,45,56,101
LAIKIPIA,LAIKIPIA WEST,100+,18,37,55
LAIKIPIA,LAIKIPIA WEST,Not Stated,1,-,1
LAIKIPIA,NYAHURURU,Total,76249,78447,154696
LAIKIPIA,NYAHURURU,0,1842,1859,3701
LAIKIPIA,NYAHURURU,1,1679,1683,3362
LAIKIPIA,NYAHURURU,2,1737,1708,3445
LAIKIPIA,NYAHURURU,3,1923,1842,3765
LAIKIPIA,NYAHURURU,4,1859,1799,3658
LAIKIPIA,NYAHURURU,0 - 4,9040,8891,17931
LAIKIPIA,NYAHURURU,5,1763,1744,3507
LAIKIPIA,NYAHURURU,6,1769,1857,3626
LAIKIPIA,NYAHURURU,7,1872,1871,3743
LAIKIPIA,NYAHURURU,8,1797,1686,3483
LAIKIPIA,NYAHURURU,9,1852,1964,3816
LAIKIPIA,NYAHURURU,05-Sep,9053,9122,18175
LAIKIPIA,NYAHURURU,10,2034,1954,3988
LAIKIPIA,NYAHURURU,11,1780,1719,3499
LAIKIPIA,NYAHURURU,12,2018,1927,3945
LAIKIPIA,NYAHURURU,13,2005,2069,4074
LAIKIPIA,NYAHURURU,14,2001,1902,3903
LAIKIPIA,NYAHURURU,Oct-14,9838,9571,19409
LAIKIPIA,NYAHURURU,15,1938,1859,3797
LAIKIPIA,NYAHURURU,16,1908,1890,3798
LAIKIPIA,NYAHURURU,17,1951,1883,3834
LAIKIPIA,NYAHURURU,18,1615,1507,3122
LAIKIPIA,NYAHURURU,19,1738,1641,3379
LAIKIPIA,NYAHURURU,15-19,9150,8780,17930
LAIKIPIA,NYAHURURU,20,1526,1456,2982
LAIKIPIA,NYAHURURU,21,1307,1340,2647
LAIKIPIA,NYAHURURU,22,1270,1389,2659
LAIKIPIA,NYAHURURU,23,1246,1319,2565
LAIKIPIA,NYAHURURU,24,1157,1177,2334
LAIKIPIA,NYAHURURU,20-24,6506,6681,13187
LAIKIPIA,NYAHURURU,25,1179,1211,2390
LAIKIPIA,NYAHURURU,26,927,1117,2044
LAIKIPIA,NYAHURURU,27,1039,1092,2131
LAIKIPIA,NYAHURURU,28,892,1019,1911
LAIKIPIA,NYAHURURU,29,995,1074,2069
LAIKIPIA,NYAHURURU,25-29,5032,5513,10545
LAIKIPIA,NYAHURURU,30,1166,1329,2495
LAIKIPIA,NYAHURURU,31,902,954,1856
LAIKIPIA,NYAHURURU,32,1122,1241,2363
LAIKIPIA,NYAHURURU,33,972,1076,2048
LAIKIPIA,NYAHURURU,34,902,1031,1933
LAIKIPIA,NYAHURURU,30-34,5064,5631,10695
LAIKIPIA,NYAHURURU,35,1237,1337,2574
LAIKIPIA,NYAHURURU,36,899,938,1837
LAIKIPIA,NYAHURURU,37,911,898,1809
LAIKIPIA,NYAHURURU,38,774,787,1561
LAIKIPIA,NYAHURURU,39,853,898,1751
LAIKIPIA,NYAHURURU,35-39,4674,4858,9532
LAIKIPIA,NYAHURURU,40,1039,1006,2045
LAIKIPIA,NYAHURURU,41,871,902,1773
LAIKIPIA,NYAHURURU,42,813,822,1635
LAIKIPIA,NYAHURURU,43,726,764,1490
LAIKIPIA,NYAHURURU,44,564,683,1247
LAIKIPIA,NYAHURURU,40-44,4013,4177,8190
LAIKIPIA,NYAHURURU,45,905,892,1797
LAIKIPIA,NYAHURURU,46,689,754,1443
LAIKIPIA,NYAHURURU,47,642,771,1413
LAIKIPIA,NYAHURURU,48,526,556,1082
LAIKIPIA,NYAHURURU,49,628,611,1239
LAIKIPIA,NYAHURURU,45-49,3390,3584,6974
LAIKIPIA,NYAHURURU,50,771,802,1573
LAIKIPIA,NYAHURURU,51,653,617,1270
LAIKIPIA,NYAHURURU,52,661,643,1304
LAIKIPIA,NYAHURURU,53,406,449,855
LAIKIPIA,NYAHURURU,54,534,520,1054
LAIKIPIA,NYAHURURU,50-54,3025,3031,6056
LAIKIPIA,NYAHURURU,55,551,539,1090
LAIKIPIA,NYAHURURU,56,548,538,1086
LAIKIPIA,NYAHURURU,57,466,539,1005
LAIKIPIA,NYAHURURU,58,386,508,894
LAIKIPIA,NYAHURURU,59,464,488,952
LAIKIPIA,NYAHURURU,55-59,2415,2612,5027
LAIKIPIA,NYAHURURU,60,495,515,1010
LAIKIPIA,NYAHURURU,61,331,363,694
LAIKIPIA,NYAHURURU,62,307,326,633
LAIKIPIA,NYAHURURU,63,233,276,509
LAIKIPIA,NYAHURURU,64,196,177,373
LAIKIPIA,NYAHURURU,60-64,1562,1657,3219
LAIKIPIA,NYAHURURU,65,308,337,645
LAIKIPIA,NYAHURURU,66,171,227,398
LAIKIPIA,NYAHURURU,67,322,414,736
LAIKIPIA,NYAHURURU,68,162,166,328
LAIKIPIA,NYAHURURU,69,240,251,491
LAIKIPIA,NYAHURURU,65-69,1203,1395,2598
LAIKIPIA,NYAHURURU,70,285,379,664
LAIKIPIA,NYAHURURU,71,211,232,443
LAIKIPIA,NYAHURURU,72,204,176,380
LAIKIPIA,NYAHURURU,73,175,179,354
LAIKIPIA,NYAHURURU,74,148,172,320
LAIKIPIA,NYAHURURU,70-74,1023,1138,2161
LAIKIPIA,NYAHURURU,75,142,198,340
LAIKIPIA,NYAHURURU,76,163,292,455
LAIKIPIA,NYAHURURU,77,101,140,241
LAIKIPIA,NYAHURURU,78,74,81,155
LAIKIPIA,NYAHURURU,79,113,130,243
LAIKIPIA,NYAHURURU,75-79,593,841,1434
LAIKIPIA,NYAHURURU,80,97,161,258
LAIKIPIA,NYAHURURU,81,65,94,159
LAIKIPIA,NYAHURURU,82,56,52,108
LAIKIPIA,NYAHURURU,83,65,59,124
LAIKIPIA,NYAHURURU,84,61,79,140
LAIKIPIA,NYAHURURU,80-84,344,445,789
LAIKIPIA,NYAHURURU,85,49,65,114
LAIKIPIA,NYAHURURU,86,38,63,101
LAIKIPIA,NYAHURURU,87,51,50,101
LAIKIPIA,NYAHURURU,88,24,20,44
LAIKIPIA,NYAHURURU,89,39,70,109
LAIKIPIA,NYAHURURU,85-89,201,268,469
LAIKIPIA,NYAHURURU,90,22,42,64
LAIKIPIA,NYAHURURU,91,27,39,66
LAIKIPIA,NYAHURURU,92,13,15,28
LAIKIPIA,NYAHURURU,93,11,13,24
LAIKIPIA,NYAHURURU,94,9,21,30
LAIKIPIA,NYAHURURU,90-94,82,130,212
LAIKIPIA,NYAHURURU,95,9,23,32
LAIKIPIA,NYAHURURU,96,5,10,15
LAIKIPIA,NYAHURURU,97,5,11,16
LAIKIPIA,NYAHURURU,98,4,9,13
LAIKIPIA,NYAHURURU,99,7,17,24
LAIKIPIA,NYAHURURU,95-99,30,70,100
LAIKIPIA,NYAHURURU,100+,11,52,63
LAIKIPIA,NYAHURURU,Not Stated,-,-,-
LAMU,ALL,Total,76103,67813,143916
LAMU,ALL,0,1824,1765,3589
LAMU,ALL,1,1808,1750,3558
LAMU,ALL,2,1949,1867,3816
LAMU,ALL,3,1968,1869,3837
LAMU,ALL,4,2055,1883,3938
LAMU,ALL,0 - 4,9604,9134,18738
LAMU,ALL,5,2014,1908,3922
LAMU,ALL,6,1949,1853,3802
LAMU,ALL,7,1810,1823,3633
LAMU,ALL,8,1901,1880,3781
LAMU,ALL,9,1831,1777,3608
LAMU,ALL,05-Sep,9505,9241,18746
LAMU,ALL,10,1962,1873,3835
LAMU,ALL,11,1740,1686,3426
LAMU,ALL,12,1995,1817,3812
LAMU,ALL,13,2024,1972,3996
LAMU,ALL,14,1771,1633,3404
LAMU,ALL,Oct-14,9492,8981,18473
LAMU,ALL,15,1673,1594,3267
LAMU,ALL,16,1613,1508,3121
LAMU,ALL,17,1678,1439,3117
LAMU,ALL,18,1497,1351,2848
LAMU,ALL,19,1462,1337,2799
LAMU,ALL,15-19,7923,7229,15152
LAMU,ALL,20,1473,1423,2896
LAMU,ALL,21,1251,1073,2324
LAMU,ALL,22,1555,1273,2828
LAMU,ALL,23,1421,1213,2634
LAMU,ALL,24,1434,1054,2488
LAMU,ALL,20-24,7134,6036,13170
LAMU,ALL,25,1613,1191,2804
LAMU,ALL,26,1387,1139,2526
LAMU,ALL,27,1328,1037,2365
LAMU,ALL,28,1119,882,2001
LAMU,ALL,29,1106,834,1940
LAMU,ALL,25-29,6553,5083,11636
LAMU,ALL,30,1397,1223,2620
LAMU,ALL,31,1130,941,2071
LAMU,ALL,32,1258,1078,2336
LAMU,ALL,33,980,849,1829
LAMU,ALL,34,909,791,1700
LAMU,ALL,30-34,5674,4882,10556
LAMU,ALL,35,1184,1017,2201
LAMU,ALL,36,929,791,1720
LAMU,ALL,37,852,718,1570
LAMU,ALL,38,629,534,1163
LAMU,ALL,39,707,500,1207
LAMU,ALL,35-39,4301,3560,7861
LAMU,ALL,40,1000,740,1740
LAMU,ALL,41,1037,933,1970
LAMU,ALL,42,769,632,1401
LAMU,ALL,43,606,480,1086
LAMU,ALL,44,484,405,889
LAMU,ALL,40-44,3896,3190,7086
LAMU,ALL,45,1008,932,1940
LAMU,ALL,46,647,507,1154
LAMU,ALL,47,617,402,1019
LAMU,ALL,48,478,346,824
LAMU,ALL,49,523,410,933
LAMU,ALL,45-49,3273,2597,5870
LAMU,ALL,50,749,623,1372
LAMU,ALL,51,514,395,909
LAMU,ALL,52,424,352,776
LAMU,ALL,53,289,233,522
LAMU,ALL,54,350,244,594
LAMU,ALL,50-54,2326,1847,4173
LAMU,ALL,55,417,292,709
LAMU,ALL,56,434,399,833
LAMU,ALL,57,365,364,729
LAMU,ALL,58,359,340,699
LAMU,ALL,59,397,401,798
LAMU,ALL,55-59,1972,1796,3768
LAMU,ALL,60,461,482,943
LAMU,ALL,61,277,348,625
LAMU,ALL,62,279,220,499
LAMU,ALL,63,286,230,516
LAMU,ALL,64,224,171,395
LAMU,ALL,60-64,1527,1451,2978
LAMU,ALL,65,314,327,641
LAMU,ALL,66,193,217,410
LAMU,ALL,67,264,195,459
LAMU,ALL,68,163,135,298
LAMU,ALL,69,220,169,389
LAMU,ALL,65-69,1154,1043,2197
LAMU,ALL,70,300,360,660
LAMU,ALL,71,169,218,387
LAMU,ALL,72,175,102,277
LAMU,ALL,73,139,79,218
LAMU,ALL,74,109,87,196
LAMU,ALL,70-74,892,846,1738
LAMU,ALL,75,121,125,246
LAMU,ALL,76,101,99,200
LAMU,ALL,77,80,45,125
LAMU,ALL,78,65,36,101
LAMU,ALL,79,68,60,128
LAMU,ALL,75-79,435,365,800
LAMU,ALL,80,94,137,231
LAMU,ALL,81,48,59,107
LAMU,ALL,82,28,24,52
LAMU,ALL,83,40,21,61
LAMU,ALL,84,39,27,66
LAMU,ALL,80-84,249,268,517
LAMU,ALL,85,30,32,62
LAMU,ALL,86,21,32,53
LAMU,ALL,87,28,19,47
LAMU,ALL,88,15,11,26
LAMU,ALL,89,15,23,38
LAMU,ALL,85-89,109,117,226
LAMU,ALL,90,19,39,58
LAMU,ALL,91,7,17,24
LAMU,ALL,92,10,5,15
LAMU,ALL,93,3,7,10
LAMU,ALL,94,10,8,18
LAMU,ALL,90-94,49,76,125
LAMU,ALL,95,6,8,14
LAMU,ALL,96,3,8,11
LAMU,ALL,97,4,5,9
LAMU,ALL,98,2,2,4
LAMU,ALL,99,3,12,15
LAMU,ALL,95-99,18,35,53
LAMU,ALL,100+,14,35,49
LAMU,ALL,Not Stated,3,1,4
LAMU,LAMU EAST,Total,11675,10583,22258
LAMU,LAMU EAST,0,239,249,488
LAMU,LAMU EAST,1,256,216,472
LAMU,LAMU EAST,2,333,283,616
LAMU,LAMU EAST,3,294,283,577
LAMU,LAMU EAST,4,347,289,636
LAMU,LAMU EAST,0 - 4,1469,1320,2789
LAMU,LAMU EAST,5,310,303,613
LAMU,LAMU EAST,6,269,243,512
LAMU,LAMU EAST,7,281,300,581
LAMU,LAMU EAST,8,280,303,583
LAMU,LAMU EAST,9,286,262,548
LAMU,LAMU EAST,05-Sep,1426,1411,2837
LAMU,LAMU EAST,10,287,259,546
LAMU,LAMU EAST,11,271,249,520
LAMU,LAMU EAST,12,297,288,585
LAMU,LAMU EAST,13,312,295,607
LAMU,LAMU EAST,14,283,274,557
LAMU,LAMU EAST,Oct-14,1450,1365,2815
LAMU,LAMU EAST,15,231,271,502
LAMU,LAMU EAST,16,243,264,507
LAMU,LAMU EAST,17,245,188,433
LAMU,LAMU EAST,18,222,233,455
LAMU,LAMU EAST,19,192,173,365
LAMU,LAMU EAST,15-19,1133,1129,2262
LAMU,LAMU EAST,20,224,176,400
LAMU,LAMU EAST,21,158,157,315
LAMU,LAMU EAST,22,221,179,400
LAMU,LAMU EAST,23,206,170,376
LAMU,LAMU EAST,24,211,131,342
LAMU,LAMU EAST,20-24,1020,813,1833
LAMU,LAMU EAST,25,231,143,374
LAMU,LAMU EAST,26,246,168,414
LAMU,LAMU EAST,27,222,123,345
LAMU,LAMU EAST,28,160,104,264
LAMU,LAMU EAST,29,153,106,259
LAMU,LAMU EAST,25-29,1012,644,1656
LAMU,LAMU EAST,30,212,146,358
LAMU,LAMU EAST,31,194,139,333
LAMU,LAMU EAST,32,208,154,362
LAMU,LAMU EAST,33,196,126,322
LAMU,LAMU EAST,34,103,105,208
LAMU,LAMU EAST,30-34,913,670,1583
LAMU,LAMU EAST,35,177,131,308
LAMU,LAMU EAST,36,161,169,330
LAMU,LAMU EAST,37,162,140,302
LAMU,LAMU EAST,38,75,67,142
LAMU,LAMU EAST,39,97,53,150
LAMU,LAMU EAST,35-39,672,560,1232
LAMU,LAMU EAST,40,150,105,255
LAMU,LAMU EAST,41,224,276,500
LAMU,LAMU EAST,42,95,85,180
LAMU,LAMU EAST,43,47,35,82
LAMU,LAMU EAST,44,41,37,78
LAMU,LAMU EAST,40-44,557,538,1095
LAMU,LAMU EAST,45,170,198,368
LAMU,LAMU EAST,46,99,88,187
LAMU,LAMU EAST,47,62,43,105
LAMU,LAMU EAST,48,49,27,76
LAMU,LAMU EAST,49,78,91,169
LAMU,LAMU EAST,45-49,458,447,905
LAMU,LAMU EAST,50,97,74,171
LAMU,LAMU EAST,51,95,111,206
LAMU,LAMU EAST,52,67,51,118
LAMU,LAMU EAST,53,34,27,61
LAMU,LAMU EAST,54,32,31,63
LAMU,LAMU EAST,50-54,325,294,619
LAMU,LAMU EAST,55,62,51,113
LAMU,LAMU EAST,56,80,134,214
LAMU,LAMU EAST,57,69,78,147
LAMU,LAMU EAST,58,62,63,125
LAMU,LAMU EAST,59,82,111,193
LAMU,LAMU EAST,55-59,355,437,792
LAMU,LAMU EAST,60,83,130,213
LAMU,LAMU EAST,61,51,84,135
LAMU,LAMU EAST,62,54,44,98
LAMU,LAMU EAST,63,56,50,106
LAMU,LAMU EAST,64,45,34,79
LAMU,LAMU EAST,60-64,289,342,631
LAMU,LAMU EAST,65,50,83,133
LAMU,LAMU EAST,66,49,52,101
LAMU,LAMU EAST,67,29,30,59
LAMU,LAMU EAST,68,23,23,46
LAMU,LAMU EAST,69,41,39,80
LAMU,LAMU EAST,65-69,192,227,419
LAMU,LAMU EAST,70,77,94,171
LAMU,LAMU EAST,71,42,76,118
LAMU,LAMU EAST,72,36,13,49
LAMU,LAMU EAST,73,30,14,44
LAMU,LAMU EAST,74,24,21,45
LAMU,LAMU EAST,70-74,209,218,427
LAMU,LAMU EAST,75,29,33,62
LAMU,LAMU EAST,76,19,17,36
LAMU,LAMU EAST,77,25,8,33
LAMU,LAMU EAST,78,16,6,22
LAMU,LAMU EAST,79,14,14,28
LAMU,LAMU EAST,75-79,103,78,181
LAMU,LAMU EAST,80,26,24,50
LAMU,LAMU EAST,81,12,10,22
LAMU,LAMU EAST,82,4,5,9
LAMU,LAMU EAST,83,4,4,8
LAMU,LAMU EAST,84,10,5,15
LAMU,LAMU EAST,80-84,56,48,104
LAMU,LAMU EAST,85,3,11,14
LAMU,LAMU EAST,86,5,5,10
LAMU,LAMU EAST,87,4,2,6
LAMU,LAMU EAST,88,4,1,5
LAMU,LAMU EAST,89,6,3,9
LAMU,LAMU EAST,85-89,22,22,44
LAMU,LAMU EAST,90,4,7,11
LAMU,LAMU EAST,91,3,3,6
LAMU,LAMU EAST,92,-,-,-
LAMU,LAMU EAST,93,1,-,1
LAMU,LAMU EAST,94,2,3,5
LAMU,LAMU EAST,90-94,10,13,23
LAMU,LAMU EAST,95,1,-,1
LAMU,LAMU EAST,96,1,-,1
LAMU,LAMU EAST,97,-,1,1
LAMU,LAMU EAST,98,-,-,-
LAMU,LAMU EAST,99,-,-,-
LAMU,LAMU EAST,95-99,2,1,3
LAMU,LAMU EAST,100+,2,6,8
LAMU,LAMU EAST,Not Stated,_,_,_
LAMU,LAMU WEST,Total,64428,57230,121658
LAMU,LAMU WEST,0,1585,1516,3101
LAMU,LAMU WEST,1,1552,1534,3086
LAMU,LAMU WEST,2,1616,1584,3200
LAMU,LAMU WEST,3,1674,1586,3260
LAMU,LAMU WEST,4,1708,1594,3302
LAMU,LAMU WEST,0 - 4,8135,7814,15949
LAMU,LAMU WEST,5,1704,1605,3309
LAMU,LAMU WEST,6,1680,1610,3290
LAMU,LAMU WEST,7,1529,1523,3052
LAMU,LAMU WEST,8,1621,1577,3198
LAMU,LAMU WEST,9,1545,1515,3060
LAMU,LAMU WEST,05-Sep,8079,7830,15909
LAMU,LAMU WEST,10,1675,1614,3289
LAMU,LAMU WEST,11,1469,1437,2906
LAMU,LAMU WEST,12,1698,1529,3227
LAMU,LAMU WEST,13,1712,1677,3389
LAMU,LAMU WEST,14,1488,1359,2847
LAMU,LAMU WEST,Oct-14,8042,7616,15658
LAMU,LAMU WEST,15,1442,1323,2765
LAMU,LAMU WEST,16,1370,1244,2614
LAMU,LAMU WEST,17,1433,1251,2684
LAMU,LAMU WEST,18,1275,1118,2393
LAMU,LAMU WEST,19,1270,1164,2434
LAMU,LAMU WEST,15-19,6790,6100,12890
LAMU,LAMU WEST,20,1249,1247,2496
LAMU,LAMU WEST,21,1093,916,2009
LAMU,LAMU WEST,22,1334,1094,2428
LAMU,LAMU WEST,23,1215,1043,2258
LAMU,LAMU WEST,24,1223,923,2146
LAMU,LAMU WEST,20-24,6114,5223,11337
LAMU,LAMU WEST,25,1382,1048,2430
LAMU,LAMU WEST,26,1141,971,2112
LAMU,LAMU WEST,27,1106,914,2020
LAMU,LAMU WEST,28,959,778,1737
LAMU,LAMU WEST,29,953,728,1681
LAMU,LAMU WEST,25-29,5541,4439,9980
LAMU,LAMU WEST,30,1185,1077,2262
LAMU,LAMU WEST,31,936,802,1738
LAMU,LAMU WEST,32,1050,924,1974
LAMU,LAMU WEST,33,784,723,1507
LAMU,LAMU WEST,34,806,686,1492
LAMU,LAMU WEST,30-34,4761,4212,8973
LAMU,LAMU WEST,35,1007,886,1893
LAMU,LAMU WEST,36,768,622,1390
LAMU,LAMU WEST,37,690,578,1268
LAMU,LAMU WEST,38,554,467,1021
LAMU,LAMU WEST,39,610,447,1057
LAMU,LAMU WEST,35-39,3629,3000,6629
LAMU,LAMU WEST,40,850,635,1485
LAMU,LAMU WEST,41,813,657,1470
LAMU,LAMU WEST,42,674,547,1221
LAMU,LAMU WEST,43,559,445,1004
LAMU,LAMU WEST,44,443,368,811
LAMU,LAMU WEST,40-44,3339,2652,5991
LAMU,LAMU WEST,45,838,734,1572
LAMU,LAMU WEST,46,548,419,967
LAMU,LAMU WEST,47,555,359,914
LAMU,LAMU WEST,48,429,319,748
LAMU,LAMU WEST,49,445,319,764
LAMU,LAMU WEST,45-49,2815,2150,4965
LAMU,LAMU WEST,50,652,549,1201
LAMU,LAMU WEST,51,419,284,703
LAMU,LAMU WEST,52,357,301,658
LAMU,LAMU WEST,53,255,206,461
LAMU,LAMU WEST,54,318,213,531
LAMU,LAMU WEST,50-54,2001,1553,3554
LAMU,LAMU WEST,55,355,241,596
LAMU,LAMU WEST,56,354,265,619
LAMU,LAMU WEST,57,296,286,582
LAMU,LAMU WEST,58,297,277,574
LAMU,LAMU WEST,59,315,290,605
LAMU,LAMU WEST,55-59,1617,1359,2976
LAMU,LAMU WEST,60,378,352,730
LAMU,LAMU WEST,61,226,264,490
LAMU,LAMU WEST,62,225,176,401
LAMU,LAMU WEST,63,230,180,410
LAMU,LAMU WEST,64,179,137,316
LAMU,LAMU WEST,60-64,1238,1109,2347
LAMU,LAMU WEST,65,264,244,508
LAMU,LAMU WEST,66,144,165,309
LAMU,LAMU WEST,67,235,165,400
LAMU,LAMU WEST,68,140,112,252
LAMU,LAMU WEST,69,179,130,309
LAMU,LAMU WEST,65-69,962,816,1778
LAMU,LAMU WEST,70,223,266,489
LAMU,LAMU WEST,71,127,142,269
LAMU,LAMU WEST,72,139,89,228
LAMU,LAMU WEST,73,109,65,174
LAMU,LAMU WEST,74,85,66,151
LAMU,LAMU WEST,70-74,683,628,1311
LAMU,LAMU WEST,75,92,92,184
LAMU,LAMU WEST,76,82,82,164
LAMU,LAMU WEST,77,55,37,92
LAMU,LAMU WEST,78,49,30,79
LAMU,LAMU WEST,79,54,46,100
LAMU,LAMU WEST,75-79,332,287,619
LAMU,LAMU WEST,80,68,113,181
LAMU,LAMU WEST,81,36,49,85
LAMU,LAMU WEST,82,24,19,43
LAMU,LAMU WEST,83,36,17,53
LAMU,LAMU WEST,84,29,22,51
LAMU,LAMU WEST,80-84,193,220,413
LAMU,LAMU WEST,85,27,21,48
LAMU,LAMU WEST,86,16,27,43
LAMU,LAMU WEST,87,24,17,41
LAMU,LAMU WEST,88,11,10,21
LAMU,LAMU WEST,89,9,20,29
LAMU,LAMU WEST,85-89,87,95,182
LAMU,LAMU WEST,90,15,32,47
LAMU,LAMU WEST,91,4,14,18
LAMU,LAMU WEST,92,10,5,15
LAMU,LAMU WEST,93,2,7,9
LAMU,LAMU WEST,94,8,5,13
LAMU,LAMU WEST,90-94,39,63,102
LAMU,LAMU WEST,95,5,8,13
LAMU,LAMU WEST,96,2,8,10
LAMU,LAMU WEST,97,4,4,8
LAMU,LAMU WEST,98,2,2,4
LAMU,LAMU WEST,99,3,12,15
LAMU,LAMU WEST,95-99,16,34,50
LAMU,LAMU WEST,100+,12,29,41
LAMU,LAMU WEST,Not Stated,3,1,4
MACHAKOS,ALL,Total,710707,711191,1421898
MACHAKOS,ALL,0,14385,14242,28627
MACHAKOS,ALL,1,14904,14608,29512
MACHAKOS,ALL,2,14554,14456,29010
MACHAKOS,ALL,3,14960,15046,30006
MACHAKOS,ALL,4,15285,14418,29703
MACHAKOS,ALL,0 - 4,74088,72770,146858
MACHAKOS,ALL,5,15162,14387,29549
MACHAKOS,ALL,6,14601,14560,29161
MACHAKOS,ALL,7,15155,14587,29742
MACHAKOS,ALL,8,15064,14991,30055
MACHAKOS,ALL,9,16489,15564,32053
MACHAKOS,ALL,05-Sep,76471,74089,150560
MACHAKOS,ALL,10,16593,16154,32747
MACHAKOS,ALL,11,16136,16566,32702
MACHAKOS,ALL,12,17420,16925,34345
MACHAKOS,ALL,13,17169,16729,33898
MACHAKOS,ALL,14,16763,15760,32523
MACHAKOS,ALL,Oct-14,84081,82134,166215
MACHAKOS,ALL,15,16131,15871,32002
MACHAKOS,ALL,16,15551,15167,30718
MACHAKOS,ALL,17,16348,15386,31734
MACHAKOS,ALL,18,12994,12200,25194
MACHAKOS,ALL,19,14256,13216,27472
MACHAKOS,ALL,15-19,75280,71840,147120
MACHAKOS,ALL,20,13669,13442,27111
MACHAKOS,ALL,21,13007,12834,25841
MACHAKOS,ALL,22,12155,12459,24614
MACHAKOS,ALL,23,13643,14376,28019
MACHAKOS,ALL,24,12742,12864,25606
MACHAKOS,ALL,20-24,65216,65975,131191
MACHAKOS,ALL,25,13185,12885,26070
MACHAKOS,ALL,26,11167,11549,22716
MACHAKOS,ALL,27,11826,11635,23461
MACHAKOS,ALL,28,10112,10672,20784
MACHAKOS,ALL,29,11928,12028,23956
MACHAKOS,ALL,25-29,58218,58769,116987
MACHAKOS,ALL,30,13403,13997,27400
MACHAKOS,ALL,31,10300,10078,20378
MACHAKOS,ALL,32,12353,12719,25072
MACHAKOS,ALL,33,10558,11161,21719
MACHAKOS,ALL,34,9778,9828,19606
MACHAKOS,ALL,30-34,56392,57783,114175
MACHAKOS,ALL,35,12078,11964,24042
MACHAKOS,ALL,36,9407,9300,18707
MACHAKOS,ALL,37,9982,9170,19152
MACHAKOS,ALL,38,7780,7501,15281
MACHAKOS,ALL,39,9563,9092,18655
MACHAKOS,ALL,35-39,48810,47027,95837
MACHAKOS,ALL,40,9973,9286,19259
MACHAKOS,ALL,41,9593,8954,18547
MACHAKOS,ALL,42,8344,7859,16203
MACHAKOS,ALL,43,7406,7795,15201
MACHAKOS,ALL,44,6349,6152,12501
MACHAKOS,ALL,40-44,41665,40046,81711
MACHAKOS,ALL,45,8897,7973,16870
MACHAKOS,ALL,46,6796,6015,12811
MACHAKOS,ALL,47,6872,6073,12945
MACHAKOS,ALL,48,4954,4743,9697
MACHAKOS,ALL,49,6495,6072,12567
MACHAKOS,ALL,45-49,34014,30876,64890
MACHAKOS,ALL,50,6323,6502,12825
MACHAKOS,ALL,51,5348,5288,10636
MACHAKOS,ALL,52,4381,4200,8581
MACHAKOS,ALL,53,3602,3500,7102
MACHAKOS,ALL,54,4290,4072,8362
MACHAKOS,ALL,50-54,23944,23562,47506
MACHAKOS,ALL,55,4566,4211,8777
MACHAKOS,ALL,56,5096,5065,10161
MACHAKOS,ALL,57,3967,4621,8588
MACHAKOS,ALL,58,3028,3279,6307
MACHAKOS,ALL,59,4298,4455,8753
MACHAKOS,ALL,55-59,20955,21631,42586
MACHAKOS,ALL,60,4889,5114,10003
MACHAKOS,ALL,61,4218,4214,8432
MACHAKOS,ALL,62,3331,3240,6571
MACHAKOS,ALL,63,3420,3523,6943
MACHAKOS,ALL,64,2319,2458,4777
MACHAKOS,ALL,60-64,18177,18549,36726
MACHAKOS,ALL,65,3213,3521,6734
MACHAKOS,ALL,66,2106,2404,4510
MACHAKOS,ALL,67,3791,4589,8380
MACHAKOS,ALL,68,1494,1769,3263
MACHAKOS,ALL,69,2227,2967,5194
MACHAKOS,ALL,65-69,12831,15250,28081
MACHAKOS,ALL,70,2671,3456,6127
MACHAKOS,ALL,71,2069,2649,4718
MACHAKOS,ALL,72,1533,1550,3083
MACHAKOS,ALL,73,1397,1585,2982
MACHAKOS,ALL,74,1309,1753,3062
MACHAKOS,ALL,70-74,8979,10993,19972
MACHAKOS,ALL,75,1006,1400,2406
MACHAKOS,ALL,76,776,1319,2095
MACHAKOS,ALL,77,1000,1678,2678
MACHAKOS,ALL,78,680,779,1459
MACHAKOS,ALL,79,705,1738,2443
MACHAKOS,ALL,75-79,4167,6914,11081
MACHAKOS,ALL,80,1067,1839,2906
MACHAKOS,ALL,81,708,1044,1752
MACHAKOS,ALL,82,606,643,1249
MACHAKOS,ALL,83,661,910,1571
MACHAKOS,ALL,84,530,928,1458
MACHAKOS,ALL,80-84,3572,5364,8936
MACHAKOS,ALL,85,440,701,1141
MACHAKOS,ALL,86,320,344,664
MACHAKOS,ALL,87,431,714,1145
MACHAKOS,ALL,88,207,259,466
MACHAKOS,ALL,89,401,1249,1650
MACHAKOS,ALL,85-89,1799,3267,5066
MACHAKOS,ALL,90,313,754,1067
MACHAKOS,ALL,91,429,890,1319
MACHAKOS,ALL,92,179,314,493
MACHAKOS,ALL,93,133,263,396
MACHAKOS,ALL,94,121,289,410
MACHAKOS,ALL,90-94,1175,2510,3685
MACHAKOS,ALL,95,185,380,565
MACHAKOS,ALL,96,98,156,254
MACHAKOS,ALL,97,117,145,262
MACHAKOS,ALL,98,73,138,211
MACHAKOS,ALL,99,106,374,480
MACHAKOS,ALL,95-99,579,1193,1772
MACHAKOS,ALL,100+,282,643,925
MACHAKOS,ALL,Not Stated,12,6,18
MACHAKOS,ATHI RIVER,Total,164322,158172,322494
MACHAKOS,ATHI RIVER,0,4100,4017,8117
MACHAKOS,ATHI RIVER,1,4092,3946,8038
MACHAKOS,ATHI RIVER,2,3838,3785,7623
MACHAKOS,ATHI RIVER,3,3726,3790,7516
MACHAKOS,ATHI RIVER,4,3577,3366,6943
MACHAKOS,ATHI RIVER,0 - 4,19333,18904,38237
MACHAKOS,ATHI RIVER,5,3355,3255,6610
MACHAKOS,ATHI RIVER,6,3225,3343,6568
MACHAKOS,ATHI RIVER,7,3232,3154,6386
MACHAKOS,ATHI RIVER,8,2975,3006,5981
MACHAKOS,ATHI RIVER,9,3096,3025,6121
MACHAKOS,ATHI RIVER,05-Sep,15883,15783,31666
MACHAKOS,ATHI RIVER,10,3070,3084,6154
MACHAKOS,ATHI RIVER,11,2741,2835,5576
MACHAKOS,ATHI RIVER,12,2826,2909,5735
MACHAKOS,ATHI RIVER,13,2815,2776,5591
MACHAKOS,ATHI RIVER,14,2454,2489,4943
MACHAKOS,ATHI RIVER,Oct-14,13906,14093,27999
MACHAKOS,ATHI RIVER,15,2277,2421,4698
MACHAKOS,ATHI RIVER,16,2197,2387,4584
MACHAKOS,ATHI RIVER,17,2347,2644,4991
MACHAKOS,ATHI RIVER,18,2082,2542,4624
MACHAKOS,ATHI RIVER,19,2642,3377,6019
MACHAKOS,ATHI RIVER,15-19,11545,13371,24916
MACHAKOS,ATHI RIVER,20,3009,3860,6869
MACHAKOS,ATHI RIVER,21,3414,4175,7589
MACHAKOS,ATHI RIVER,22,3540,4329,7869
MACHAKOS,ATHI RIVER,23,4215,5157,9372
MACHAKOS,ATHI RIVER,24,4297,4766,9063
MACHAKOS,ATHI RIVER,20-24,18475,22287,40762
MACHAKOS,ATHI RIVER,25,4658,4806,9464
MACHAKOS,ATHI RIVER,26,4143,4333,8476
MACHAKOS,ATHI RIVER,27,4286,4192,8478
MACHAKOS,ATHI RIVER,28,3525,3743,7268
MACHAKOS,ATHI RIVER,29,4092,3912,8004
MACHAKOS,ATHI RIVER,25-29,20704,20986,41690
MACHAKOS,ATHI RIVER,30,4665,4527,9192
MACHAKOS,ATHI RIVER,31,3283,3005,6288
MACHAKOS,ATHI RIVER,32,4091,3897,7988
MACHAKOS,ATHI RIVER,33,3258,3071,6329
MACHAKOS,ATHI RIVER,34,3081,2806,5887
MACHAKOS,ATHI RIVER,30-34,18378,17306,35684
MACHAKOS,ATHI RIVER,35,3695,3250,6945
MACHAKOS,ATHI RIVER,36,2894,2503,5397
MACHAKOS,ATHI RIVER,37,2776,2297,5073
MACHAKOS,ATHI RIVER,38,2412,2182,4594
MACHAKOS,ATHI RIVER,39,2538,2119,4657
MACHAKOS,ATHI RIVER,35-39,14315,12351,26666
MACHAKOS,ATHI RIVER,40,2892,2282,5174
MACHAKOS,ATHI RIVER,41,2356,1924,4280
MACHAKOS,ATHI RIVER,42,2249,1710,3959
MACHAKOS,ATHI RIVER,43,1870,1460,3330
MACHAKOS,ATHI RIVER,44,1522,1270,2792
MACHAKOS,ATHI RIVER,40-44,10889,8646,19535
MACHAKOS,ATHI RIVER,45,2335,1547,3882
MACHAKOS,ATHI RIVER,46,1638,1151,2789
MACHAKOS,ATHI RIVER,47,1636,1109,2745
MACHAKOS,ATHI RIVER,48,1232,868,2100
MACHAKOS,ATHI RIVER,49,1431,933,2364
MACHAKOS,ATHI RIVER,45-49,8272,5608,13880
MACHAKOS,ATHI RIVER,50,1497,971,2468
MACHAKOS,ATHI RIVER,51,1145,711,1856
MACHAKOS,ATHI RIVER,52,966,660,1626
MACHAKOS,ATHI RIVER,53,748,534,1282
MACHAKOS,ATHI RIVER,54,874,512,1386
MACHAKOS,ATHI RIVER,50-54,5230,3388,8618
MACHAKOS,ATHI RIVER,55,816,469,1285
MACHAKOS,ATHI RIVER,56,826,538,1364
MACHAKOS,ATHI RIVER,57,678,475,1153
MACHAKOS,ATHI RIVER,58,476,332,808
MACHAKOS,ATHI RIVER,59,567,384,951
MACHAKOS,ATHI RIVER,55-59,3363,2198,5561
MACHAKOS,ATHI RIVER,60,600,416,1016
MACHAKOS,ATHI RIVER,61,465,309,774
MACHAKOS,ATHI RIVER,62,375,260,635
MACHAKOS,ATHI RIVER,63,350,209,559
MACHAKOS,ATHI RIVER,64,244,196,440
MACHAKOS,ATHI RIVER,60-64,2034,1390,3424
MACHAKOS,ATHI RIVER,65,300,200,500
MACHAKOS,ATHI RIVER,66,183,149,332
MACHAKOS,ATHI RIVER,67,272,233,505
MACHAKOS,ATHI RIVER,68,133,106,239
MACHAKOS,ATHI RIVER,69,141,124,265
MACHAKOS,ATHI RIVER,65-69,1029,812,1841
MACHAKOS,ATHI RIVER,70,193,158,351
MACHAKOS,ATHI RIVER,71,129,102,231
MACHAKOS,ATHI RIVER,72,113,74,187
MACHAKOS,ATHI RIVER,73,68,62,130
MACHAKOS,ATHI RIVER,74,64,49,113
MACHAKOS,ATHI RIVER,70-74,567,445,1012
MACHAKOS,ATHI RIVER,75,47,53,100
MACHAKOS,ATHI RIVER,76,41,52,93
MACHAKOS,ATHI RIVER,77,50,52,102
MACHAKOS,ATHI RIVER,78,20,22,42
MACHAKOS,ATHI RIVER,79,17,50,67
MACHAKOS,ATHI RIVER,75-79,175,229,404
MACHAKOS,ATHI RIVER,80,43,50,93
MACHAKOS,ATHI RIVER,81,19,25,44
MACHAKOS,ATHI RIVER,82,16,29,45
MACHAKOS,ATHI RIVER,83,21,24,45
MACHAKOS,ATHI RIVER,84,14,21,35
MACHAKOS,ATHI RIVER,80-84,113,149,262
MACHAKOS,ATHI RIVER,85,18,26,44
MACHAKOS,ATHI RIVER,86,13,22,35
MACHAKOS,ATHI RIVER,87,7,21,28
MACHAKOS,ATHI RIVER,88,6,10,16
MACHAKOS,ATHI RIVER,89,11,35,46
MACHAKOS,ATHI RIVER,85-89,55,114,169
MACHAKOS,ATHI RIVER,90,8,22,30
MACHAKOS,ATHI RIVER,91,7,10,17
MACHAKOS,ATHI RIVER,92,4,8,12
MACHAKOS,ATHI RIVER,93,6,4,10
MACHAKOS,ATHI RIVER,94,3,11,14
MACHAKOS,ATHI RIVER,90-94,28,55,83
MACHAKOS,ATHI RIVER,95,5,11,16
MACHAKOS,ATHI RIVER,96,4,4,8
MACHAKOS,ATHI RIVER,97,3,7,10
MACHAKOS,ATHI RIVER,98,3,4,7
MACHAKOS,ATHI RIVER,99,2,8,10
MACHAKOS,ATHI RIVER,95-99,17,34,51
MACHAKOS,ATHI RIVER,100+,6,19,25
MACHAKOS,ATHI RIVER,Not Stated,5,4,9
MACHAKOS,KALAMA,Total,26764,27692,54456
MACHAKOS,KALAMA,0,455,433,888
MACHAKOS,KALAMA,1,531,503,1034
MACHAKOS,KALAMA,2,465,479,944
MACHAKOS,KALAMA,3,526,518,1044
MACHAKOS,KALAMA,4,552,521,1073
MACHAKOS,KALAMA,0 - 4,2529,2454,4983
MACHAKOS,KALAMA,5,589,549,1138
MACHAKOS,KALAMA,6,544,533,1077
MACHAKOS,KALAMA,7,607,511,1118
MACHAKOS,KALAMA,8,625,607,1232
MACHAKOS,KALAMA,9,649,628,1277
MACHAKOS,KALAMA,05-Sep,3014,2828,5842
MACHAKOS,KALAMA,10,738,662,1400
MACHAKOS,KALAMA,11,688,710,1398
MACHAKOS,KALAMA,12,783,708,1491
MACHAKOS,KALAMA,13,743,711,1454
MACHAKOS,KALAMA,14,733,687,1420
MACHAKOS,KALAMA,Oct-14,3685,3478,7163
MACHAKOS,KALAMA,15,715,731,1446
MACHAKOS,KALAMA,16,677,673,1350
MACHAKOS,KALAMA,17,683,657,1340
MACHAKOS,KALAMA,18,551,523,1074
MACHAKOS,KALAMA,19,512,459,971
MACHAKOS,KALAMA,15-19,3138,3043,6181
MACHAKOS,KALAMA,20,484,433,917
MACHAKOS,KALAMA,21,443,377,820
MACHAKOS,KALAMA,22,360,358,718
MACHAKOS,KALAMA,23,399,412,811
MACHAKOS,KALAMA,24,409,311,720
MACHAKOS,KALAMA,20-24,2095,1891,3986
MACHAKOS,KALAMA,25,340,355,695
MACHAKOS,KALAMA,26,344,317,661
MACHAKOS,KALAMA,27,312,339,651
MACHAKOS,KALAMA,28,301,322,623
MACHAKOS,KALAMA,29,364,374,738
MACHAKOS,KALAMA,25-29,1661,1707,3368
MACHAKOS,KALAMA,30,414,433,847
MACHAKOS,KALAMA,31,313,337,650
MACHAKOS,KALAMA,32,407,387,794
MACHAKOS,KALAMA,33,330,368,698
MACHAKOS,KALAMA,34,316,267,583
MACHAKOS,KALAMA,30-34,1780,1792,3572
MACHAKOS,KALAMA,35,409,393,802
MACHAKOS,KALAMA,36,267,319,586
MACHAKOS,KALAMA,37,313,329,642
MACHAKOS,KALAMA,38,206,244,450
MACHAKOS,KALAMA,39,337,347,684
MACHAKOS,KALAMA,35-39,1532,1632,3164
MACHAKOS,KALAMA,40,297,338,635
MACHAKOS,KALAMA,41,323,313,636
MACHAKOS,KALAMA,42,286,309,595
MACHAKOS,KALAMA,43,268,313,581
MACHAKOS,KALAMA,44,230,260,490
MACHAKOS,KALAMA,40-44,1404,1533,2937
MACHAKOS,KALAMA,45,324,299,623
MACHAKOS,KALAMA,46,284,255,539
MACHAKOS,KALAMA,47,233,270,503
MACHAKOS,KALAMA,48,154,225,379
MACHAKOS,KALAMA,49,248,283,531
MACHAKOS,KALAMA,45-49,1243,1332,2575
MACHAKOS,KALAMA,50,221,292,513
MACHAKOS,KALAMA,51,202,285,487
MACHAKOS,KALAMA,52,162,204,366
MACHAKOS,KALAMA,53,158,154,312
MACHAKOS,KALAMA,54,171,199,370
MACHAKOS,KALAMA,50-54,914,1134,2048
MACHAKOS,KALAMA,55,196,209,405
MACHAKOS,KALAMA,56,238,227,465
MACHAKOS,KALAMA,57,169,215,384
MACHAKOS,KALAMA,58,136,167,303
MACHAKOS,KALAMA,59,237,250,487
MACHAKOS,KALAMA,55-59,976,1068,2044
MACHAKOS,KALAMA,60,242,256,498
MACHAKOS,KALAMA,61,179,262,441
MACHAKOS,KALAMA,62,126,167,293
MACHAKOS,KALAMA,63,161,188,349
MACHAKOS,KALAMA,64,112,125,237
MACHAKOS,KALAMA,60-64,820,998,1818
MACHAKOS,KALAMA,65,160,172,332
MACHAKOS,KALAMA,66,108,148,256
MACHAKOS,KALAMA,67,190,243,433
MACHAKOS,KALAMA,68,78,91,169
MACHAKOS,KALAMA,69,125,189,314
MACHAKOS,KALAMA,65-69,661,843,1504
MACHAKOS,KALAMA,70,162,199,361
MACHAKOS,KALAMA,71,132,171,303
MACHAKOS,KALAMA,72,84,82,166
MACHAKOS,KALAMA,73,108,105,213
MACHAKOS,KALAMA,74,82,106,188
MACHAKOS,KALAMA,70-74,568,663,1231
MACHAKOS,KALAMA,75,58,83,141
MACHAKOS,KALAMA,76,55,63,118
MACHAKOS,KALAMA,77,64,134,198
MACHAKOS,KALAMA,78,42,36,78
MACHAKOS,KALAMA,79,45,117,162
MACHAKOS,KALAMA,75-79,264,433,697
MACHAKOS,KALAMA,80,74,115,189
MACHAKOS,KALAMA,81,49,50,99
MACHAKOS,KALAMA,82,39,31,70
MACHAKOS,KALAMA,83,38,56,94
MACHAKOS,KALAMA,84,43,73,116
MACHAKOS,KALAMA,80-84,243,325,568
MACHAKOS,KALAMA,85,25,40,65
MACHAKOS,KALAMA,86,14,18,32
MACHAKOS,KALAMA,87,25,30,55
MACHAKOS,KALAMA,88,10,15,25
MACHAKOS,KALAMA,89,31,114,145
MACHAKOS,KALAMA,85-89,105,217,322
MACHAKOS,KALAMA,90,30,66,96
MACHAKOS,KALAMA,91,20,67,87
MACHAKOS,KALAMA,92,18,22,40
MACHAKOS,KALAMA,93,14,22,36
MACHAKOS,KALAMA,94,7,16,23
MACHAKOS,KALAMA,90-94,89,193,282
MACHAKOS,KALAMA,95,12,30,42
MACHAKOS,KALAMA,96,3,6,9
MACHAKOS,KALAMA,97,3,8,11
MACHAKOS,KALAMA,98,-,4,4
MACHAKOS,KALAMA,99,6,33,39
MACHAKOS,KALAMA,95-99,24,81,105
MACHAKOS,KALAMA,100+,19,47,66
MACHAKOS,KALAMA,Not Stated,-,-,-
MACHAKOS,KANGUNDO,Total,48697,49219,97916
MACHAKOS,KANGUNDO,0,831,771,1602
MACHAKOS,KANGUNDO,1,911,909,1820
MACHAKOS,KANGUNDO,2,911,892,1803
MACHAKOS,KANGUNDO,3,978,930,1908
MACHAKOS,KANGUNDO,4,975,929,1904
MACHAKOS,KANGUNDO,0 - 4,4606,4431,9037
MACHAKOS,KANGUNDO,5,957,985,1942
MACHAKOS,KANGUNDO,6,975,959,1934
MACHAKOS,KANGUNDO,7,1048,1008,2056
MACHAKOS,KANGUNDO,8,1054,1004,2058
MACHAKOS,KANGUNDO,9,1183,1078,2261
MACHAKOS,KANGUNDO,05-Sep,5217,5034,10251
MACHAKOS,KANGUNDO,10,1189,1157,2346
MACHAKOS,KANGUNDO,11,1121,1164,2285
MACHAKOS,KANGUNDO,12,1278,1214,2492
MACHAKOS,KANGUNDO,13,1316,1253,2569
MACHAKOS,KANGUNDO,14,1289,1164,2453
MACHAKOS,KANGUNDO,Oct-14,6193,5952,12145
MACHAKOS,KANGUNDO,15,1204,1141,2345
MACHAKOS,KANGUNDO,16,1130,1080,2210
MACHAKOS,KANGUNDO,17,1300,1078,2378
MACHAKOS,KANGUNDO,18,879,748,1627
MACHAKOS,KANGUNDO,19,993,785,1778
MACHAKOS,KANGUNDO,15-19,5506,4832,10338
MACHAKOS,KANGUNDO,20,818,691,1509
MACHAKOS,KANGUNDO,21,766,657,1423
MACHAKOS,KANGUNDO,22,660,592,1252
MACHAKOS,KANGUNDO,23,716,684,1400
MACHAKOS,KANGUNDO,24,625,613,1238
MACHAKOS,KANGUNDO,20-24,3585,3237,6822
MACHAKOS,KANGUNDO,25,641,574,1215
MACHAKOS,KANGUNDO,26,553,500,1053
MACHAKOS,KANGUNDO,27,534,543,1077
MACHAKOS,KANGUNDO,28,528,517,1045
MACHAKOS,KANGUNDO,29,594,615,1209
MACHAKOS,KANGUNDO,25-29,2850,2749,5599
MACHAKOS,KANGUNDO,30,671,743,1414
MACHAKOS,KANGUNDO,31,539,539,1078
MACHAKOS,KANGUNDO,32,695,758,1453
MACHAKOS,KANGUNDO,33,629,741,1370
MACHAKOS,KANGUNDO,34,602,658,1260
MACHAKOS,KANGUNDO,30-34,3136,3439,6575
MACHAKOS,KANGUNDO,35,736,747,1483
MACHAKOS,KANGUNDO,36,642,593,1235
MACHAKOS,KANGUNDO,37,702,676,1378
MACHAKOS,KANGUNDO,38,510,544,1054
MACHAKOS,KANGUNDO,39,728,627,1355
MACHAKOS,KANGUNDO,35-39,3318,3187,6505
MACHAKOS,KANGUNDO,40,674,704,1378
MACHAKOS,KANGUNDO,41,660,694,1354
MACHAKOS,KANGUNDO,42,578,628,1206
MACHAKOS,KANGUNDO,43,579,637,1216
MACHAKOS,KANGUNDO,44,481,451,932
MACHAKOS,KANGUNDO,40-44,2972,3114,6086
MACHAKOS,KANGUNDO,45,608,628,1236
MACHAKOS,KANGUNDO,46,486,431,917
MACHAKOS,KANGUNDO,47,490,481,971
MACHAKOS,KANGUNDO,48,373,348,721
MACHAKOS,KANGUNDO,49,502,501,1003
MACHAKOS,KANGUNDO,45-49,2459,2389,4848
MACHAKOS,KANGUNDO,50,447,547,994
MACHAKOS,KANGUNDO,51,433,476,909
MACHAKOS,KANGUNDO,52,336,346,682
MACHAKOS,KANGUNDO,53,291,328,619
MACHAKOS,KANGUNDO,54,320,358,678
MACHAKOS,KANGUNDO,50-54,1827,2055,3882
MACHAKOS,KANGUNDO,55,392,420,812
MACHAKOS,KANGUNDO,56,464,445,909
MACHAKOS,KANGUNDO,57,350,442,792
MACHAKOS,KANGUNDO,58,267,316,583
MACHAKOS,KANGUNDO,59,414,426,840
MACHAKOS,KANGUNDO,55-59,1887,2049,3936
MACHAKOS,KANGUNDO,60,460,505,965
MACHAKOS,KANGUNDO,61,399,431,830
MACHAKOS,KANGUNDO,62,341,320,661
MACHAKOS,KANGUNDO,63,364,360,724
MACHAKOS,KANGUNDO,64,249,252,501
MACHAKOS,KANGUNDO,60-64,1813,1868,3681
MACHAKOS,KANGUNDO,65,324,342,666
MACHAKOS,KANGUNDO,66,202,267,469
MACHAKOS,KANGUNDO,67,326,419,745
MACHAKOS,KANGUNDO,68,146,172,318
MACHAKOS,KANGUNDO,69,207,291,498
MACHAKOS,KANGUNDO,65-69,1205,1491,2696
MACHAKOS,KANGUNDO,70,260,359,619
MACHAKOS,KANGUNDO,71,219,298,517
MACHAKOS,KANGUNDO,72,143,163,306
MACHAKOS,KANGUNDO,73,137,160,297
MACHAKOS,KANGUNDO,74,154,187,341
MACHAKOS,KANGUNDO,70-74,913,1167,2080
MACHAKOS,KANGUNDO,75,108,142,250
MACHAKOS,KANGUNDO,76,77,131,208
MACHAKOS,KANGUNDO,77,103,195,298
MACHAKOS,KANGUNDO,78,61,100,161
MACHAKOS,KANGUNDO,79,81,211,292
MACHAKOS,KANGUNDO,75-79,430,779,1209
MACHAKOS,KANGUNDO,80,111,170,281
MACHAKOS,KANGUNDO,81,85,127,212
MACHAKOS,KANGUNDO,82,64,63,127
MACHAKOS,KANGUNDO,83,69,112,181
MACHAKOS,KANGUNDO,84,67,123,190
MACHAKOS,KANGUNDO,80-84,396,595,991
MACHAKOS,KANGUNDO,85,33,83,116
MACHAKOS,KANGUNDO,86,37,35,72
MACHAKOS,KANGUNDO,87,61,106,167
MACHAKOS,KANGUNDO,88,17,38,55
MACHAKOS,KANGUNDO,89,41,141,182
MACHAKOS,KANGUNDO,85-89,189,403,592
MACHAKOS,KANGUNDO,90,23,88,111
MACHAKOS,KANGUNDO,91,52,77,129
MACHAKOS,KANGUNDO,92,14,22,36
MACHAKOS,KANGUNDO,93,10,32,42
MACHAKOS,KANGUNDO,94,12,37,49
MACHAKOS,KANGUNDO,90-94,111,256,367
MACHAKOS,KANGUNDO,95,18,43,61
MACHAKOS,KANGUNDO,96,10,21,31
MACHAKOS,KANGUNDO,97,14,12,26
MACHAKOS,KANGUNDO,98,7,9,16
MACHAKOS,KANGUNDO,99,4,40,44
MACHAKOS,KANGUNDO,95-99,53,125,178
MACHAKOS,KANGUNDO,100+,31,67,98
MACHAKOS,KANGUNDO,Not Stated,-,-,-
MACHAKOS,KATHIANI,Total,54910,56976,111886
MACHAKOS,KATHIANI,0,989,953,1942
MACHAKOS,KATHIANI,1,1030,1074,2104
MACHAKOS,KATHIANI,2,1134,1028,2162
MACHAKOS,KATHIANI,3,1170,1135,2305
MACHAKOS,KATHIANI,4,1212,1127,2339
MACHAKOS,KATHIANI,0 - 4,5535,5317,10852
MACHAKOS,KATHIANI,5,1225,1176,2401
MACHAKOS,KATHIANI,6,1250,1205,2455
MACHAKOS,KATHIANI,7,1304,1296,2600
MACHAKOS,KATHIANI,8,1326,1301,2627
MACHAKOS,KATHIANI,9,1421,1294,2715
MACHAKOS,KATHIANI,05-Sep,6526,6272,12798
MACHAKOS,KATHIANI,10,1423,1376,2799
MACHAKOS,KATHIANI,11,1461,1411,2872
MACHAKOS,KATHIANI,12,1624,1518,3142
MACHAKOS,KATHIANI,13,1584,1495,3079
MACHAKOS,KATHIANI,14,1518,1425,2943
MACHAKOS,KATHIANI,Oct-14,7610,7225,14835
MACHAKOS,KATHIANI,15,1395,1397,2792
MACHAKOS,KATHIANI,16,1443,1341,2784
MACHAKOS,KATHIANI,17,1419,1307,2726
MACHAKOS,KATHIANI,18,1192,1008,2200
MACHAKOS,KATHIANI,19,1229,979,2208
MACHAKOS,KATHIANI,15-19,6678,6032,12710
MACHAKOS,KATHIANI,20,1005,880,1885
MACHAKOS,KATHIANI,21,916,786,1702
MACHAKOS,KATHIANI,22,822,681,1503
MACHAKOS,KATHIANI,23,786,839,1625
MACHAKOS,KATHIANI,24,794,751,1545
MACHAKOS,KATHIANI,20-24,4323,3937,8260
MACHAKOS,KATHIANI,25,750,726,1476
MACHAKOS,KATHIANI,26,584,701,1285
MACHAKOS,KATHIANI,27,662,711,1373
MACHAKOS,KATHIANI,28,590,673,1263
MACHAKOS,KATHIANI,29,711,751,1462
MACHAKOS,KATHIANI,25-29,3297,3562,6859
MACHAKOS,KATHIANI,30,729,894,1623
MACHAKOS,KATHIANI,31,658,704,1362
MACHAKOS,KATHIANI,32,794,870,1664
MACHAKOS,KATHIANI,33,675,836,1511
MACHAKOS,KATHIANI,34,644,718,1362
MACHAKOS,KATHIANI,30-34,3500,4022,7522
MACHAKOS,KATHIANI,35,819,880,1699
MACHAKOS,KATHIANI,36,579,666,1245
MACHAKOS,KATHIANI,37,653,641,1294
MACHAKOS,KATHIANI,38,515,519,1034
MACHAKOS,KATHIANI,39,620,698,1318
MACHAKOS,KATHIANI,35-39,3186,3404,6590
MACHAKOS,KATHIANI,40,668,705,1373
MACHAKOS,KATHIANI,41,741,741,1482
MACHAKOS,KATHIANI,42,544,630,1174
MACHAKOS,KATHIANI,43,549,667,1216
MACHAKOS,KATHIANI,44,490,525,1015
MACHAKOS,KATHIANI,40-44,2992,3268,6260
MACHAKOS,KATHIANI,45,583,742,1325
MACHAKOS,KATHIANI,46,504,551,1055
MACHAKOS,KATHIANI,47,464,507,971
MACHAKOS,KATHIANI,48,371,414,785
MACHAKOS,KATHIANI,49,489,513,1002
MACHAKOS,KATHIANI,45-49,2411,2727,5138
MACHAKOS,KATHIANI,50,461,611,1072
MACHAKOS,KATHIANI,51,435,474,909
MACHAKOS,KATHIANI,52,292,349,641
MACHAKOS,KATHIANI,53,271,312,583
MACHAKOS,KATHIANI,54,343,342,685
MACHAKOS,KATHIANI,50-54,1802,2088,3890
MACHAKOS,KATHIANI,55,386,378,764
MACHAKOS,KATHIANI,56,412,437,849
MACHAKOS,KATHIANI,57,336,470,806
MACHAKOS,KATHIANI,58,246,331,577
MACHAKOS,KATHIANI,59,432,471,903
MACHAKOS,KATHIANI,55-59,1812,2087,3899
MACHAKOS,KATHIANI,60,487,542,1029
MACHAKOS,KATHIANI,61,389,445,834
MACHAKOS,KATHIANI,62,319,329,648
MACHAKOS,KATHIANI,63,363,376,739
MACHAKOS,KATHIANI,64,217,245,462
MACHAKOS,KATHIANI,60-64,1775,1937,3712
MACHAKOS,KATHIANI,65,330,385,715
MACHAKOS,KATHIANI,66,219,249,468
MACHAKOS,KATHIANI,67,394,502,896
MACHAKOS,KATHIANI,68,150,188,338
MACHAKOS,KATHIANI,69,246,360,606
MACHAKOS,KATHIANI,65-69,1339,1684,3023
MACHAKOS,KATHIANI,70,254,382,636
MACHAKOS,KATHIANI,71,205,295,500
MACHAKOS,KATHIANI,72,163,177,340
MACHAKOS,KATHIANI,73,158,168,326
MACHAKOS,KATHIANI,74,146,203,349
MACHAKOS,KATHIANI,70-74,926,1225,2151
MACHAKOS,KATHIANI,75,94,147,241
MACHAKOS,KATHIANI,76,87,147,234
MACHAKOS,KATHIANI,77,87,163,250
MACHAKOS,KATHIANI,78,87,85,172
MACHAKOS,KATHIANI,79,87,215,302
MACHAKOS,KATHIANI,75-79,442,757,1199
MACHAKOS,KATHIANI,80,112,196,308
MACHAKOS,KATHIANI,81,80,134,214
MACHAKOS,KATHIANI,82,66,79,145
MACHAKOS,KATHIANI,83,67,120,187
MACHAKOS,KATHIANI,84,36,104,140
MACHAKOS,KATHIANI,80-84,361,633,994
MACHAKOS,KATHIANI,85,53,75,128
MACHAKOS,KATHIANI,86,40,38,78
MACHAKOS,KATHIANI,87,52,71,123
MACHAKOS,KATHIANI,88,15,23,38
MACHAKOS,KATHIANI,89,40,151,191
MACHAKOS,KATHIANI,85-89,200,358,558
MACHAKOS,KATHIANI,90,23,76,99
MACHAKOS,KATHIANI,91,47,103,150
MACHAKOS,KATHIANI,92,17,28,45
MACHAKOS,KATHIANI,93,12,18,30
MACHAKOS,KATHIANI,94,13,26,39
MACHAKOS,KATHIANI,90-94,112,251,363
MACHAKOS,KATHIANI,95,15,33,48
MACHAKOS,KATHIANI,96,12,12,24
MACHAKOS,KATHIANI,97,7,14,21
MACHAKOS,KATHIANI,98,7,17,24
MACHAKOS,KATHIANI,99,11,39,50
MACHAKOS,KATHIANI,95-99,52,115,167
MACHAKOS,KATHIANI,100+,31,74,105
MACHAKOS,KATHIANI,Not Stated,-,1,1
MACHAKOS,MACHAKOS,Total,85486,85114,170600
MACHAKOS,MACHAKOS,0,1828,1777,3605
MACHAKOS,MACHAKOS,1,1707,1730,3437
MACHAKOS,MACHAKOS,2,1662,1645,3307
MACHAKOS,MACHAKOS,3,1621,1668,3289
MACHAKOS,MACHAKOS,4,1697,1654,3351
MACHAKOS,MACHAKOS,0 - 4,8515,8474,16989
MACHAKOS,MACHAKOS,5,1750,1584,3334
MACHAKOS,MACHAKOS,6,1569,1589,3158
MACHAKOS,MACHAKOS,7,1604,1636,3240
MACHAKOS,MACHAKOS,8,1563,1542,3105
MACHAKOS,MACHAKOS,9,1744,1703,3447
MACHAKOS,MACHAKOS,05-Sep,8230,8054,16284
MACHAKOS,MACHAKOS,10,1731,1758,3489
MACHAKOS,MACHAKOS,11,1672,1635,3307
MACHAKOS,MACHAKOS,12,1708,1722,3430
MACHAKOS,MACHAKOS,13,1726,1726,3452
MACHAKOS,MACHAKOS,14,1736,1599,3335
MACHAKOS,MACHAKOS,Oct-14,8573,8440,17013
MACHAKOS,MACHAKOS,15,1665,1614,3279
MACHAKOS,MACHAKOS,16,1548,1508,3056
MACHAKOS,MACHAKOS,17,1737,1640,3377
MACHAKOS,MACHAKOS,18,1352,1304,2656
MACHAKOS,MACHAKOS,19,1595,1538,3133
MACHAKOS,MACHAKOS,15-19,7897,7604,15501
MACHAKOS,MACHAKOS,20,1620,1709,3329
MACHAKOS,MACHAKOS,21,1597,1714,3311
MACHAKOS,MACHAKOS,22,1661,1726,3387
MACHAKOS,MACHAKOS,23,1867,2081,3948
MACHAKOS,MACHAKOS,24,1780,1832,3612
MACHAKOS,MACHAKOS,20-24,8525,9062,17587
MACHAKOS,MACHAKOS,25,1896,1812,3708
MACHAKOS,MACHAKOS,26,1579,1545,3124
MACHAKOS,MACHAKOS,27,1658,1565,3223
MACHAKOS,MACHAKOS,28,1423,1466,2889
MACHAKOS,MACHAKOS,29,1638,1615,3253
MACHAKOS,MACHAKOS,25-29,8194,8003,16197
MACHAKOS,MACHAKOS,30,1855,1846,3701
MACHAKOS,MACHAKOS,31,1406,1300,2706
MACHAKOS,MACHAKOS,32,1685,1630,3315
MACHAKOS,MACHAKOS,33,1414,1356,2770
MACHAKOS,MACHAKOS,34,1287,1249,2536
MACHAKOS,MACHAKOS,30-34,7647,7381,15028
MACHAKOS,MACHAKOS,35,1566,1430,2996
MACHAKOS,MACHAKOS,36,1230,1160,2390
MACHAKOS,MACHAKOS,37,1258,1221,2479
MACHAKOS,MACHAKOS,38,1018,964,1982
MACHAKOS,MACHAKOS,39,1282,1158,2440
MACHAKOS,MACHAKOS,35-39,6354,5933,12287
MACHAKOS,MACHAKOS,40,1315,1155,2470
MACHAKOS,MACHAKOS,41,1251,1084,2335
MACHAKOS,MACHAKOS,42,1113,1002,2115
MACHAKOS,MACHAKOS,43,929,902,1831
MACHAKOS,MACHAKOS,44,767,724,1491
MACHAKOS,MACHAKOS,40-44,5375,4867,10242
MACHAKOS,MACHAKOS,45,1115,989,2104
MACHAKOS,MACHAKOS,46,810,709,1519
MACHAKOS,MACHAKOS,47,854,783,1637
MACHAKOS,MACHAKOS,48,687,589,1276
MACHAKOS,MACHAKOS,49,857,757,1614
MACHAKOS,MACHAKOS,45-49,4323,3827,8150
MACHAKOS,MACHAKOS,50,820,840,1660
MACHAKOS,MACHAKOS,51,654,603,1257
MACHAKOS,MACHAKOS,52,617,548,1165
MACHAKOS,MACHAKOS,53,508,433,941
MACHAKOS,MACHAKOS,54,541,563,1104
MACHAKOS,MACHAKOS,50-54,3140,2987,6127
MACHAKOS,MACHAKOS,55,590,577,1167
MACHAKOS,MACHAKOS,56,619,611,1230
MACHAKOS,MACHAKOS,57,515,604,1119
MACHAKOS,MACHAKOS,58,391,422,813
MACHAKOS,MACHAKOS,59,518,574,1092
MACHAKOS,MACHAKOS,55-59,2633,2788,5421
MACHAKOS,MACHAKOS,60,586,668,1254
MACHAKOS,MACHAKOS,61,490,554,1044
MACHAKOS,MACHAKOS,62,426,391,817
MACHAKOS,MACHAKOS,63,403,448,851
MACHAKOS,MACHAKOS,64,285,293,578
MACHAKOS,MACHAKOS,60-64,2190,2354,4544
MACHAKOS,MACHAKOS,65,408,484,892
MACHAKOS,MACHAKOS,66,282,271,553
MACHAKOS,MACHAKOS,67,422,571,993
MACHAKOS,MACHAKOS,68,201,222,423
MACHAKOS,MACHAKOS,69,267,352,619
MACHAKOS,MACHAKOS,65-69,1580,1900,3480
MACHAKOS,MACHAKOS,70,317,430,747
MACHAKOS,MACHAKOS,71,239,299,538
MACHAKOS,MACHAKOS,72,181,182,363
MACHAKOS,MACHAKOS,73,160,171,331
MACHAKOS,MACHAKOS,74,181,211,392
MACHAKOS,MACHAKOS,70-74,1078,1293,2371
MACHAKOS,MACHAKOS,75,136,146,282
MACHAKOS,MACHAKOS,76,108,147,255
MACHAKOS,MACHAKOS,77,110,175,285
MACHAKOS,MACHAKOS,78,79,95,174
MACHAKOS,MACHAKOS,79,77,183,260
MACHAKOS,MACHAKOS,75-79,510,746,1256
MACHAKOS,MACHAKOS,80,104,213,317
MACHAKOS,MACHAKOS,81,82,138,220
MACHAKOS,MACHAKOS,82,61,80,141
MACHAKOS,MACHAKOS,83,69,108,177
MACHAKOS,MACHAKOS,84,63,103,166
MACHAKOS,MACHAKOS,80-84,379,642,1021
MACHAKOS,MACHAKOS,85,56,72,128
MACHAKOS,MACHAKOS,86,31,43,74
MACHAKOS,MACHAKOS,87,39,68,107
MACHAKOS,MACHAKOS,88,14,27,41
MACHAKOS,MACHAKOS,89,39,129,168
MACHAKOS,MACHAKOS,85-89,179,339,518
MACHAKOS,MACHAKOS,90,25,68,93
MACHAKOS,MACHAKOS,91,39,88,127
MACHAKOS,MACHAKOS,92,16,35,51
MACHAKOS,MACHAKOS,93,10,19,29
MACHAKOS,MACHAKOS,94,11,28,39
MACHAKOS,MACHAKOS,90-94,101,238,339
MACHAKOS,MACHAKOS,95,9,32,41
MACHAKOS,MACHAKOS,96,4,19,23
MACHAKOS,MACHAKOS,97,11,16,27
MACHAKOS,MACHAKOS,98,5,14,19
MACHAKOS,MACHAKOS,99,9,36,45
MACHAKOS,MACHAKOS,95-99,38,117,155
MACHAKOS,MACHAKOS,100+,23,65,88
MACHAKOS,MACHAKOS,Not Stated,2,-,2
MACHAKOS,MASINGA,Total,73519,75001,148520
MACHAKOS,MASINGA,0,1478,1434,2912
MACHAKOS,MASINGA,1,1588,1595,3183
MACHAKOS,MASINGA,2,1583,1590,3173
MACHAKOS,MASINGA,3,1640,1729,3369
MACHAKOS,MASINGA,4,1789,1598,3387
MACHAKOS,MASINGA,0 - 4,8078,7946,16024
MACHAKOS,MASINGA,5,1757,1657,3414
MACHAKOS,MASINGA,6,1722,1659,3381
MACHAKOS,MASINGA,7,1765,1629,3394
MACHAKOS,MASINGA,8,1840,1813,3653
MACHAKOS,MASINGA,9,2044,1887,3931
MACHAKOS,MASINGA,05-Sep,9128,8645,17773
MACHAKOS,MASINGA,10,2032,1901,3933
MACHAKOS,MASINGA,11,2034,2135,4169
MACHAKOS,MASINGA,12,2210,2125,4335
MACHAKOS,MASINGA,13,2207,2079,4286
MACHAKOS,MASINGA,14,2108,2027,4135
MACHAKOS,MASINGA,Oct-14,10591,10267,20858
MACHAKOS,MASINGA,15,2227,2031,4258
MACHAKOS,MASINGA,16,1965,1900,3865
MACHAKOS,MASINGA,17,2075,1823,3898
MACHAKOS,MASINGA,18,1640,1408,3048
MACHAKOS,MASINGA,19,1643,1341,2984
MACHAKOS,MASINGA,15-19,9550,8503,18053
MACHAKOS,MASINGA,20,1519,1333,2852
MACHAKOS,MASINGA,21,1247,1088,2335
MACHAKOS,MASINGA,22,1019,1018,2037
MACHAKOS,MASINGA,23,1110,1143,2253
MACHAKOS,MASINGA,24,922,961,1883
MACHAKOS,MASINGA,20-24,5817,5543,11360
MACHAKOS,MASINGA,25,936,990,1926
MACHAKOS,MASINGA,26,839,920,1759
MACHAKOS,MASINGA,27,904,958,1862
MACHAKOS,MASINGA,28,758,906,1664
MACHAKOS,MASINGA,29,903,1022,1925
MACHAKOS,MASINGA,25-29,4340,4796,9136
MACHAKOS,MASINGA,30,1088,1204,2292
MACHAKOS,MASINGA,31,877,930,1807
MACHAKOS,MASINGA,32,1001,1071,2072
MACHAKOS,MASINGA,33,865,1038,1903
MACHAKOS,MASINGA,34,783,865,1648
MACHAKOS,MASINGA,30-34,4614,5108,9722
MACHAKOS,MASINGA,35,1090,1175,2265
MACHAKOS,MASINGA,36,805,883,1688
MACHAKOS,MASINGA,37,898,877,1775
MACHAKOS,MASINGA,38,639,615,1254
MACHAKOS,MASINGA,39,811,861,1672
MACHAKOS,MASINGA,35-39,4243,4411,8654
MACHAKOS,MASINGA,40,866,849,1715
MACHAKOS,MASINGA,41,842,923,1765
MACHAKOS,MASINGA,42,696,743,1439
MACHAKOS,MASINGA,43,598,789,1387
MACHAKOS,MASINGA,44,580,582,1162
MACHAKOS,MASINGA,40-44,3582,3886,7468
MACHAKOS,MASINGA,45,839,860,1699
MACHAKOS,MASINGA,46,653,634,1287
MACHAKOS,MASINGA,47,687,620,1307
MACHAKOS,MASINGA,48,417,484,901
MACHAKOS,MASINGA,49,594,691,1285
MACHAKOS,MASINGA,45-49,3190,3289,6479
MACHAKOS,MASINGA,50,576,673,1249
MACHAKOS,MASINGA,51,508,626,1134
MACHAKOS,MASINGA,52,402,420,822
MACHAKOS,MASINGA,53,345,362,707
MACHAKOS,MASINGA,54,426,428,854
MACHAKOS,MASINGA,50-54,2257,2509,4766
MACHAKOS,MASINGA,55,459,429,888
MACHAKOS,MASINGA,56,545,608,1153
MACHAKOS,MASINGA,57,366,513,879
MACHAKOS,MASINGA,58,283,364,647
MACHAKOS,MASINGA,59,428,499,927
MACHAKOS,MASINGA,55-59,2081,2413,4494
MACHAKOS,MASINGA,60,497,488,985
MACHAKOS,MASINGA,61,499,466,965
MACHAKOS,MASINGA,62,345,359,704
MACHAKOS,MASINGA,63,370,406,776
MACHAKOS,MASINGA,64,251,287,538
MACHAKOS,MASINGA,60-64,1962,2006,3968
MACHAKOS,MASINGA,65,353,407,760
MACHAKOS,MASINGA,66,238,297,535
MACHAKOS,MASINGA,67,499,642,1141
MACHAKOS,MASINGA,68,193,244,437
MACHAKOS,MASINGA,69,282,348,630
MACHAKOS,MASINGA,65-69,1565,1938,3503
MACHAKOS,MASINGA,70,297,443,740
MACHAKOS,MASINGA,71,247,375,622
MACHAKOS,MASINGA,72,196,198,394
MACHAKOS,MASINGA,73,160,195,355
MACHAKOS,MASINGA,74,146,220,366
MACHAKOS,MASINGA,70-74,1046,1431,2477
MACHAKOS,MASINGA,75,109,176,285
MACHAKOS,MASINGA,76,85,173,258
MACHAKOS,MASINGA,77,118,191,309
MACHAKOS,MASINGA,78,91,103,194
MACHAKOS,MASINGA,79,99,204,303
MACHAKOS,MASINGA,75-79,502,847,1349
MACHAKOS,MASINGA,80,142,231,373
MACHAKOS,MASINGA,81,90,115,205
MACHAKOS,MASINGA,82,72,82,154
MACHAKOS,MASINGA,83,86,86,172
MACHAKOS,MASINGA,84,76,87,163
MACHAKOS,MASINGA,80-84,466,601,1067
MACHAKOS,MASINGA,85,45,71,116
MACHAKOS,MASINGA,86,48,47,95
MACHAKOS,MASINGA,87,62,80,142
MACHAKOS,MASINGA,88,38,22,60
MACHAKOS,MASINGA,89,56,141,197
MACHAKOS,MASINGA,85-89,249,361,610
MACHAKOS,MASINGA,90,42,66,108
MACHAKOS,MASINGA,91,47,107,154
MACHAKOS,MASINGA,92,21,42,63
MACHAKOS,MASINGA,93,18,39,57
MACHAKOS,MASINGA,94,14,26,40
MACHAKOS,MASINGA,90-94,142,280,422
MACHAKOS,MASINGA,95,18,42,60
MACHAKOS,MASINGA,96,10,15,25
MACHAKOS,MASINGA,97,23,15,38
MACHAKOS,MASINGA,98,14,16,30
MACHAKOS,MASINGA,99,18,55,73
MACHAKOS,MASINGA,95-99,83,143,226
MACHAKOS,MASINGA,100+,33,78,111
MACHAKOS,MASINGA,Not Stated,-,-,-
MACHAKOS,MATUNGULU,Total,81145,80407,161552
MACHAKOS,MATUNGULU,0,1554,1625,3179
MACHAKOS,MATUNGULU,1,1594,1567,3161
MACHAKOS,MATUNGULU,2,1613,1601,3214
MACHAKOS,MATUNGULU,3,1663,1702,3365
MACHAKOS,MATUNGULU,4,1754,1699,3453
MACHAKOS,MATUNGULU,0 - 4,8178,8194,16372
MACHAKOS,MATUNGULU,5,1707,1647,3354
MACHAKOS,MATUNGULU,6,1668,1639,3307
MACHAKOS,MATUNGULU,7,1724,1626,3350
MACHAKOS,MATUNGULU,8,1743,1772,3515
MACHAKOS,MATUNGULU,9,1968,1876,3844
MACHAKOS,MATUNGULU,05-Sep,8810,8560,17370
MACHAKOS,MATUNGULU,10,1992,1906,3898
MACHAKOS,MATUNGULU,11,1889,1939,3828
MACHAKOS,MATUNGULU,12,2079,2017,4096
MACHAKOS,MATUNGULU,13,2088,2084,4172
MACHAKOS,MATUNGULU,14,2015,1918,3933
MACHAKOS,MATUNGULU,Oct-14,10063,9864,19927
MACHAKOS,MATUNGULU,15,1888,1838,3726
MACHAKOS,MATUNGULU,16,1897,1773,3670
MACHAKOS,MATUNGULU,17,1941,1808,3749
MACHAKOS,MATUNGULU,18,1535,1372,2907
MACHAKOS,MATUNGULU,19,1620,1524,3144
MACHAKOS,MATUNGULU,15-19,8881,8315,17196
MACHAKOS,MATUNGULU,20,1520,1379,2899
MACHAKOS,MATUNGULU,21,1388,1233,2621
MACHAKOS,MATUNGULU,22,1185,1188,2373
MACHAKOS,MATUNGULU,23,1387,1300,2687
MACHAKOS,MATUNGULU,24,1245,1225,2470
MACHAKOS,MATUNGULU,20-24,6725,6325,13050
MACHAKOS,MATUNGULU,25,1268,1214,2482
MACHAKOS,MATUNGULU,26,1087,1096,2183
MACHAKOS,MATUNGULU,27,1189,1085,2274
MACHAKOS,MATUNGULU,28,1027,1023,2050
MACHAKOS,MATUNGULU,29,1201,1187,2388
MACHAKOS,MATUNGULU,25-29,5772,5605,11377
MACHAKOS,MATUNGULU,30,1313,1415,2728
MACHAKOS,MATUNGULU,31,1129,1079,2208
MACHAKOS,MATUNGULU,32,1266,1347,2613
MACHAKOS,MATUNGULU,33,1178,1256,2434
MACHAKOS,MATUNGULU,34,1017,1110,2127
MACHAKOS,MATUNGULU,30-34,5903,6207,12110
MACHAKOS,MATUNGULU,35,1272,1377,2649
MACHAKOS,MATUNGULU,36,1078,1071,2149
MACHAKOS,MATUNGULU,37,1204,1028,2232
MACHAKOS,MATUNGULU,38,895,905,1800
MACHAKOS,MATUNGULU,39,1127,1072,2199
MACHAKOS,MATUNGULU,35-39,5576,5453,11029
MACHAKOS,MATUNGULU,40,1189,1124,2313
MACHAKOS,MATUNGULU,41,1175,1049,2224
MACHAKOS,MATUNGULU,42,1037,934,1971
MACHAKOS,MATUNGULU,43,924,931,1855
MACHAKOS,MATUNGULU,44,794,724,1518
MACHAKOS,MATUNGULU,40-44,5119,4762,9881
MACHAKOS,MATUNGULU,45,1057,929,1986
MACHAKOS,MATUNGULU,46,872,743,1615
MACHAKOS,MATUNGULU,47,876,758,1634
MACHAKOS,MATUNGULU,48,597,570,1167
MACHAKOS,MATUNGULU,49,777,714,1491
MACHAKOS,MATUNGULU,45-49,4179,3714,7893
MACHAKOS,MATUNGULU,50,773,784,1557
MACHAKOS,MATUNGULU,51,640,629,1269
MACHAKOS,MATUNGULU,52,573,499,1072
MACHAKOS,MATUNGULU,53,428,414,842
MACHAKOS,MATUNGULU,54,558,514,1072
MACHAKOS,MATUNGULU,50-54,2972,2840,5812
MACHAKOS,MATUNGULU,55,561,543,1104
MACHAKOS,MATUNGULU,56,672,689,1361
MACHAKOS,MATUNGULU,57,481,543,1024
MACHAKOS,MATUNGULU,58,397,397,794
MACHAKOS,MATUNGULU,59,517,542,1059
MACHAKOS,MATUNGULU,55-59,2628,2714,5342
MACHAKOS,MATUNGULU,60,602,666,1268
MACHAKOS,MATUNGULU,61,537,524,1061
MACHAKOS,MATUNGULU,62,417,459,876
MACHAKOS,MATUNGULU,63,418,470,888
MACHAKOS,MATUNGULU,64,290,363,653
MACHAKOS,MATUNGULU,60-64,2264,2482,4746
MACHAKOS,MATUNGULU,65,408,442,850
MACHAKOS,MATUNGULU,66,282,298,580
MACHAKOS,MATUNGULU,67,495,563,1058
MACHAKOS,MATUNGULU,68,179,216,395
MACHAKOS,MATUNGULU,69,284,315,599
MACHAKOS,MATUNGULU,65-69,1648,1834,3482
MACHAKOS,MATUNGULU,70,315,368,683
MACHAKOS,MATUNGULU,71,267,297,564
MACHAKOS,MATUNGULU,72,193,201,394
MACHAKOS,MATUNGULU,73,181,195,376
MACHAKOS,MATUNGULU,74,132,204,336
MACHAKOS,MATUNGULU,70-74,1088,1265,2353
MACHAKOS,MATUNGULU,75,122,177,299
MACHAKOS,MATUNGULU,76,104,144,248
MACHAKOS,MATUNGULU,77,142,191,333
MACHAKOS,MATUNGULU,78,79,103,182
MACHAKOS,MATUNGULU,79,73,155,228
MACHAKOS,MATUNGULU,75-79,520,770,1290
MACHAKOS,MATUNGULU,80,113,232,345
MACHAKOS,MATUNGULU,81,81,119,200
MACHAKOS,MATUNGULU,82,83,73,156
MACHAKOS,MATUNGULU,83,80,110,190
MACHAKOS,MATUNGULU,84,63,97,160
MACHAKOS,MATUNGULU,80-84,420,631,1051
MACHAKOS,MATUNGULU,85,51,82,133
MACHAKOS,MATUNGULU,86,35,46,81
MACHAKOS,MATUNGULU,87,44,96,140
MACHAKOS,MATUNGULU,88,33,40,73
MACHAKOS,MATUNGULU,89,35,103,138
MACHAKOS,MATUNGULU,85-89,198,367,565
MACHAKOS,MATUNGULU,90,27,69,96
MACHAKOS,MATUNGULU,91,36,105,141
MACHAKOS,MATUNGULU,92,16,43,59
MACHAKOS,MATUNGULU,93,17,24,41
MACHAKOS,MATUNGULU,94,15,50,65
MACHAKOS,MATUNGULU,90-94,111,291,402
MACHAKOS,MATUNGULU,95,24,40,64
MACHAKOS,MATUNGULU,96,9,23,32
MACHAKOS,MATUNGULU,97,8,11,19
MACHAKOS,MATUNGULU,98,10,21,31
MACHAKOS,MATUNGULU,99,8,44,52
MACHAKOS,MATUNGULU,95-99,59,139,198
MACHAKOS,MATUNGULU,100+,31,74,105
MACHAKOS,MATUNGULU,Not Stated,-,1,1
MACHAKOS,MWALA,Total,90427,91466,181893
MACHAKOS,MWALA,0,1540,1536,3076
MACHAKOS,MWALA,1,1684,1598,3282
MACHAKOS,MWALA,2,1672,1653,3325
MACHAKOS,MWALA,3,1772,1776,3548
MACHAKOS,MWALA,4,1845,1715,3560
MACHAKOS,MWALA,0 - 4,8513,8278,16791
MACHAKOS,MWALA,5,1918,1724,3642
MACHAKOS,MWALA,6,1816,1808,3624
MACHAKOS,MWALA,7,2011,1861,3872
MACHAKOS,MWALA,8,2009,1964,3973
MACHAKOS,MWALA,9,2236,2108,4344
MACHAKOS,MWALA,05-Sep,9990,9465,19455
MACHAKOS,MWALA,10,2231,2146,4377
MACHAKOS,MWALA,11,2316,2367,4683
MACHAKOS,MWALA,12,2552,2391,4943
MACHAKOS,MWALA,13,2442,2320,4762
MACHAKOS,MWALA,14,2539,2216,4755
MACHAKOS,MWALA,Oct-14,12080,11440,23520
MACHAKOS,MWALA,15,2488,2417,4905
MACHAKOS,MWALA,16,2403,2230,4633
MACHAKOS,MWALA,17,2570,2352,4922
MACHAKOS,MWALA,18,1959,1664,3623
MACHAKOS,MWALA,19,2071,1615,3686
MACHAKOS,MWALA,15-19,11491,10278,21769
MACHAKOS,MWALA,20,1826,1417,3243
MACHAKOS,MWALA,21,1569,1293,2862
MACHAKOS,MWALA,22,1337,1152,2489
MACHAKOS,MWALA,23,1423,1219,2642
MACHAKOS,MWALA,24,1247,1082,2329
MACHAKOS,MWALA,20-24,7402,6163,13565
MACHAKOS,MWALA,25,1308,1144,2452
MACHAKOS,MWALA,26,996,991,1987
MACHAKOS,MWALA,27,1135,1068,2203
MACHAKOS,MWALA,28,958,969,1927
MACHAKOS,MWALA,29,1208,1219,2427
MACHAKOS,MWALA,25-29,5605,5391,10996
MACHAKOS,MWALA,30,1325,1447,2772
MACHAKOS,MWALA,31,1042,1089,2131
MACHAKOS,MWALA,32,1206,1381,2587
MACHAKOS,MWALA,33,1133,1237,2370
MACHAKOS,MWALA,34,1045,1078,2123
MACHAKOS,MWALA,30-34,5751,6232,11983
MACHAKOS,MWALA,35,1274,1353,2627
MACHAKOS,MWALA,36,969,1083,2052
MACHAKOS,MWALA,37,1096,1097,2193
MACHAKOS,MWALA,38,829,774,1603
MACHAKOS,MWALA,39,1073,1144,2217
MACHAKOS,MWALA,35-39,5241,5451,10692
MACHAKOS,MWALA,40,1022,1110,2132
MACHAKOS,MWALA,41,1157,1180,2337
MACHAKOS,MWALA,42,928,1037,1965
MACHAKOS,MWALA,43,910,1205,2115
MACHAKOS,MWALA,44,789,915,1704
MACHAKOS,MWALA,40-44,4806,5447,10253
MACHAKOS,MWALA,45,1077,1097,2174
MACHAKOS,MWALA,46,799,820,1619
MACHAKOS,MWALA,47,867,834,1701
MACHAKOS,MWALA,48,614,663,1277
MACHAKOS,MWALA,49,845,930,1775
MACHAKOS,MWALA,45-49,4202,4344,8546
MACHAKOS,MWALA,50,829,1016,1845
MACHAKOS,MWALA,51,752,826,1578
MACHAKOS,MWALA,52,552,659,1211
MACHAKOS,MWALA,53,467,571,1038
MACHAKOS,MWALA,54,591,664,1255
MACHAKOS,MWALA,50-54,3191,3736,6927
MACHAKOS,MWALA,55,656,686,1342
MACHAKOS,MWALA,56,716,808,1524
MACHAKOS,MWALA,57,603,809,1412
MACHAKOS,MWALA,58,486,528,1014
MACHAKOS,MWALA,59,638,724,1362
MACHAKOS,MWALA,55-59,3099,3555,6654
MACHAKOS,MWALA,60,778,902,1680
MACHAKOS,MWALA,61,724,685,1409
MACHAKOS,MWALA,62,556,509,1065
MACHAKOS,MWALA,63,539,605,1144
MACHAKOS,MWALA,64,376,404,780
MACHAKOS,MWALA,60-64,2973,3105,6078
MACHAKOS,MWALA,65,540,610,1150
MACHAKOS,MWALA,66,331,402,733
MACHAKOS,MWALA,67,643,724,1367
MACHAKOS,MWALA,68,230,298,528
MACHAKOS,MWALA,69,387,527,914
MACHAKOS,MWALA,65-69,2131,2561,4692
MACHAKOS,MWALA,70,506,604,1110
MACHAKOS,MWALA,71,361,430,791
MACHAKOS,MWALA,72,271,279,550
MACHAKOS,MWALA,73,262,289,551
MACHAKOS,MWALA,74,221,328,549
MACHAKOS,MWALA,70-74,1621,1930,3551
MACHAKOS,MWALA,75,195,277,472
MACHAKOS,MWALA,76,127,285,412
MACHAKOS,MWALA,77,179,331,510
MACHAKOS,MWALA,78,119,150,269
MACHAKOS,MWALA,79,127,350,477
MACHAKOS,MWALA,75-79,747,1393,2140
MACHAKOS,MWALA,80,220,365,585
MACHAKOS,MWALA,81,136,193,329
MACHAKOS,MWALA,82,116,107,223
MACHAKOS,MWALA,83,133,163,296
MACHAKOS,MWALA,84,86,185,271
MACHAKOS,MWALA,80-84,691,1013,1704
MACHAKOS,MWALA,85,81,164,245
MACHAKOS,MWALA,86,55,57,112
MACHAKOS,MWALA,87,82,138,220
MACHAKOS,MWALA,88,42,48,90
MACHAKOS,MWALA,89,91,272,363
MACHAKOS,MWALA,85-89,351,679,1030
MACHAKOS,MWALA,90,90,183,273
MACHAKOS,MWALA,91,119,210,329
MACHAKOS,MWALA,92,44,75,119
MACHAKOS,MWALA,93,28,60,88
MACHAKOS,MWALA,94,28,65,93
MACHAKOS,MWALA,90-94,309,593,902
MACHAKOS,MWALA,95,55,98,153
MACHAKOS,MWALA,96,27,39,66
MACHAKOS,MWALA,97,32,37,69
MACHAKOS,MWALA,98,16,40,56
MACHAKOS,MWALA,99,31,72,103
MACHAKOS,MWALA,95-99,161,286,447
MACHAKOS,MWALA,100+,70,126,196
MACHAKOS,MWALA,Not Stated,2,-,2
MACHAKOS,YATTA,Total,85437,87144,172581
MACHAKOS,YATTA,0,1610,1696,3306
MACHAKOS,YATTA,1,1767,1686,3453
MACHAKOS,YATTA,2,1676,1783,3459
MACHAKOS,YATTA,3,1864,1798,3662
MACHAKOS,YATTA,4,1884,1809,3693
MACHAKOS,YATTA,0 - 4,8801,8772,17573
MACHAKOS,YATTA,5,1904,1810,3714
MACHAKOS,YATTA,6,1832,1825,3657
MACHAKOS,YATTA,7,1860,1866,3726
MACHAKOS,YATTA,8,1929,1982,3911
MACHAKOS,YATTA,9,2148,1965,4113
MACHAKOS,YATTA,05-Sep,9673,9448,19121
MACHAKOS,YATTA,10,2187,2164,4351
MACHAKOS,YATTA,11,2214,2370,4584
MACHAKOS,YATTA,12,2360,2321,4681
MACHAKOS,YATTA,13,2248,2285,4533
MACHAKOS,YATTA,14,2371,2235,4606
MACHAKOS,YATTA,Oct-14,11380,11375,22755
MACHAKOS,YATTA,15,2272,2281,4553
MACHAKOS,YATTA,16,2291,2275,4566
MACHAKOS,YATTA,17,2276,2077,4353
MACHAKOS,YATTA,18,1804,1631,3435
MACHAKOS,YATTA,19,1951,1598,3549
MACHAKOS,YATTA,15-19,10594,9862,20456
MACHAKOS,YATTA,20,1868,1740,3608
MACHAKOS,YATTA,21,1667,1511,3178
MACHAKOS,YATTA,22,1571,1415,2986
MACHAKOS,YATTA,23,1740,1541,3281
MACHAKOS,YATTA,24,1423,1323,2746
MACHAKOS,YATTA,20-24,8269,7530,15799
MACHAKOS,YATTA,25,1388,1264,2652
MACHAKOS,YATTA,26,1042,1146,2188
MACHAKOS,YATTA,27,1146,1174,2320
MACHAKOS,YATTA,28,1002,1053,2055
MACHAKOS,YATTA,29,1217,1333,2550
MACHAKOS,YATTA,25-29,5795,5970,11765
MACHAKOS,YATTA,30,1343,1488,2831
MACHAKOS,YATTA,31,1053,1095,2148
MACHAKOS,YATTA,32,1208,1378,2586
MACHAKOS,YATTA,33,1076,1258,2334
MACHAKOS,YATTA,34,1003,1077,2080
MACHAKOS,YATTA,30-34,5683,6296,11979
MACHAKOS,YATTA,35,1217,1359,2576
MACHAKOS,YATTA,36,943,1022,1965
MACHAKOS,YATTA,37,1082,1004,2086
MACHAKOS,YATTA,38,756,754,1510
MACHAKOS,YATTA,39,1047,1066,2113
MACHAKOS,YATTA,35-39,5045,5205,10250
MACHAKOS,YATTA,40,1050,1019,2069
MACHAKOS,YATTA,41,1088,1046,2134
MACHAKOS,YATTA,42,913,866,1779
MACHAKOS,YATTA,43,779,891,1670
MACHAKOS,YATTA,44,696,701,1397
MACHAKOS,YATTA,40-44,4526,4523,9049
MACHAKOS,YATTA,45,959,882,1841
MACHAKOS,YATTA,46,750,721,1471
MACHAKOS,YATTA,47,765,711,1476
MACHAKOS,YATTA,48,509,582,1091
MACHAKOS,YATTA,49,752,750,1502
MACHAKOS,YATTA,45-49,3735,3646,7381
MACHAKOS,YATTA,50,699,768,1467
MACHAKOS,YATTA,51,579,658,1237
MACHAKOS,YATTA,52,481,515,996
MACHAKOS,YATTA,53,386,392,778
MACHAKOS,YATTA,54,466,492,958
MACHAKOS,YATTA,50-54,2611,2825,5436
MACHAKOS,YATTA,55,510,500,1010
MACHAKOS,YATTA,56,604,702,1306
MACHAKOS,YATTA,57,469,550,1019
MACHAKOS,YATTA,58,346,422,768
MACHAKOS,YATTA,59,547,585,1132
MACHAKOS,YATTA,55-59,2476,2759,5235
MACHAKOS,YATTA,60,637,671,1308
MACHAKOS,YATTA,61,536,538,1074
MACHAKOS,YATTA,62,426,446,872
MACHAKOS,YATTA,63,452,461,913
MACHAKOS,YATTA,64,295,293,588
MACHAKOS,YATTA,60-64,2346,2409,4755
MACHAKOS,YATTA,65,390,479,869
MACHAKOS,YATTA,66,261,323,584
MACHAKOS,YATTA,67,550,692,1242
MACHAKOS,YATTA,68,184,232,416
MACHAKOS,YATTA,69,288,461,749
MACHAKOS,YATTA,65-69,1673,2187,3860
MACHAKOS,YATTA,70,367,513,880
MACHAKOS,YATTA,71,270,382,652
MACHAKOS,YATTA,72,189,194,383
MACHAKOS,YATTA,73,163,240,403
MACHAKOS,YATTA,74,183,245,428
MACHAKOS,YATTA,70-74,1172,1574,2746
MACHAKOS,YATTA,75,137,199,336
MACHAKOS,YATTA,76,92,177,269
MACHAKOS,YATTA,77,147,246,393
MACHAKOS,YATTA,78,102,85,187
MACHAKOS,YATTA,79,99,253,352
MACHAKOS,YATTA,75-79,577,960,1537
MACHAKOS,YATTA,80,148,267,415
MACHAKOS,YATTA,81,86,143,229
MACHAKOS,YATTA,82,89,99,188
MACHAKOS,YATTA,83,98,131,229
MACHAKOS,YATTA,84,82,135,217
MACHAKOS,YATTA,80-84,503,775,1278
MACHAKOS,YATTA,85,78,88,166
MACHAKOS,YATTA,86,47,38,85
MACHAKOS,YATTA,87,59,104,163
MACHAKOS,YATTA,88,32,36,68
MACHAKOS,YATTA,89,57,163,220
MACHAKOS,YATTA,85-89,273,429,702
MACHAKOS,YATTA,90,45,116,161
MACHAKOS,YATTA,91,62,123,185
MACHAKOS,YATTA,92,29,39,68
MACHAKOS,YATTA,93,18,45,63
MACHAKOS,YATTA,94,18,30,48
MACHAKOS,YATTA,90-94,172,353,525
MACHAKOS,YATTA,95,29,51,80
MACHAKOS,YATTA,96,19,17,36
MACHAKOS,YATTA,97,16,25,41
MACHAKOS,YATTA,98,11,13,24
MACHAKOS,YATTA,99,17,47,64
MACHAKOS,YATTA,95-99,92,153,245
MACHAKOS,YATTA,100+,38,93,131
MACHAKOS,YATTA,Not Stated,3,-,3
MAKUENI,ALL,Total,489691,497942,987633
MAKUENI,ALL,0,8826,8890,17716
MAKUENI,ALL,1,9757,9531,19288
MAKUENI,ALL,2,9579,9516,19095
MAKUENI,ALL,3,10166,9706,19872
MAKUENI,ALL,4,10405,10049,20454
MAKUENI,ALL,0 - 4,48733,47692,96425
MAKUENI,ALL,5,10825,10326,21151
MAKUENI,ALL,6,10491,10290,20781
MAKUENI,ALL,7,11042,10716,21758
MAKUENI,ALL,8,11657,11316,22973
MAKUENI,ALL,9,12544,12195,24739
MAKUENI,ALL,05-Sep,56559,54843,111402
MAKUENI,ALL,10,13093,12890,25983
MAKUENI,ALL,11,13252,13439,26691
MAKUENI,ALL,12,14555,13874,28429
MAKUENI,ALL,13,14056,13982,28038
MAKUENI,ALL,14,13988,13264,27252
MAKUENI,ALL,Oct-14,68944,67449,136393
MAKUENI,ALL,15,14111,13563,27674
MAKUENI,ALL,16,13345,12993,26338
MAKUENI,ALL,17,14065,12908,26973
MAKUENI,ALL,18,10939,9672,20611
MAKUENI,ALL,19,11472,9791,21263
MAKUENI,ALL,15-19,63932,58927,122859
MAKUENI,ALL,20,10050,8849,18899
MAKUENI,ALL,21,8561,7912,16473
MAKUENI,ALL,22,7515,7016,14531
MAKUENI,ALL,23,7877,7830,15707
MAKUENI,ALL,24,7255,6910,14165
MAKUENI,ALL,20-24,41258,38517,79775
MAKUENI,ALL,25,7787,7452,15239
MAKUENI,ALL,26,6349,6686,13035
MAKUENI,ALL,27,6706,6489,13195
MAKUENI,ALL,28,5412,5611,11023
MAKUENI,ALL,29,6583,6809,13392
MAKUENI,ALL,25-29,32837,33047,65884
MAKUENI,ALL,30,7524,8235,15759
MAKUENI,ALL,31,5764,6059,11823
MAKUENI,ALL,32,6750,7396,14146
MAKUENI,ALL,33,6283,6947,13230
MAKUENI,ALL,34,5360,5941,11301
MAKUENI,ALL,30-34,31681,34578,66259
MAKUENI,ALL,35,7375,7598,14973
MAKUENI,ALL,36,5225,5393,10618
MAKUENI,ALL,37,5834,5585,11419
MAKUENI,ALL,38,4069,4257,8326
MAKUENI,ALL,39,5528,5663,11191
MAKUENI,ALL,35-39,28031,28496,56527
MAKUENI,ALL,40,5689,5649,11338
MAKUENI,ALL,41,5690,5431,11121
MAKUENI,ALL,42,4868,4621,9489
MAKUENI,ALL,43,4366,4874,9240
MAKUENI,ALL,44,4144,4596,8740
MAKUENI,ALL,40-44,24757,25171,49928
MAKUENI,ALL,45,6093,6594,12687
MAKUENI,ALL,46,4393,4756,9149
MAKUENI,ALL,47,4515,4825,9340
MAKUENI,ALL,48,3168,3294,6462
MAKUENI,ALL,49,4377,4840,9217
MAKUENI,ALL,45-49,22546,24309,46855
MAKUENI,ALL,50,4139,4404,8543
MAKUENI,ALL,51,3629,3687,7316
MAKUENI,ALL,52,2856,2949,5805
MAKUENI,ALL,53,2440,2473,4913
MAKUENI,ALL,54,3064,2919,5983
MAKUENI,ALL,50-54,16128,16432,32560
MAKUENI,ALL,55,3018,2967,5985
MAKUENI,ALL,56,2974,3354,6328
MAKUENI,ALL,57,2783,3497,6280
MAKUENI,ALL,58,2025,2288,4313
MAKUENI,ALL,59,2976,3361,6337
MAKUENI,ALL,55-59,13776,15467,29243
MAKUENI,ALL,60,3328,3843,7171
MAKUENI,ALL,61,2863,3212,6075
MAKUENI,ALL,62,2257,2491,4748
MAKUENI,ALL,63,2436,2766,5202
MAKUENI,ALL,64,1721,1907,3628
MAKUENI,ALL,60-64,12605,14219,26824
MAKUENI,ALL,65,2555,3182,5737
MAKUENI,ALL,66,1626,1777,3403
MAKUENI,ALL,67,2982,3732,6714
MAKUENI,ALL,68,1214,1554,2768
MAKUENI,ALL,69,1899,2478,4377
MAKUENI,ALL,65-69,10276,12723,22999
MAKUENI,ALL,70,2223,3049,5272
MAKUENI,ALL,71,1695,2137,3832
MAKUENI,ALL,72,1270,1230,2500
MAKUENI,ALL,73,1186,1475,2661
MAKUENI,ALL,74,1104,1660,2764
MAKUENI,ALL,70-74,7478,9551,17029
MAKUENI,ALL,75,856,1280,2136
MAKUENI,ALL,76,630,861,1491
MAKUENI,ALL,77,922,1358,2280
MAKUENI,ALL,78,580,667,1247
MAKUENI,ALL,79,692,1525,2217
MAKUENI,ALL,75-79,3680,5691,9371
MAKUENI,ALL,80,927,1632,2559
MAKUENI,ALL,81,548,781,1329
MAKUENI,ALL,82,466,514,980
MAKUENI,ALL,83,579,703,1282
MAKUENI,ALL,84,454,803,1257
MAKUENI,ALL,80-84,2974,4433,7407
MAKUENI,ALL,85,368,517,885
MAKUENI,ALL,86,248,277,525
MAKUENI,ALL,87,352,542,894
MAKUENI,ALL,88,174,213,387
MAKUENI,ALL,89,409,1065,1474
MAKUENI,ALL,85-89,1551,2614,4165
MAKUENI,ALL,90,311,772,1083
MAKUENI,ALL,91,288,752,1040
MAKUENI,ALL,92,204,320,524
MAKUENI,ALL,93,116,294,410
MAKUENI,ALL,94,111,240,351
MAKUENI,ALL,90-94,1030,2378,3408
MAKUENI,ALL,95,196,285,481
MAKUENI,ALL,96,70,96,166
MAKUENI,ALL,97,113,108,221
MAKUENI,ALL,98,75,95,170
MAKUENI,ALL,99,149,272,421
MAKUENI,ALL,95-99,603,856,1459
MAKUENI,ALL,100+,308,545,853
MAKUENI,ALL,Not Stated,4,4,8
MAKUENI,KATHONZWENI,Total,39335,40442,79777
MAKUENI,KATHONZWENI,0,696,717,1413
MAKUENI,KATHONZWENI,1,767,756,1523
MAKUENI,KATHONZWENI,2,716,745,1461
MAKUENI,KATHONZWENI,3,814,745,1559
MAKUENI,KATHONZWENI,4,799,791,1590
MAKUENI,KATHONZWENI,0 - 4,3792,3754,7546
MAKUENI,KATHONZWENI,5,834,829,1663
MAKUENI,KATHONZWENI,6,800,783,1583
MAKUENI,KATHONZWENI,7,906,863,1769
MAKUENI,KATHONZWENI,8,907,929,1836
MAKUENI,KATHONZWENI,9,1030,991,2021
MAKUENI,KATHONZWENI,05-Sep,4477,4395,8872
MAKUENI,KATHONZWENI,10,1054,1008,2062
MAKUENI,KATHONZWENI,11,1150,1171,2321
MAKUENI,KATHONZWENI,12,1211,1167,2378
MAKUENI,KATHONZWENI,13,1227,1107,2334
MAKUENI,KATHONZWENI,14,1141,1114,2255
MAKUENI,KATHONZWENI,Oct-14,5783,5567,11350
MAKUENI,KATHONZWENI,15,1262,1163,2425
MAKUENI,KATHONZWENI,16,1212,1161,2373
MAKUENI,KATHONZWENI,17,1252,1186,2438
MAKUENI,KATHONZWENI,18,1039,876,1915
MAKUENI,KATHONZWENI,19,966,800,1766
MAKUENI,KATHONZWENI,15-19,5731,5186,10917
MAKUENI,KATHONZWENI,20,869,754,1623
MAKUENI,KATHONZWENI,21,642,609,1251
MAKUENI,KATHONZWENI,22,573,490,1063
MAKUENI,KATHONZWENI,23,590,600,1190
MAKUENI,KATHONZWENI,24,570,493,1063
MAKUENI,KATHONZWENI,20-24,3244,2946,6190
MAKUENI,KATHONZWENI,25,603,566,1169
MAKUENI,KATHONZWENI,26,446,481,927
MAKUENI,KATHONZWENI,27,502,505,1007
MAKUENI,KATHONZWENI,28,373,390,763
MAKUENI,KATHONZWENI,29,522,488,1010
MAKUENI,KATHONZWENI,25-29,2446,2430,4876
MAKUENI,KATHONZWENI,30,566,583,1149
MAKUENI,KATHONZWENI,31,392,466,858
MAKUENI,KATHONZWENI,32,480,563,1043
MAKUENI,KATHONZWENI,33,418,571,989
MAKUENI,KATHONZWENI,34,386,446,832
MAKUENI,KATHONZWENI,30-34,2242,2629,4871
MAKUENI,KATHONZWENI,35,526,632,1158
MAKUENI,KATHONZWENI,36,383,418,801
MAKUENI,KATHONZWENI,37,454,436,890
MAKUENI,KATHONZWENI,38,308,341,649
MAKUENI,KATHONZWENI,39,419,518,937
MAKUENI,KATHONZWENI,35-39,2090,2345,4435
MAKUENI,KATHONZWENI,40,441,462,903
MAKUENI,KATHONZWENI,41,412,497,909
MAKUENI,KATHONZWENI,42,325,360,685
MAKUENI,KATHONZWENI,43,313,395,708
MAKUENI,KATHONZWENI,44,318,390,708
MAKUENI,KATHONZWENI,40-44,1809,2104,3913
MAKUENI,KATHONZWENI,45,541,584,1125
MAKUENI,KATHONZWENI,46,353,387,740
MAKUENI,KATHONZWENI,47,365,362,727
MAKUENI,KATHONZWENI,48,258,263,521
MAKUENI,KATHONZWENI,49,354,424,778
MAKUENI,KATHONZWENI,45-49,1871,2020,3891
MAKUENI,KATHONZWENI,50,353,369,722
MAKUENI,KATHONZWENI,51,330,319,649
MAKUENI,KATHONZWENI,52,221,264,485
MAKUENI,KATHONZWENI,53,211,195,406
MAKUENI,KATHONZWENI,54,218,241,459
MAKUENI,KATHONZWENI,50-54,1333,1388,2721
MAKUENI,KATHONZWENI,55,251,265,516
MAKUENI,KATHONZWENI,56,247,248,495
MAKUENI,KATHONZWENI,57,202,259,461
MAKUENI,KATHONZWENI,58,137,175,312
MAKUENI,KATHONZWENI,59,218,227,445
MAKUENI,KATHONZWENI,55-59,1055,1174,2229
MAKUENI,KATHONZWENI,60,259,302,561
MAKUENI,KATHONZWENI,61,203,240,443
MAKUENI,KATHONZWENI,62,185,188,373
MAKUENI,KATHONZWENI,63,166,176,342
MAKUENI,KATHONZWENI,64,120,134,254
MAKUENI,KATHONZWENI,60-64,933,1040,1973
MAKUENI,KATHONZWENI,65,191,245,436
MAKUENI,KATHONZWENI,66,99,133,232
MAKUENI,KATHONZWENI,67,233,356,589
MAKUENI,KATHONZWENI,68,117,141,258
MAKUENI,KATHONZWENI,69,124,218,342
MAKUENI,KATHONZWENI,65-69,764,1093,1857
MAKUENI,KATHONZWENI,70,197,279,476
MAKUENI,KATHONZWENI,71,133,208,341
MAKUENI,KATHONZWENI,72,120,110,230
MAKUENI,KATHONZWENI,73,106,133,239
MAKUENI,KATHONZWENI,74,118,172,290
MAKUENI,KATHONZWENI,70-74,674,902,1576
MAKUENI,KATHONZWENI,75,97,122,219
MAKUENI,KATHONZWENI,76,68,81,149
MAKUENI,KATHONZWENI,77,100,133,233
MAKUENI,KATHONZWENI,78,65,64,129
MAKUENI,KATHONZWENI,79,68,121,189
MAKUENI,KATHONZWENI,75-79,398,521,919
MAKUENI,KATHONZWENI,80,109,169,278
MAKUENI,KATHONZWENI,81,58,53,111
MAKUENI,KATHONZWENI,82,45,44,89
MAKUENI,KATHONZWENI,83,54,67,121
MAKUENI,KATHONZWENI,84,41,67,108
MAKUENI,KATHONZWENI,80-84,307,400,707
MAKUENI,KATHONZWENI,85,43,39,82
MAKUENI,KATHONZWENI,86,24,22,46
MAKUENI,KATHONZWENI,87,38,37,75
MAKUENI,KATHONZWENI,88,12,15,27
MAKUENI,KATHONZWENI,89,47,66,113
MAKUENI,KATHONZWENI,85-89,164,179,343
MAKUENI,KATHONZWENI,90,52,77,129
MAKUENI,KATHONZWENI,91,40,77,117
MAKUENI,KATHONZWENI,92,19,24,43
MAKUENI,KATHONZWENI,93,16,41,57
MAKUENI,KATHONZWENI,94,8,21,29
MAKUENI,KATHONZWENI,90-94,135,240,375
MAKUENI,KATHONZWENI,95,14,22,36
MAKUENI,KATHONZWENI,96,3,4,7
MAKUENI,KATHONZWENI,97,11,13,24
MAKUENI,KATHONZWENI,98,6,10,16
MAKUENI,KATHONZWENI,99,19,22,41
MAKUENI,KATHONZWENI,95-99,53,71,124
MAKUENI,KATHONZWENI,100+,34,58,92
MAKUENI,KATHONZWENI,Not Stated,-,-,-
MAKUENI,KIBWEZI,Total,98477,98517,196994
MAKUENI,KIBWEZI,0,1774,1790,3564
MAKUENI,KIBWEZI,1,2025,1870,3895
MAKUENI,KIBWEZI,2,2021,1888,3909
MAKUENI,KIBWEZI,3,2102,1935,4037
MAKUENI,KIBWEZI,4,2179,2180,4359
MAKUENI,KIBWEZI,0 - 4,10101,9663,19764
MAKUENI,KIBWEZI,5,2309,2254,4563
MAKUENI,KIBWEZI,6,2141,2228,4369
MAKUENI,KIBWEZI,7,2354,2277,4631
MAKUENI,KIBWEZI,8,2516,2391,4907
MAKUENI,KIBWEZI,9,2689,2610,5299
MAKUENI,KIBWEZI,05-Sep,12009,11760,23769
MAKUENI,KIBWEZI,10,2815,2823,5638
MAKUENI,KIBWEZI,11,2828,2850,5678
MAKUENI,KIBWEZI,12,3090,2855,5945
MAKUENI,KIBWEZI,13,2934,2930,5864
MAKUENI,KIBWEZI,14,3092,2757,5849
MAKUENI,KIBWEZI,Oct-14,14759,14215,28974
MAKUENI,KIBWEZI,15,2998,2928,5926
MAKUENI,KIBWEZI,16,2816,2726,5542
MAKUENI,KIBWEZI,17,2982,2687,5669
MAKUENI,KIBWEZI,18,2294,2007,4301
MAKUENI,KIBWEZI,19,2361,2002,4363
MAKUENI,KIBWEZI,15-19,13451,12350,25801
MAKUENI,KIBWEZI,20,1897,1696,3593
MAKUENI,KIBWEZI,21,1611,1527,3138
MAKUENI,KIBWEZI,22,1422,1413,2835
MAKUENI,KIBWEZI,23,1478,1526,3004
MAKUENI,KIBWEZI,24,1279,1337,2616
MAKUENI,KIBWEZI,20-24,7687,7499,15186
MAKUENI,KIBWEZI,25,1484,1443,2927
MAKUENI,KIBWEZI,26,1230,1273,2503
MAKUENI,KIBWEZI,27,1332,1306,2638
MAKUENI,KIBWEZI,28,1037,1143,2180
MAKUENI,KIBWEZI,29,1304,1364,2668
MAKUENI,KIBWEZI,25-29,6387,6529,12916
MAKUENI,KIBWEZI,30,1511,1605,3116
MAKUENI,KIBWEZI,31,1157,1188,2345
MAKUENI,KIBWEZI,32,1361,1526,2887
MAKUENI,KIBWEZI,33,1185,1354,2539
MAKUENI,KIBWEZI,34,1087,1255,2342
MAKUENI,KIBWEZI,30-34,6301,6928,13229
MAKUENI,KIBWEZI,35,1481,1462,2943
MAKUENI,KIBWEZI,36,978,990,1968
MAKUENI,KIBWEZI,37,1129,1065,2194
MAKUENI,KIBWEZI,38,792,755,1547
MAKUENI,KIBWEZI,39,1080,1050,2130
MAKUENI,KIBWEZI,35-39,5460,5322,10782
MAKUENI,KIBWEZI,40,1101,1078,2179
MAKUENI,KIBWEZI,41,1166,1071,2237
MAKUENI,KIBWEZI,42,1003,857,1860
MAKUENI,KIBWEZI,43,826,879,1705
MAKUENI,KIBWEZI,44,836,899,1735
MAKUENI,KIBWEZI,40-44,4932,4784,9716
MAKUENI,KIBWEZI,45,1195,1283,2478
MAKUENI,KIBWEZI,46,929,854,1783
MAKUENI,KIBWEZI,47,924,894,1818
MAKUENI,KIBWEZI,48,620,591,1211
MAKUENI,KIBWEZI,49,880,946,1826
MAKUENI,KIBWEZI,45-49,4548,4568,9116
MAKUENI,KIBWEZI,50,806,838,1644
MAKUENI,KIBWEZI,51,696,622,1318
MAKUENI,KIBWEZI,52,574,525,1099
MAKUENI,KIBWEZI,53,455,410,865
MAKUENI,KIBWEZI,54,565,532,1097
MAKUENI,KIBWEZI,50-54,3096,2927,6023
MAKUENI,KIBWEZI,55,525,517,1042
MAKUENI,KIBWEZI,56,580,644,1224
MAKUENI,KIBWEZI,57,459,577,1036
MAKUENI,KIBWEZI,58,359,396,755
MAKUENI,KIBWEZI,59,506,621,1127
MAKUENI,KIBWEZI,55-59,2429,2755,5184
MAKUENI,KIBWEZI,60,612,672,1284
MAKUENI,KIBWEZI,61,483,618,1101
MAKUENI,KIBWEZI,62,386,448,834
MAKUENI,KIBWEZI,63,413,546,959
MAKUENI,KIBWEZI,64,320,369,689
MAKUENI,KIBWEZI,60-64,2214,2653,4867
MAKUENI,KIBWEZI,65,450,595,1045
MAKUENI,KIBWEZI,66,334,335,669
MAKUENI,KIBWEZI,67,577,744,1321
MAKUENI,KIBWEZI,68,236,276,512
MAKUENI,KIBWEZI,69,350,432,782
MAKUENI,KIBWEZI,65-69,1947,2382,4329
MAKUENI,KIBWEZI,70,409,557,966
MAKUENI,KIBWEZI,71,314,378,692
MAKUENI,KIBWEZI,72,245,228,473
MAKUENI,KIBWEZI,73,234,271,505
MAKUENI,KIBWEZI,74,190,290,480
MAKUENI,KIBWEZI,70-74,1392,1724,3116
MAKUENI,KIBWEZI,75,172,184,356
MAKUENI,KIBWEZI,76,125,146,271
MAKUENI,KIBWEZI,77,176,236,412
MAKUENI,KIBWEZI,78,101,112,213
MAKUENI,KIBWEZI,79,119,220,339
MAKUENI,KIBWEZI,75-79,693,898,1591
MAKUENI,KIBWEZI,80,178,251,429
MAKUENI,KIBWEZI,81,90,109,199
MAKUENI,KIBWEZI,82,86,68,154
MAKUENI,KIBWEZI,83,105,102,207
MAKUENI,KIBWEZI,84,95,119,214
MAKUENI,KIBWEZI,80-84,554,649,1203
MAKUENI,KIBWEZI,85,65,77,142
MAKUENI,KIBWEZI,86,36,46,82
MAKUENI,KIBWEZI,87,66,83,149
MAKUENI,KIBWEZI,88,39,31,70
MAKUENI,KIBWEZI,89,58,166,224
MAKUENI,KIBWEZI,85-89,264,403,667
MAKUENI,KIBWEZI,90,36,98,134
MAKUENI,KIBWEZI,91,40,96,136
MAKUENI,KIBWEZI,92,19,39,58
MAKUENI,KIBWEZI,93,18,41,59
MAKUENI,KIBWEZI,94,14,28,42
MAKUENI,KIBWEZI,90-94,127,302,429
MAKUENI,KIBWEZI,95,39,34,73
MAKUENI,KIBWEZI,96,10,19,29
MAKUENI,KIBWEZI,97,13,17,30
MAKUENI,KIBWEZI,98,10,5,15
MAKUENI,KIBWEZI,99,21,36,57
MAKUENI,KIBWEZI,95-99,93,111,204
MAKUENI,KIBWEZI,100+,33,93,126
MAKUENI,KIBWEZI,Not Stated,-,2,2
MAKUENI,KILUNGU,Total,29019,31932,60951
MAKUENI,KILUNGU,0,527,580,1107
MAKUENI,KILUNGU,1,636,575,1211
MAKUENI,KILUNGU,2,574,579,1153
MAKUENI,KILUNGU,3,619,629,1248
MAKUENI,KILUNGU,4,693,635,1328
MAKUENI,KILUNGU,0 - 4,3049,2998,6047
MAKUENI,KILUNGU,5,703,699,1402
MAKUENI,KILUNGU,6,654,689,1343
MAKUENI,KILUNGU,7,743,694,1437
MAKUENI,KILUNGU,8,693,747,1440
MAKUENI,KILUNGU,9,803,793,1596
MAKUENI,KILUNGU,05-Sep,3596,3622,7218
MAKUENI,KILUNGU,10,840,876,1716
MAKUENI,KILUNGU,11,832,876,1708
MAKUENI,KILUNGU,12,907,956,1863
MAKUENI,KILUNGU,13,878,942,1820
MAKUENI,KILUNGU,14,914,896,1810
MAKUENI,KILUNGU,Oct-14,4371,4546,8917
MAKUENI,KILUNGU,15,889,863,1752
MAKUENI,KILUNGU,16,834,844,1678
MAKUENI,KILUNGU,17,839,842,1681
MAKUENI,KILUNGU,18,640,584,1224
MAKUENI,KILUNGU,19,666,631,1297
MAKUENI,KILUNGU,15-19,3868,3764,7632
MAKUENI,KILUNGU,20,593,533,1126
MAKUENI,KILUNGU,21,483,475,958
MAKUENI,KILUNGU,22,457,439,896
MAKUENI,KILUNGU,23,450,401,851
MAKUENI,KILUNGU,24,407,434,841
MAKUENI,KILUNGU,20-24,2390,2282,4672
MAKUENI,KILUNGU,25,384,400,784
MAKUENI,KILUNGU,26,313,389,702
MAKUENI,KILUNGU,27,306,337,643
MAKUENI,KILUNGU,28,274,279,553
MAKUENI,KILUNGU,29,329,368,697
MAKUENI,KILUNGU,25-29,1606,1773,3379
MAKUENI,KILUNGU,30,376,463,839
MAKUENI,KILUNGU,31,294,355,649
MAKUENI,KILUNGU,32,332,400,732
MAKUENI,KILUNGU,33,316,364,680
MAKUENI,KILUNGU,34,261,316,577
MAKUENI,KILUNGU,30-34,1579,1898,3477
MAKUENI,KILUNGU,35,362,445,807
MAKUENI,KILUNGU,36,278,337,615
MAKUENI,KILUNGU,37,299,322,621
MAKUENI,KILUNGU,38,226,261,487
MAKUENI,KILUNGU,39,305,328,633
MAKUENI,KILUNGU,35-39,1470,1693,3163
MAKUENI,KILUNGU,40,309,345,654
MAKUENI,KILUNGU,41,275,306,581
MAKUENI,KILUNGU,42,262,237,499
MAKUENI,KILUNGU,43,279,294,573
MAKUENI,KILUNGU,44,200,235,435
MAKUENI,KILUNGU,40-44,1325,1417,2742
MAKUENI,KILUNGU,45,296,382,678
MAKUENI,KILUNGU,46,225,307,532
MAKUENI,KILUNGU,47,227,324,551
MAKUENI,KILUNGU,48,159,223,382
MAKUENI,KILUNGU,49,214,295,509
MAKUENI,KILUNGU,45-49,1121,1531,2652
MAKUENI,KILUNGU,50,230,293,523
MAKUENI,KILUNGU,51,197,269,466
MAKUENI,KILUNGU,52,173,198,371
MAKUENI,KILUNGU,53,157,206,363
MAKUENI,KILUNGU,54,181,205,386
MAKUENI,KILUNGU,50-54,938,1171,2109
MAKUENI,KILUNGU,55,169,199,368
MAKUENI,KILUNGU,56,182,241,423
MAKUENI,KILUNGU,57,177,258,435
MAKUENI,KILUNGU,58,122,157,279
MAKUENI,KILUNGU,59,177,247,424
MAKUENI,KILUNGU,55-59,827,1102,1929
MAKUENI,KILUNGU,60,211,288,499
MAKUENI,KILUNGU,61,184,253,437
MAKUENI,KILUNGU,62,137,195,332
MAKUENI,KILUNGU,63,192,222,414
MAKUENI,KILUNGU,64,117,124,241
MAKUENI,KILUNGU,60-64,841,1082,1923
MAKUENI,KILUNGU,65,162,236,398
MAKUENI,KILUNGU,66,141,133,274
MAKUENI,KILUNGU,67,220,265,485
MAKUENI,KILUNGU,68,95,120,215
MAKUENI,KILUNGU,69,129,168,297
MAKUENI,KILUNGU,65-69,747,922,1669
MAKUENI,KILUNGU,70,159,220,379
MAKUENI,KILUNGU,71,106,166,272
MAKUENI,KILUNGU,72,96,97,193
MAKUENI,KILUNGU,73,89,118,207
MAKUENI,KILUNGU,74,69,109,178
MAKUENI,KILUNGU,70-74,519,710,1229
MAKUENI,KILUNGU,75,71,107,178
MAKUENI,KILUNGU,76,47,82,129
MAKUENI,KILUNGU,77,76,122,198
MAKUENI,KILUNGU,78,52,65,117
MAKUENI,KILUNGU,79,47,133,180
MAKUENI,KILUNGU,75-79,293,509,802
MAKUENI,KILUNGU,80,60,109,169
MAKUENI,KILUNGU,81,30,77,107
MAKUENI,KILUNGU,82,43,36,79
MAKUENI,KILUNGU,83,44,48,92
MAKUENI,KILUNGU,84,34,50,84
MAKUENI,KILUNGU,80-84,211,320,531
MAKUENI,KILUNGU,85,39,41,80
MAKUENI,KILUNGU,86,12,15,27
MAKUENI,KILUNGU,87,35,51,86
MAKUENI,KILUNGU,88,5,33,38
MAKUENI,KILUNGU,89,40,127,167
MAKUENI,KILUNGU,85-89,131,267,398
MAKUENI,KILUNGU,90,20,87,107
MAKUENI,KILUNGU,91,10,55,65
MAKUENI,KILUNGU,92,17,20,37
MAKUENI,KILUNGU,93,6,25,31
MAKUENI,KILUNGU,94,8,18,26
MAKUENI,KILUNGU,90-94,61,205,266
MAKUENI,KILUNGU,95,10,23,33
MAKUENI,KILUNGU,96,4,9,13
MAKUENI,KILUNGU,97,8,4,12
MAKUENI,KILUNGU,98,4,11,15
MAKUENI,KILUNGU,99,20,28,48
MAKUENI,KILUNGU,95-99,46,75,121
MAKUENI,KILUNGU,100+,29,44,73
MAKUENI,KILUNGU,Not Stated,1,1,2
MAKUENI,MAKINDU,Total,42204,42742,84946
MAKUENI,MAKINDU,0,814,767,1581
MAKUENI,MAKINDU,1,833,856,1689
MAKUENI,MAKINDU,2,836,876,1712
MAKUENI,MAKINDU,3,869,871,1740
MAKUENI,MAKINDU,4,960,873,1833
MAKUENI,MAKINDU,0 - 4,4312,4243,8555
MAKUENI,MAKINDU,5,992,832,1824
MAKUENI,MAKINDU,6,957,897,1854
MAKUENI,MAKINDU,7,917,857,1774
MAKUENI,MAKINDU,8,1064,927,1991
MAKUENI,MAKINDU,9,1078,1050,2128
MAKUENI,MAKINDU,05-Sep,5008,4563,9571
MAKUENI,MAKINDU,10,1100,1093,2193
MAKUENI,MAKINDU,11,1208,1235,2443
MAKUENI,MAKINDU,12,1290,1196,2486
MAKUENI,MAKINDU,13,1242,1311,2553
MAKUENI,MAKINDU,14,1198,1150,2348
MAKUENI,MAKINDU,Oct-14,6038,5985,12023
MAKUENI,MAKINDU,15,1268,1222,2490
MAKUENI,MAKINDU,16,1051,1091,2142
MAKUENI,MAKINDU,17,1166,1081,2247
MAKUENI,MAKINDU,18,919,873,1792
MAKUENI,MAKINDU,19,899,892,1791
MAKUENI,MAKINDU,15-19,5303,5159,10462
MAKUENI,MAKINDU,20,853,816,1669
MAKUENI,MAKINDU,21,713,723,1436
MAKUENI,MAKINDU,22,631,675,1306
MAKUENI,MAKINDU,23,741,740,1481
MAKUENI,MAKINDU,24,667,675,1342
MAKUENI,MAKINDU,20-24,3605,3629,7234
MAKUENI,MAKINDU,25,732,752,1484
MAKUENI,MAKINDU,26,565,675,1240
MAKUENI,MAKINDU,27,611,633,1244
MAKUENI,MAKINDU,28,462,553,1015
MAKUENI,MAKINDU,29,597,619,1216
MAKUENI,MAKINDU,25-29,2967,3232,6199
MAKUENI,MAKINDU,30,699,744,1443
MAKUENI,MAKINDU,31,529,597,1126
MAKUENI,MAKINDU,32,638,695,1333
MAKUENI,MAKINDU,33,616,674,1290
MAKUENI,MAKINDU,34,489,558,1047
MAKUENI,MAKINDU,30-34,2971,3268,6239
MAKUENI,MAKINDU,35,657,702,1359
MAKUENI,MAKINDU,36,453,516,969
MAKUENI,MAKINDU,37,528,526,1054
MAKUENI,MAKINDU,38,384,407,791
MAKUENI,MAKINDU,39,505,472,977
MAKUENI,MAKINDU,35-39,2527,2623,5150
MAKUENI,MAKINDU,40,539,508,1047
MAKUENI,MAKINDU,41,533,455,988
MAKUENI,MAKINDU,42,454,458,912
MAKUENI,MAKINDU,43,387,422,809
MAKUENI,MAKINDU,44,394,459,853
MAKUENI,MAKINDU,40-44,2307,2302,4609
MAKUENI,MAKINDU,45,557,544,1101
MAKUENI,MAKINDU,46,380,381,761
MAKUENI,MAKINDU,47,393,345,738
MAKUENI,MAKINDU,48,274,248,522
MAKUENI,MAKINDU,49,382,360,742
MAKUENI,MAKINDU,45-49,1986,1878,3864
MAKUENI,MAKINDU,50,342,356,698
MAKUENI,MAKINDU,51,277,283,560
MAKUENI,MAKINDU,52,243,205,448
MAKUENI,MAKINDU,53,196,177,373
MAKUENI,MAKINDU,54,237,226,463
MAKUENI,MAKINDU,50-54,1295,1247,2542
MAKUENI,MAKINDU,55,265,211,476
MAKUENI,MAKINDU,56,255,251,506
MAKUENI,MAKINDU,57,214,229,443
MAKUENI,MAKINDU,58,133,151,284
MAKUENI,MAKINDU,59,241,230,471
MAKUENI,MAKINDU,55-59,1108,1072,2180
MAKUENI,MAKINDU,60,243,275,518
MAKUENI,MAKINDU,61,200,238,438
MAKUENI,MAKINDU,62,179,195,374
MAKUENI,MAKINDU,63,156,181,337
MAKUENI,MAKINDU,64,123,160,283
MAKUENI,MAKINDU,60-64,901,1049,1950
MAKUENI,MAKINDU,65,185,230,415
MAKUENI,MAKINDU,66,101,128,229
MAKUENI,MAKINDU,67,220,262,482
MAKUENI,MAKINDU,68,96,107,203
MAKUENI,MAKINDU,69,125,168,293
MAKUENI,MAKINDU,65-69,727,895,1622
MAKUENI,MAKINDU,70,174,201,375
MAKUENI,MAKINDU,71,125,137,262
MAKUENI,MAKINDU,72,61,88,149
MAKUENI,MAKINDU,73,73,90,163
MAKUENI,MAKINDU,74,81,79,160
MAKUENI,MAKINDU,70-74,514,595,1109
MAKUENI,MAKINDU,75,65,75,140
MAKUENI,MAKINDU,76,27,55,82
MAKUENI,MAKINDU,77,60,90,150
MAKUENI,MAKINDU,78,45,54,99
MAKUENI,MAKINDU,79,48,101,149
MAKUENI,MAKINDU,75-79,245,375,620
MAKUENI,MAKINDU,80,66,102,168
MAKUENI,MAKINDU,81,35,48,83
MAKUENI,MAKINDU,82,36,34,70
MAKUENI,MAKINDU,83,31,42,73
MAKUENI,MAKINDU,84,28,51,79
MAKUENI,MAKINDU,80-84,196,277,473
MAKUENI,MAKINDU,85,14,34,48
MAKUENI,MAKINDU,86,15,14,29
MAKUENI,MAKINDU,87,20,25,45
MAKUENI,MAKINDU,88,11,14,25
MAKUENI,MAKINDU,89,26,51,77
MAKUENI,MAKINDU,85-89,86,138,224
MAKUENI,MAKINDU,90,20,44,64
MAKUENI,MAKINDU,91,15,37,52
MAKUENI,MAKINDU,92,13,14,27
MAKUENI,MAKINDU,93,12,13,25
MAKUENI,MAKINDU,94,8,15,23
MAKUENI,MAKINDU,90-94,68,123,191
MAKUENI,MAKINDU,95,10,19,29
MAKUENI,MAKINDU,96,2,8,10
MAKUENI,MAKINDU,97,8,8,16
MAKUENI,MAKINDU,98,4,5,9
MAKUENI,MAKINDU,99,1,12,13
MAKUENI,MAKINDU,95-99,25,52,77
MAKUENI,MAKINDU,100+,15,36,51
MAKUENI,MAKINDU,Not Stated,-,1,1
MAKUENI,MAKUENI,Total,65418,64955,130373
MAKUENI,MAKUENI,0,1154,1184,2338
MAKUENI,MAKUENI,1,1298,1302,2600
MAKUENI,MAKUENI,2,1257,1256,2513
MAKUENI,MAKUENI,3,1285,1217,2502
MAKUENI,MAKUENI,4,1326,1205,2531
MAKUENI,MAKUENI,0 - 4,6320,6164,12484
MAKUENI,MAKUENI,5,1348,1229,2577
MAKUENI,MAKUENI,6,1268,1159,2427
MAKUENI,MAKUENI,7,1306,1277,2583
MAKUENI,MAKUENI,8,1406,1366,2772
MAKUENI,MAKUENI,9,1435,1380,2815
MAKUENI,MAKUENI,05-Sep,6763,6411,13174
MAKUENI,MAKUENI,10,1514,1559,3073
MAKUENI,MAKUENI,11,1513,1546,3059
MAKUENI,MAKUENI,12,1724,1619,3343
MAKUENI,MAKUENI,13,1619,1639,3258
MAKUENI,MAKUENI,14,1638,1582,3220
MAKUENI,MAKUENI,Oct-14,8008,7945,15953
MAKUENI,MAKUENI,15,1583,1501,3084
MAKUENI,MAKUENI,16,1556,1486,3042
MAKUENI,MAKUENI,17,1615,1577,3192
MAKUENI,MAKUENI,18,1285,1180,2465
MAKUENI,MAKUENI,19,1486,1337,2823
MAKUENI,MAKUENI,15-19,7525,7081,14606
MAKUENI,MAKUENI,20,1383,1294,2677
MAKUENI,MAKUENI,21,1230,1296,2526
MAKUENI,MAKUENI,22,1128,1136,2264
MAKUENI,MAKUENI,23,1283,1279,2562
MAKUENI,MAKUENI,24,1184,1076,2260
MAKUENI,MAKUENI,20-24,6208,6081,12289
MAKUENI,MAKUENI,25,1364,1209,2573
MAKUENI,MAKUENI,26,1094,1015,2109
MAKUENI,MAKUENI,27,1079,938,2017
MAKUENI,MAKUENI,28,883,782,1665
MAKUENI,MAKUENI,29,1016,994,2010
MAKUENI,MAKUENI,25-29,5436,4938,10374
MAKUENI,MAKUENI,30,1166,1241,2407
MAKUENI,MAKUENI,31,895,809,1704
MAKUENI,MAKUENI,32,1039,1026,2065
MAKUENI,MAKUENI,33,998,986,1984
MAKUENI,MAKUENI,34,841,813,1654
MAKUENI,MAKUENI,30-34,4939,4875,9814
MAKUENI,MAKUENI,35,1105,1048,2153
MAKUENI,MAKUENI,36,800,772,1572
MAKUENI,MAKUENI,37,863,783,1646
MAKUENI,MAKUENI,38,589,596,1185
MAKUENI,MAKUENI,39,768,797,1565
MAKUENI,MAKUENI,35-39,4125,3996,8121
MAKUENI,MAKUENI,40,789,752,1541
MAKUENI,MAKUENI,41,815,728,1543
MAKUENI,MAKUENI,42,701,659,1360
MAKUENI,MAKUENI,43,611,660,1271
MAKUENI,MAKUENI,44,580,598,1178
MAKUENI,MAKUENI,40-44,3496,3397,6893
MAKUENI,MAKUENI,45,847,890,1737
MAKUENI,MAKUENI,46,600,615,1215
MAKUENI,MAKUENI,47,607,632,1239
MAKUENI,MAKUENI,48,436,407,843
MAKUENI,MAKUENI,49,628,580,1208
MAKUENI,MAKUENI,45-49,3118,3124,6242
MAKUENI,MAKUENI,50,560,584,1144
MAKUENI,MAKUENI,51,511,481,992
MAKUENI,MAKUENI,52,373,425,798
MAKUENI,MAKUENI,53,329,328,657
MAKUENI,MAKUENI,54,425,392,817
MAKUENI,MAKUENI,50-54,2198,2210,4408
MAKUENI,MAKUENI,55,467,411,878
MAKUENI,MAKUENI,56,408,426,834
MAKUENI,MAKUENI,57,365,502,867
MAKUENI,MAKUENI,58,286,331,617
MAKUENI,MAKUENI,59,431,433,864
MAKUENI,MAKUENI,55-59,1957,2103,4060
MAKUENI,MAKUENI,60,486,465,951
MAKUENI,MAKUENI,61,422,418,840
MAKUENI,MAKUENI,62,320,311,631
MAKUENI,MAKUENI,63,362,342,704
MAKUENI,MAKUENI,64,237,253,490
MAKUENI,MAKUENI,60-64,1827,1789,3616
MAKUENI,MAKUENI,65,352,380,732
MAKUENI,MAKUENI,66,208,221,429
MAKUENI,MAKUENI,67,415,440,855
MAKUENI,MAKUENI,68,150,201,351
MAKUENI,MAKUENI,69,241,313,554
MAKUENI,MAKUENI,65-69,1366,1555,2921
MAKUENI,MAKUENI,70,265,390,655
MAKUENI,MAKUENI,71,218,251,469
MAKUENI,MAKUENI,72,147,138,285
MAKUENI,MAKUENI,73,140,197,337
MAKUENI,MAKUENI,74,132,181,313
MAKUENI,MAKUENI,70-74,902,1157,2059
MAKUENI,MAKUENI,75,94,155,249
MAKUENI,MAKUENI,76,91,114,205
MAKUENI,MAKUENI,77,110,174,284
MAKUENI,MAKUENI,78,63,72,135
MAKUENI,MAKUENI,79,92,178,270
MAKUENI,MAKUENI,75-79,450,693,1143
MAKUENI,MAKUENI,80,109,210,319
MAKUENI,MAKUENI,81,73,96,169
MAKUENI,MAKUENI,82,53,66,119
MAKUENI,MAKUENI,83,81,95,176
MAKUENI,MAKUENI,84,48,91,139
MAKUENI,MAKUENI,80-84,364,558,922
MAKUENI,MAKUENI,85,33,61,94
MAKUENI,MAKUENI,86,35,44,79
MAKUENI,MAKUENI,87,38,59,97
MAKUENI,MAKUENI,88,22,24,46
MAKUENI,MAKUENI,89,37,129,166
MAKUENI,MAKUENI,85-89,165,317,482
MAKUENI,MAKUENI,90,28,102,130
MAKUENI,MAKUENI,91,45,114,159
MAKUENI,MAKUENI,92,35,71,106
MAKUENI,MAKUENI,93,16,45,61
MAKUENI,MAKUENI,94,11,42,53
MAKUENI,MAKUENI,90-94,135,374,509
MAKUENI,MAKUENI,95,27,51,78
MAKUENI,MAKUENI,96,7,22,29
MAKUENI,MAKUENI,97,18,15,33
MAKUENI,MAKUENI,98,10,12,22
MAKUENI,MAKUENI,99,13,34,47
MAKUENI,MAKUENI,95-99,75,134,209
MAKUENI,MAKUENI,100+,41,53,94
MAKUENI,MAKUENI,Not Stated,-,-,-
MAKUENI,MBOONI EAST,Total,48152,49601,97753
MAKUENI,MBOONI EAST,0,852,857,1709
MAKUENI,MBOONI EAST,1,906,914,1820
MAKUENI,MBOONI EAST,2,917,873,1790
MAKUENI,MBOONI EAST,3,1040,986,2026
MAKUENI,MBOONI EAST,4,1031,944,1975
MAKUENI,MBOONI EAST,0 - 4,4746,4574,9320
MAKUENI,MBOONI EAST,5,1037,959,1996
MAKUENI,MBOONI EAST,6,1036,1000,2036
MAKUENI,MBOONI EAST,7,1063,1039,2102
MAKUENI,MBOONI EAST,8,1185,1038,2223
MAKUENI,MBOONI EAST,9,1191,1186,2377
MAKUENI,MBOONI EAST,05-Sep,5512,5222,10734
MAKUENI,MBOONI EAST,10,1265,1155,2420
MAKUENI,MBOONI EAST,11,1341,1235,2576
MAKUENI,MBOONI EAST,12,1430,1418,2848
MAKUENI,MBOONI EAST,13,1393,1374,2767
MAKUENI,MBOONI EAST,14,1378,1238,2616
MAKUENI,MBOONI EAST,Oct-14,6807,6420,13227
MAKUENI,MBOONI EAST,15,1374,1365,2739
MAKUENI,MBOONI EAST,16,1389,1350,2739
MAKUENI,MBOONI EAST,17,1499,1302,2801
MAKUENI,MBOONI EAST,18,1161,983,2144
MAKUENI,MBOONI EAST,19,1152,945,2097
MAKUENI,MBOONI EAST,15-19,6575,5945,12520
MAKUENI,MBOONI EAST,20,1046,833,1879
MAKUENI,MBOONI EAST,21,850,685,1535
MAKUENI,MBOONI EAST,22,707,581,1288
MAKUENI,MBOONI EAST,23,720,698,1418
MAKUENI,MBOONI EAST,24,671,588,1259
MAKUENI,MBOONI EAST,20-24,3994,3385,7379
MAKUENI,MBOONI EAST,25,639,657,1296
MAKUENI,MBOONI EAST,26,555,588,1143
MAKUENI,MBOONI EAST,27,638,587,1225
MAKUENI,MBOONI EAST,28,497,552,1049
MAKUENI,MBOONI EAST,29,595,605,1200
MAKUENI,MBOONI EAST,25-29,2924,2989,5913
MAKUENI,MBOONI EAST,30,664,797,1461
MAKUENI,MBOONI EAST,31,536,562,1098
MAKUENI,MBOONI EAST,32,610,722,1332
MAKUENI,MBOONI EAST,33,597,708,1305
MAKUENI,MBOONI EAST,34,450,549,999
MAKUENI,MBOONI EAST,30-34,2857,3338,6195
MAKUENI,MBOONI EAST,35,716,778,1494
MAKUENI,MBOONI EAST,36,523,520,1043
MAKUENI,MBOONI EAST,37,586,535,1121
MAKUENI,MBOONI EAST,38,361,434,795
MAKUENI,MBOONI EAST,39,560,536,1096
MAKUENI,MBOONI EAST,35-39,2746,2803,5549
MAKUENI,MBOONI EAST,40,567,575,1142
MAKUENI,MBOONI EAST,41,553,561,1114
MAKUENI,MBOONI EAST,42,421,511,932
MAKUENI,MBOONI EAST,43,418,537,955
MAKUENI,MBOONI EAST,44,391,473,864
MAKUENI,MBOONI EAST,40-44,2350,2657,5007
MAKUENI,MBOONI EAST,45,586,722,1308
MAKUENI,MBOONI EAST,46,416,517,933
MAKUENI,MBOONI EAST,47,442,517,959
MAKUENI,MBOONI EAST,48,343,342,685
MAKUENI,MBOONI EAST,49,460,524,984
MAKUENI,MBOONI EAST,45-49,2247,2622,4869
MAKUENI,MBOONI EAST,50,412,495,907
MAKUENI,MBOONI EAST,51,371,392,763
MAKUENI,MBOONI EAST,52,249,316,565
MAKUENI,MBOONI EAST,53,219,283,502
MAKUENI,MBOONI EAST,54,324,317,641
MAKUENI,MBOONI EAST,50-54,1575,1803,3378
MAKUENI,MBOONI EAST,55,293,343,636
MAKUENI,MBOONI EAST,56,281,379,660
MAKUENI,MBOONI EAST,57,321,389,710
MAKUENI,MBOONI EAST,58,240,237,477
MAKUENI,MBOONI EAST,59,292,348,640
MAKUENI,MBOONI EAST,55-59,1427,1696,3123
MAKUENI,MBOONI EAST,60,341,432,773
MAKUENI,MBOONI EAST,61,321,339,660
MAKUENI,MBOONI EAST,62,231,263,494
MAKUENI,MBOONI EAST,63,246,282,528
MAKUENI,MBOONI EAST,64,199,217,416
MAKUENI,MBOONI EAST,60-64,1338,1533,2871
MAKUENI,MBOONI EAST,65,248,360,608
MAKUENI,MBOONI EAST,66,184,192,376
MAKUENI,MBOONI EAST,67,284,373,657
MAKUENI,MBOONI EAST,68,124,212,336
MAKUENI,MBOONI EAST,69,207,291,498
MAKUENI,MBOONI EAST,65-69,1047,1428,2475
MAKUENI,MBOONI EAST,70,231,330,561
MAKUENI,MBOONI EAST,71,196,226,422
MAKUENI,MBOONI EAST,72,152,138,290
MAKUENI,MBOONI EAST,73,147,164,311
MAKUENI,MBOONI EAST,74,105,201,306
MAKUENI,MBOONI EAST,70-74,831,1059,1890
MAKUENI,MBOONI EAST,75,76,230,306
MAKUENI,MBOONI EAST,76,63,83,146
MAKUENI,MBOONI EAST,77,96,145,241
MAKUENI,MBOONI EAST,78,67,73,140
MAKUENI,MBOONI EAST,79,90,203,293
MAKUENI,MBOONI EAST,75-79,392,734,1126
MAKUENI,MBOONI EAST,80,108,190,298
MAKUENI,MBOONI EAST,81,83,108,191
MAKUENI,MBOONI EAST,82,48,65,113
MAKUENI,MBOONI EAST,83,47,88,135
MAKUENI,MBOONI EAST,84,41,96,137
MAKUENI,MBOONI EAST,80-84,327,547,874
MAKUENI,MBOONI EAST,85,57,69,126
MAKUENI,MBOONI EAST,86,33,48,81
MAKUENI,MBOONI EAST,87,45,93,138
MAKUENI,MBOONI EAST,88,17,23,40
MAKUENI,MBOONI EAST,89,52,124,176
MAKUENI,MBOONI EAST,85-89,204,357,561
MAKUENI,MBOONI EAST,90,46,93,139
MAKUENI,MBOONI EAST,91,40,115,155
MAKUENI,MBOONI EAST,92,22,52,74
MAKUENI,MBOONI EAST,93,16,43,59
MAKUENI,MBOONI EAST,94,18,24,42
MAKUENI,MBOONI EAST,90-94,142,327,469
MAKUENI,MBOONI EAST,95,26,49,75
MAKUENI,MBOONI EAST,96,14,6,20
MAKUENI,MBOONI EAST,97,21,9,30
MAKUENI,MBOONI EAST,98,8,15,23
MAKUENI,MBOONI EAST,99,16,26,42
MAKUENI,MBOONI EAST,95-99,85,105,190
MAKUENI,MBOONI EAST,100+,25,57,82
MAKUENI,MBOONI EAST,Not Stated,1,-,1
MAKUENI,MBOONI WEST,Total,49434,53159,102593
MAKUENI,MBOONI WEST,0,874,892,1766
MAKUENI,MBOONI WEST,1,993,1052,2045
MAKUENI,MBOONI WEST,2,1006,1020,2026
MAKUENI,MBOONI WEST,3,1104,1030,2134
MAKUENI,MBOONI WEST,4,1064,1048,2112
MAKUENI,MBOONI WEST,0 - 4,5041,5042,10083
MAKUENI,MBOONI WEST,5,1084,1112,2196
MAKUENI,MBOONI WEST,6,1166,1081,2247
MAKUENI,MBOONI WEST,7,1163,1156,2319
MAKUENI,MBOONI WEST,8,1278,1221,2499
MAKUENI,MBOONI WEST,9,1371,1322,2693
MAKUENI,MBOONI WEST,05-Sep,6062,5892,11954
MAKUENI,MBOONI WEST,10,1467,1386,2853
MAKUENI,MBOONI WEST,11,1375,1397,2772
MAKUENI,MBOONI WEST,12,1621,1479,3100
MAKUENI,MBOONI WEST,13,1493,1470,2963
MAKUENI,MBOONI WEST,14,1486,1483,2969
MAKUENI,MBOONI WEST,Oct-14,7442,7215,14657
MAKUENI,MBOONI WEST,15,1565,1440,3005
MAKUENI,MBOONI WEST,16,1398,1381,2779
MAKUENI,MBOONI WEST,17,1460,1363,2823
MAKUENI,MBOONI WEST,18,1123,993,2116
MAKUENI,MBOONI WEST,19,1139,975,2114
MAKUENI,MBOONI WEST,15-19,6685,6152,12837
MAKUENI,MBOONI WEST,20,995,862,1857
MAKUENI,MBOONI WEST,21,830,748,1578
MAKUENI,MBOONI WEST,22,755,692,1447
MAKUENI,MBOONI WEST,23,714,740,1454
MAKUENI,MBOONI WEST,24,647,670,1317
MAKUENI,MBOONI WEST,20-24,3941,3712,7653
MAKUENI,MBOONI WEST,25,626,673,1299
MAKUENI,MBOONI WEST,26,540,618,1158
MAKUENI,MBOONI WEST,27,569,614,1183
MAKUENI,MBOONI WEST,28,465,557,1022
MAKUENI,MBOONI WEST,29,566,692,1258
MAKUENI,MBOONI WEST,25-29,2766,3154,5920
MAKUENI,MBOONI WEST,30,634,866,1500
MAKUENI,MBOONI WEST,31,519,637,1156
MAKUENI,MBOONI WEST,32,612,717,1329
MAKUENI,MBOONI WEST,33,546,732,1278
MAKUENI,MBOONI WEST,34,492,621,1113
MAKUENI,MBOONI WEST,30-34,2803,3573,6376
MAKUENI,MBOONI WEST,35,676,763,1439
MAKUENI,MBOONI WEST,36,483,538,1021
MAKUENI,MBOONI WEST,37,535,577,1112
MAKUENI,MBOONI WEST,38,354,411,765
MAKUENI,MBOONI WEST,39,529,570,1099
MAKUENI,MBOONI WEST,35-39,2577,2859,5436
MAKUENI,MBOONI WEST,40,549,603,1152
MAKUENI,MBOONI WEST,41,514,558,1072
MAKUENI,MBOONI WEST,42,438,440,878
MAKUENI,MBOONI WEST,43,389,478,867
MAKUENI,MBOONI WEST,44,364,432,796
MAKUENI,MBOONI WEST,40-44,2254,2511,4765
MAKUENI,MBOONI WEST,45,537,641,1178
MAKUENI,MBOONI WEST,46,464,616,1080
MAKUENI,MBOONI WEST,47,401,586,987
MAKUENI,MBOONI WEST,48,311,458,769
MAKUENI,MBOONI WEST,49,416,549,965
MAKUENI,MBOONI WEST,45-49,2129,2850,4979
MAKUENI,MBOONI WEST,50,369,427,796
MAKUENI,MBOONI WEST,51,363,369,732
MAKUENI,MBOONI WEST,52,245,296,541
MAKUENI,MBOONI WEST,53,203,245,448
MAKUENI,MBOONI WEST,54,311,366,677
MAKUENI,MBOONI WEST,50-54,1491,1703,3194
MAKUENI,MBOONI WEST,55,293,320,613
MAKUENI,MBOONI WEST,56,326,391,717
MAKUENI,MBOONI WEST,57,342,461,803
MAKUENI,MBOONI WEST,58,216,320,536
MAKUENI,MBOONI WEST,59,364,473,837
MAKUENI,MBOONI WEST,55-59,1541,1965,3506
MAKUENI,MBOONI WEST,60,394,512,906
MAKUENI,MBOONI WEST,61,356,415,771
MAKUENI,MBOONI WEST,62,250,301,551
MAKUENI,MBOONI WEST,63,269,386,655
MAKUENI,MBOONI WEST,64,181,239,420
MAKUENI,MBOONI WEST,60-64,1450,1853,3303
MAKUENI,MBOONI WEST,65,303,382,685
MAKUENI,MBOONI WEST,66,184,215,399
MAKUENI,MBOONI WEST,67,352,452,804
MAKUENI,MBOONI WEST,68,134,159,293
MAKUENI,MBOONI WEST,69,239,312,551
MAKUENI,MBOONI WEST,65-69,1212,1520,2732
MAKUENI,MBOONI WEST,70,257,384,641
MAKUENI,MBOONI WEST,71,213,281,494
MAKUENI,MBOONI WEST,72,153,148,301
MAKUENI,MBOONI WEST,73,136,182,318
MAKUENI,MBOONI WEST,74,137,201,338
MAKUENI,MBOONI WEST,70-74,896,1196,2092
MAKUENI,MBOONI WEST,75,82,154,236
MAKUENI,MBOONI WEST,76,66,112,178
MAKUENI,MBOONI WEST,77,102,156,258
MAKUENI,MBOONI WEST,78,71,79,150
MAKUENI,MBOONI WEST,79,79,196,275
MAKUENI,MBOONI WEST,75-79,400,697,1097
MAKUENI,MBOONI WEST,80,101,201,302
MAKUENI,MBOONI WEST,81,71,131,202
MAKUENI,MBOONI WEST,82,39,84,123
MAKUENI,MBOONI WEST,83,78,85,163
MAKUENI,MBOONI WEST,84,50,90,140
MAKUENI,MBOONI WEST,80-84,339,591,930
MAKUENI,MBOONI WEST,85,36,69,105
MAKUENI,MBOONI WEST,86,31,33,64
MAKUENI,MBOONI WEST,87,41,65,106
MAKUENI,MBOONI WEST,88,24,19,43
MAKUENI,MBOONI WEST,89,44,109,153
MAKUENI,MBOONI WEST,85-89,176,295,471
MAKUENI,MBOONI WEST,90,35,80,115
MAKUENI,MBOONI WEST,91,28,61,89
MAKUENI,MBOONI WEST,92,26,38,64
MAKUENI,MBOONI WEST,93,12,24,36
MAKUENI,MBOONI WEST,94,10,24,34
MAKUENI,MBOONI WEST,90-94,111,227,338
MAKUENI,MBOONI WEST,95,23,25,48
MAKUENI,MBOONI WEST,96,13,11,24
MAKUENI,MBOONI WEST,97,15,19,34
MAKUENI,MBOONI WEST,98,12,11,23
MAKUENI,MBOONI WEST,99,14,32,46
MAKUENI,MBOONI WEST,95-99,77,98,175
MAKUENI,MBOONI WEST,100+,41,54,95
MAKUENI,MBOONI WEST,Not Stated,-,-,-
MAKUENI,MUKAA,Total,54481,53068,107549
MAKUENI,MUKAA,0,971,981,1952
MAKUENI,MUKAA,1,1039,1026,2065
MAKUENI,MUKAA,2,1031,1076,2107
MAKUENI,MUKAA,3,1036,1032,2068
MAKUENI,MUKAA,4,1059,1062,2121
MAKUENI,MUKAA,0 - 4,5136,5177,10313
MAKUENI,MUKAA,5,1142,1073,2215
MAKUENI,MUKAA,6,1103,1140,2243
MAKUENI,MUKAA,7,1223,1148,2371
MAKUENI,MUKAA,8,1158,1268,2426
MAKUENI,MUKAA,9,1338,1273,2611
MAKUENI,MUKAA,05-Sep,5964,5902,11866
MAKUENI,MUKAA,10,1346,1252,2598
MAKUENI,MUKAA,11,1280,1408,2688
MAKUENI,MUKAA,12,1460,1362,2822
MAKUENI,MUKAA,13,1434,1352,2786
MAKUENI,MUKAA,14,1378,1342,2720
MAKUENI,MUKAA,Oct-14,6898,6716,13614
MAKUENI,MUKAA,15,1322,1329,2651
MAKUENI,MUKAA,16,1299,1281,2580
MAKUENI,MUKAA,17,1437,1260,2697
MAKUENI,MUKAA,18,1058,965,2023
MAKUENI,MUKAA,19,1244,946,2190
MAKUENI,MUKAA,15-19,6360,5781,12141
MAKUENI,MUKAA,20,1103,901,2004
MAKUENI,MUKAA,21,990,869,1859
MAKUENI,MUKAA,22,854,742,1596
MAKUENI,MUKAA,23,916,851,1767
MAKUENI,MUKAA,24,877,732,1609
MAKUENI,MUKAA,20-24,4740,4095,8835
MAKUENI,MUKAA,25,910,792,1702
MAKUENI,MUKAA,26,768,742,1510
MAKUENI,MUKAA,27,786,690,1476
MAKUENI,MUKAA,28,680,665,1345
MAKUENI,MUKAA,29,800,779,1579
MAKUENI,MUKAA,25-29,3944,3668,7612
MAKUENI,MUKAA,30,916,906,1822
MAKUENI,MUKAA,31,680,649,1329
MAKUENI,MUKAA,32,825,801,1626
MAKUENI,MUKAA,33,790,713,1503
MAKUENI,MUKAA,34,674,662,1336
MAKUENI,MUKAA,30-34,3885,3731,7616
MAKUENI,MUKAA,35,887,844,1731
MAKUENI,MUKAA,36,628,568,1196
MAKUENI,MUKAA,37,656,579,1235
MAKUENI,MUKAA,38,493,472,965
MAKUENI,MUKAA,39,610,619,1229
MAKUENI,MUKAA,35-39,3274,3082,6356
MAKUENI,MUKAA,40,658,613,1271
MAKUENI,MUKAA,41,620,555,1175
MAKUENI,MUKAA,42,593,491,1084
MAKUENI,MUKAA,43,498,527,1025
MAKUENI,MUKAA,44,509,433,942
MAKUENI,MUKAA,40-44,2878,2619,5497
MAKUENI,MUKAA,45,720,670,1390
MAKUENI,MUKAA,46,504,527,1031
MAKUENI,MUKAA,47,568,540,1108
MAKUENI,MUKAA,48,365,401,766
MAKUENI,MUKAA,49,495,609,1104
MAKUENI,MUKAA,45-49,2652,2747,5399
MAKUENI,MUKAA,50,554,503,1057
MAKUENI,MUKAA,51,417,451,868
MAKUENI,MUKAA,52,389,350,739
MAKUENI,MUKAA,53,338,305,643
MAKUENI,MUKAA,54,429,312,741
MAKUENI,MUKAA,50-54,2127,1921,4048
MAKUENI,MUKAA,55,398,365,763
MAKUENI,MUKAA,56,407,419,826
MAKUENI,MUKAA,57,335,392,727
MAKUENI,MUKAA,58,263,238,501
MAKUENI,MUKAA,59,362,360,722
MAKUENI,MUKAA,55-59,1765,1774,3539
MAKUENI,MUKAA,60,383,416,799
MAKUENI,MUKAA,61,330,338,668
MAKUENI,MUKAA,62,290,278,568
MAKUENI,MUKAA,63,324,296,620
MAKUENI,MUKAA,64,215,209,424
MAKUENI,MUKAA,60-64,1542,1537,3079
MAKUENI,MUKAA,65,332,365,697
MAKUENI,MUKAA,66,194,213,407
MAKUENI,MUKAA,67,328,368,696
MAKUENI,MUKAA,68,134,150,284
MAKUENI,MUKAA,69,248,254,502
MAKUENI,MUKAA,65-69,1236,1350,2586
MAKUENI,MUKAA,70,264,332,596
MAKUENI,MUKAA,71,199,240,439
MAKUENI,MUKAA,72,149,145,294
MAKUENI,MUKAA,73,132,154,286
MAKUENI,MUKAA,74,133,185,318
MAKUENI,MUKAA,70-74,877,1056,1933
MAKUENI,MUKAA,75,109,125,234
MAKUENI,MUKAA,76,76,96,172
MAKUENI,MUKAA,77,112,170,282
MAKUENI,MUKAA,78,58,82,140
MAKUENI,MUKAA,79,77,179,256
MAKUENI,MUKAA,75-79,432,652,1084
MAKUENI,MUKAA,80,94,170,264
MAKUENI,MUKAA,81,53,73,126
MAKUENI,MUKAA,82,64,66,130
MAKUENI,MUKAA,83,69,95,164
MAKUENI,MUKAA,84,55,115,170
MAKUENI,MUKAA,80-84,335,519,854
MAKUENI,MUKAA,85,43,70,113
MAKUENI,MUKAA,86,26,21,47
MAKUENI,MUKAA,87,36,62,98
MAKUENI,MUKAA,88,26,24,50
MAKUENI,MUKAA,89,58,146,204
MAKUENI,MUKAA,85-89,189,323,512
MAKUENI,MUKAA,90,40,97,137
MAKUENI,MUKAA,91,39,78,117
MAKUENI,MUKAA,92,19,22,41
MAKUENI,MUKAA,93,10,32,42
MAKUENI,MUKAA,94,18,31,49
MAKUENI,MUKAA,90-94,126,260,386
MAKUENI,MUKAA,95,25,31,56
MAKUENI,MUKAA,96,9,8,17
MAKUENI,MUKAA,97,10,13,23
MAKUENI,MUKAA,98,10,9,19
MAKUENI,MUKAA,99,20,33,53
MAKUENI,MUKAA,95-99,74,94,168
MAKUENI,MUKAA,100+,46,64,110
MAKUENI,MUKAA,Not Stated,1,-,1
MAKUENI,NZAUI,Total,63171,63526,126697
MAKUENI,NZAUI,0,1164,1122,2286
MAKUENI,NZAUI,1,1260,1180,2440
MAKUENI,NZAUI,2,1221,1203,2424
MAKUENI,NZAUI,3,1297,1261,2558
MAKUENI,NZAUI,4,1294,1311,2605
MAKUENI,NZAUI,0 - 4,6236,6077,12313
MAKUENI,NZAUI,5,1376,1339,2715
MAKUENI,NZAUI,6,1366,1313,2679
MAKUENI,NZAUI,7,1367,1405,2772
MAKUENI,NZAUI,8,1450,1429,2879
MAKUENI,NZAUI,9,1609,1590,3199
MAKUENI,NZAUI,05-Sep,7168,7076,14244
MAKUENI,NZAUI,10,1692,1738,3430
MAKUENI,NZAUI,11,1725,1721,3446
MAKUENI,NZAUI,12,1822,1822,3644
MAKUENI,NZAUI,13,1836,1857,3693
MAKUENI,NZAUI,14,1763,1702,3465
MAKUENI,NZAUI,Oct-14,8838,8840,17678
MAKUENI,NZAUI,15,1850,1752,3602
MAKUENI,NZAUI,16,1790,1673,3463
MAKUENI,NZAUI,17,1815,1610,3425
MAKUENI,NZAUI,18,1420,1211,2631
MAKUENI,NZAUI,19,1559,1263,2822
MAKUENI,NZAUI,15-19,8434,7509,15943
MAKUENI,NZAUI,20,1311,1160,2471
MAKUENI,NZAUI,21,1212,980,2192
MAKUENI,NZAUI,22,988,848,1836
MAKUENI,NZAUI,23,985,995,1980
MAKUENI,NZAUI,24,953,905,1858
MAKUENI,NZAUI,20-24,5449,4888,10337
MAKUENI,NZAUI,25,1045,960,2005
MAKUENI,NZAUI,26,838,905,1743
MAKUENI,NZAUI,27,883,879,1762
MAKUENI,NZAUI,28,741,690,1431
MAKUENI,NZAUI,29,854,900,1754
MAKUENI,NZAUI,25-29,4361,4334,8695
MAKUENI,NZAUI,30,992,1030,2022
MAKUENI,NZAUI,31,762,796,1558
MAKUENI,NZAUI,32,853,946,1799
MAKUENI,NZAUI,33,817,845,1662
MAKUENI,NZAUI,34,680,721,1401
MAKUENI,NZAUI,30-34,4104,4338,8442
MAKUENI,NZAUI,35,965,924,1889
MAKUENI,NZAUI,36,699,734,1433
MAKUENI,NZAUI,37,784,762,1546
MAKUENI,NZAUI,38,562,580,1142
MAKUENI,NZAUI,39,752,773,1525
MAKUENI,NZAUI,35-39,3762,3773,7535
MAKUENI,NZAUI,40,736,713,1449
MAKUENI,NZAUI,41,802,700,1502
MAKUENI,NZAUI,42,671,608,1279
MAKUENI,NZAUI,43,645,682,1327
MAKUENI,NZAUI,44,552,677,1229
MAKUENI,NZAUI,40-44,3406,3380,6786
MAKUENI,NZAUI,45,814,878,1692
MAKUENI,NZAUI,46,522,552,1074
MAKUENI,NZAUI,47,588,625,1213
MAKUENI,NZAUI,48,402,361,763
MAKUENI,NZAUI,49,548,553,1101
MAKUENI,NZAUI,45-49,2874,2969,5843
MAKUENI,NZAUI,50,513,539,1052
MAKUENI,NZAUI,51,467,501,968
MAKUENI,NZAUI,52,389,370,759
MAKUENI,NZAUI,53,332,324,656
MAKUENI,NZAUI,54,374,328,702
MAKUENI,NZAUI,50-54,2075,2062,4137
MAKUENI,NZAUI,55,357,336,693
MAKUENI,NZAUI,56,288,355,643
MAKUENI,NZAUI,57,368,430,798
MAKUENI,NZAUI,58,269,283,552
MAKUENI,NZAUI,59,385,422,807
MAKUENI,NZAUI,55-59,1667,1826,3493
MAKUENI,NZAUI,60,399,481,880
MAKUENI,NZAUI,61,364,353,717
MAKUENI,NZAUI,62,279,312,591
MAKUENI,NZAUI,63,308,335,643
MAKUENI,NZAUI,64,209,202,411
MAKUENI,NZAUI,60-64,1559,1683,3242
MAKUENI,NZAUI,65,332,389,721
MAKUENI,NZAUI,66,181,207,388
MAKUENI,NZAUI,67,353,472,825
MAKUENI,NZAUI,68,128,188,316
MAKUENI,NZAUI,69,236,322,558
MAKUENI,NZAUI,65-69,1230,1578,2808
MAKUENI,NZAUI,70,267,356,623
MAKUENI,NZAUI,71,191,250,441
MAKUENI,NZAUI,72,147,138,285
MAKUENI,NZAUI,73,129,166,295
MAKUENI,NZAUI,74,139,242,381
MAKUENI,NZAUI,70-74,873,1152,2025
MAKUENI,NZAUI,75,90,128,218
MAKUENI,NZAUI,76,67,92,159
MAKUENI,NZAUI,77,90,132,222
MAKUENI,NZAUI,78,58,66,124
MAKUENI,NZAUI,79,72,194,266
MAKUENI,NZAUI,75-79,377,612,989
MAKUENI,NZAUI,80,102,230,332
MAKUENI,NZAUI,81,55,86,141
MAKUENI,NZAUI,82,52,51,103
MAKUENI,NZAUI,83,70,81,151
MAKUENI,NZAUI,84,62,124,186
MAKUENI,NZAUI,80-84,341,572,913
MAKUENI,NZAUI,85,38,57,95
MAKUENI,NZAUI,86,36,34,70
MAKUENI,NZAUI,87,33,67,100
MAKUENI,NZAUI,88,18,30,48
MAKUENI,NZAUI,89,47,147,194
MAKUENI,NZAUI,85-89,172,335,507
MAKUENI,NZAUI,90,34,94,128
MAKUENI,NZAUI,91,31,119,150
MAKUENI,NZAUI,92,34,40,74
MAKUENI,NZAUI,93,10,30,40
MAKUENI,NZAUI,94,16,37,53
MAKUENI,NZAUI,90-94,125,320,445
MAKUENI,NZAUI,95,22,31,53
MAKUENI,NZAUI,96,8,9,17
MAKUENI,NZAUI,97,9,10,19
MAKUENI,NZAUI,98,11,17,28
MAKUENI,NZAUI,99,25,49,74
MAKUENI,NZAUI,95-99,75,116,191
MAKUENI,NZAUI,100+,44,86,130
MAKUENI,NZAUI,Not Stated,1,-,1
MANDERA,ALL,Total,434976,432444,867420
MANDERA,ALL,0,8259,10068,18327
MANDERA,ALL,1,11893,13754,25647
MANDERA,ALL,2,20027,23132,43159
MANDERA,ALL,3,14134,16702,30836
MANDERA,ALL,4,20216,22906,43122
MANDERA,ALL,0 - 4,74529,86562,161091
MANDERA,ALL,5,13958,15754,29712
MANDERA,ALL,6,20270,22743,43013
MANDERA,ALL,7,12281,13635,25916
MANDERA,ALL,8,20671,21879,42550
MANDERA,ALL,9,11405,12563,23968
MANDERA,ALL,05-Sep,78585,86574,165159
MANDERA,ALL,10,22291,22264,44555
MANDERA,ALL,11,9700,11190,20890
MANDERA,ALL,12,19210,15366,34576
MANDERA,ALL,13,11764,9776,21540
MANDERA,ALL,14,15660,12252,27912
MANDERA,ALL,Oct-14,78625,70848,149473
MANDERA,ALL,15,14630,11264,25894
MANDERA,ALL,16,14035,11332,25367
MANDERA,ALL,17,11257,9535,20792
MANDERA,ALL,18,12959,11411,24370
MANDERA,ALL,19,6034,5887,11921
MANDERA,ALL,15-19,58915,49429,108344
MANDERA,ALL,20,13722,12952,26674
MANDERA,ALL,21,5008,5049,10057
MANDERA,ALL,22,6873,7964,14837
MANDERA,ALL,23,5166,5417,10583
MANDERA,ALL,24,5112,5420,10532
MANDERA,ALL,20-24,35881,36802,72683
MANDERA,ALL,25,8519,8791,17310
MANDERA,ALL,26,4822,5106,9928
MANDERA,ALL,27,4276,4662,8938
MANDERA,ALL,28,5302,6173,11475
MANDERA,ALL,29,3516,3742,7258
MANDERA,ALL,25-29,26435,28474,54909
MANDERA,ALL,30,10118,9920,20038
MANDERA,ALL,31,2693,3209,5902
MANDERA,ALL,32,4344,4543,8887
MANDERA,ALL,33,2555,2864,5419
MANDERA,ALL,34,2353,2209,4562
MANDERA,ALL,30-34,22063,22745,44808
MANDERA,ALL,35,5085,5213,10298
MANDERA,ALL,36,2139,2607,4746
MANDERA,ALL,37,1848,2066,3914
MANDERA,ALL,38,2728,3160,5888
MANDERA,ALL,39,1953,2123,4076
MANDERA,ALL,35-39,13753,15169,28922
MANDERA,ALL,40,7343,6053,13396
MANDERA,ALL,41,2246,2364,4610
MANDERA,ALL,42,2347,1967,4314
MANDERA,ALL,43,1498,1262,2760
MANDERA,ALL,44,1053,799,1852
MANDERA,ALL,40-44,14487,12445,26932
MANDERA,ALL,45,3547,2739,6286
MANDERA,ALL,46,1177,941,2118
MANDERA,ALL,47,1190,992,2182
MANDERA,ALL,48,1321,1027,2348
MANDERA,ALL,49,1006,803,1809
MANDERA,ALL,45-49,8241,6502,14743
MANDERA,ALL,50,3675,2481,6156
MANDERA,ALL,51,731,632,1363
MANDERA,ALL,52,1234,832,2066
MANDERA,ALL,53,733,618,1351
MANDERA,ALL,54,914,644,1558
MANDERA,ALL,50-54,7287,5207,12494
MANDERA,ALL,55,1337,879,2216
MANDERA,ALL,56,827,595,1422
MANDERA,ALL,57,610,530,1140
MANDERA,ALL,58,708,580,1288
MANDERA,ALL,59,723,613,1336
MANDERA,ALL,55-59,4205,3197,7402
MANDERA,ALL,60,2451,1679,4130
MANDERA,ALL,61,547,542,1089
MANDERA,ALL,62,692,354,1046
MANDERA,ALL,63,511,354,865
MANDERA,ALL,64,458,254,712
MANDERA,ALL,60-64,4659,3183,7842
MANDERA,ALL,65,808,564,1372
MANDERA,ALL,66,304,258,562
MANDERA,ALL,67,408,249,657
MANDERA,ALL,68,304,221,525
MANDERA,ALL,69,442,234,676
MANDERA,ALL,65-69,2266,1526,3792
MANDERA,ALL,70,1312,1082,2394
MANDERA,ALL,71,257,331,588
MANDERA,ALL,72,334,187,521
MANDERA,ALL,73,157,90,247
MANDERA,ALL,74,186,99,285
MANDERA,ALL,70-74,2246,1789,4035
MANDERA,ALL,75,319,206,525
MANDERA,ALL,76,157,103,260
MANDERA,ALL,77,146,87,233
MANDERA,ALL,78,189,98,287
MANDERA,ALL,79,178,91,269
MANDERA,ALL,75-79,989,585,1574
MANDERA,ALL,80,601,547,1148
MANDERA,ALL,81,151,171,322
MANDERA,ALL,82,160,63,223
MANDERA,ALL,83,71,38,109
MANDERA,ALL,84,82,44,126
MANDERA,ALL,80-84,1065,863,1928
MANDERA,ALL,85,134,64,198
MANDERA,ALL,86,62,47,109
MANDERA,ALL,87,72,28,100
MANDERA,ALL,88,54,23,77
MANDERA,ALL,89,64,44,108
MANDERA,ALL,85-89,386,206,592
MANDERA,ALL,90,145,166,311
MANDERA,ALL,91,36,53,89
MANDERA,ALL,92,42,22,64
MANDERA,ALL,93,18,8,26
MANDERA,ALL,94,20,9,29
MANDERA,ALL,90-94,261,258,519
MANDERA,ALL,95,24,18,42
MANDERA,ALL,96,9,7,16
MANDERA,ALL,97,6,8,14
MANDERA,ALL,98,8,6,14
MANDERA,ALL,99,13,2,15
MANDERA,ALL,95-99,60,41,101
MANDERA,ALL,100+,35,39,74
MANDERA,ALL,Not Stated,3,-,3
MANDERA,MANDERA WEST,Total,48166,50130,98296
MANDERA,MANDERA WEST,0,1090,1333,2423
MANDERA,MANDERA WEST,1,1534,1683,3217
MANDERA,MANDERA WEST,2,2655,2985,5640
MANDERA,MANDERA WEST,3,1731,2006,3737
MANDERA,MANDERA WEST,4,2695,3134,5829
MANDERA,MANDERA WEST,0 - 4,9705,11141,20846
MANDERA,MANDERA WEST,5,1606,1883,3489
MANDERA,MANDERA WEST,6,2657,3112,5769
MANDERA,MANDERA WEST,7,1411,1472,2883
MANDERA,MANDERA WEST,8,2740,2862,5602
MANDERA,MANDERA WEST,9,1170,1332,2502
MANDERA,MANDERA WEST,05-Sep,9584,10661,20245
MANDERA,MANDERA WEST,10,2610,2728,5338
MANDERA,MANDERA WEST,11,947,1127,2074
MANDERA,MANDERA WEST,12,2197,1944,4141
MANDERA,MANDERA WEST,13,1145,1070,2215
MANDERA,MANDERA WEST,14,1736,1438,3174
MANDERA,MANDERA WEST,Oct-14,8635,8307,16942
MANDERA,MANDERA WEST,15,1371,1131,2502
MANDERA,MANDERA WEST,16,1492,1269,2761
MANDERA,MANDERA WEST,17,977,851,1828
MANDERA,MANDERA WEST,18,1335,1234,2569
MANDERA,MANDERA WEST,19,528,573,1101
MANDERA,MANDERA WEST,15-19,5703,5058,10761
MANDERA,MANDERA WEST,20,1300,1469,2769
MANDERA,MANDERA WEST,21,459,539,998
MANDERA,MANDERA WEST,22,721,974,1695
MANDERA,MANDERA WEST,23,445,578,1023
MANDERA,MANDERA WEST,24,472,632,1104
MANDERA,MANDERA WEST,20-24,3397,4192,7589
MANDERA,MANDERA WEST,25,825,1064,1889
MANDERA,MANDERA WEST,26,452,592,1044
MANDERA,MANDERA WEST,27,397,553,950
MANDERA,MANDERA WEST,28,593,709,1302
MANDERA,MANDERA WEST,29,318,363,681
MANDERA,MANDERA WEST,25-29,2585,3281,5866
MANDERA,MANDERA WEST,30,1096,1129,2225
MANDERA,MANDERA WEST,31,315,368,683
MANDERA,MANDERA WEST,32,460,458,918
MANDERA,MANDERA WEST,33,277,316,593
MANDERA,MANDERA WEST,34,281,257,538
MANDERA,MANDERA WEST,30-34,2429,2528,4957
MANDERA,MANDERA WEST,35,546,551,1097
MANDERA,MANDERA WEST,36,237,279,516
MANDERA,MANDERA WEST,37,158,214,372
MANDERA,MANDERA WEST,38,284,351,635
MANDERA,MANDERA WEST,39,160,179,339
MANDERA,MANDERA WEST,35-39,1385,1574,2959
MANDERA,MANDERA WEST,40,781,608,1389
MANDERA,MANDERA WEST,41,205,180,385
MANDERA,MANDERA WEST,42,269,215,484
MANDERA,MANDERA WEST,43,129,102,231
MANDERA,MANDERA WEST,44,92,86,178
MANDERA,MANDERA WEST,40-44,1476,1191,2667
MANDERA,MANDERA WEST,45,381,289,670
MANDERA,MANDERA WEST,46,109,98,207
MANDERA,MANDERA WEST,47,117,80,197
MANDERA,MANDERA WEST,48,113,103,216
MANDERA,MANDERA WEST,49,74,70,144
MANDERA,MANDERA WEST,45-49,794,640,1434
MANDERA,MANDERA WEST,50,388,238,626
MANDERA,MANDERA WEST,51,54,43,97
MANDERA,MANDERA WEST,52,134,80,214
MANDERA,MANDERA WEST,53,69,53,122
MANDERA,MANDERA WEST,54,93,66,159
MANDERA,MANDERA WEST,50-54,738,480,1218
MANDERA,MANDERA WEST,55,131,58,189
MANDERA,MANDERA WEST,56,79,42,121
MANDERA,MANDERA WEST,57,60,40,100
MANDERA,MANDERA WEST,58,66,59,125
MANDERA,MANDERA WEST,59,75,65,140
MANDERA,MANDERA WEST,55-59,411,264,675
MANDERA,MANDERA WEST,60,248,146,394
MANDERA,MANDERA WEST,61,56,50,106
MANDERA,MANDERA WEST,62,74,34,108
MANDERA,MANDERA WEST,63,54,50,104
MANDERA,MANDERA WEST,64,43,27,70
MANDERA,MANDERA WEST,60-64,475,307,782
MANDERA,MANDERA WEST,65,90,46,136
MANDERA,MANDERA WEST,66,46,29,75
MANDERA,MANDERA WEST,67,44,24,68
MANDERA,MANDERA WEST,68,30,21,51
MANDERA,MANDERA WEST,69,42,17,59
MANDERA,MANDERA WEST,65-69,252,137,389
MANDERA,MANDERA WEST,70,171,96,267
MANDERA,MANDERA WEST,71,26,46,72
MANDERA,MANDERA WEST,72,40,12,52
MANDERA,MANDERA WEST,73,14,9,23
MANDERA,MANDERA WEST,74,21,7,28
MANDERA,MANDERA WEST,70-74,272,170,442
MANDERA,MANDERA WEST,75,37,17,54
MANDERA,MANDERA WEST,76,24,9,33
MANDERA,MANDERA WEST,77,10,7,17
MANDERA,MANDERA WEST,78,15,11,26
MANDERA,MANDERA WEST,79,20,10,30
MANDERA,MANDERA WEST,75-79,106,54,160
MANDERA,MANDERA WEST,80,69,52,121
MANDERA,MANDERA WEST,81,25,25,50
MANDERA,MANDERA WEST,82,14,6,20
MANDERA,MANDERA WEST,83,5,4,9
MANDERA,MANDERA WEST,84,8,4,12
MANDERA,MANDERA WEST,80-84,121,91,212
MANDERA,MANDERA WEST,85,20,8,28
MANDERA,MANDERA WEST,86,5,5,10
MANDERA,MANDERA WEST,87,5,3,8
MANDERA,MANDERA WEST,88,11,3,14
MANDERA,MANDERA WEST,89,13,3,16
MANDERA,MANDERA WEST,85-89,54,22,76
MANDERA,MANDERA WEST,90,14,18,32
MANDERA,MANDERA WEST,91,7,10,17
MANDERA,MANDERA WEST,92,3,-,3
MANDERA,MANDERA WEST,93,2,-,2
MANDERA,MANDERA WEST,94,3,-,3
MANDERA,MANDERA WEST,90-94,29,28,57
MANDERA,MANDERA WEST,95,4,2,6
MANDERA,MANDERA WEST,96,2,1,3
MANDERA,MANDERA WEST,97,-,-,-
MANDERA,MANDERA WEST,98,-,-,-
MANDERA,MANDERA WEST,99,2,-,2
MANDERA,MANDERA WEST,95-99,8,3,11
MANDERA,MANDERA WEST,100+,6,1,7
MANDERA,MANDERA WEST,Not Stated,1,-,1
MANDERA,BANISA,Total,78301,74288,152589
MANDERA,BANISA,0,1505,1759,3264
MANDERA,BANISA,1,1990,2272,4262
MANDERA,BANISA,2,4204,4676,8880
MANDERA,BANISA,3,2507,2815,5322
MANDERA,BANISA,4,4360,4779,9139
MANDERA,BANISA,0 - 4,14566,16301,30867
MANDERA,BANISA,5,2455,2573,5028
MANDERA,BANISA,6,4365,4705,9070
MANDERA,BANISA,7,2030,2120,4150
MANDERA,BANISA,8,4249,4219,8468
MANDERA,BANISA,9,1894,1926,3820
MANDERA,BANISA,05-Sep,14993,15543,30536
MANDERA,BANISA,10,4363,3922,8285
MANDERA,BANISA,11,1536,1709,3245
MANDERA,BANISA,12,3607,2425,6032
MANDERA,BANISA,13,1675,1162,2837
MANDERA,BANISA,14,2650,1751,4401
MANDERA,BANISA,Oct-14,13831,10969,24800
MANDERA,BANISA,15,2185,1438,3623
MANDERA,BANISA,16,2314,1563,3877
MANDERA,BANISA,17,1208,938,2146
MANDERA,BANISA,18,2350,1873,4223
MANDERA,BANISA,19,773,849,1622
MANDERA,BANISA,15-19,8830,6661,15491
MANDERA,BANISA,20,2460,2293,4753
MANDERA,BANISA,21,703,750,1453
MANDERA,BANISA,22,1077,1290,2367
MANDERA,BANISA,23,684,817,1501
MANDERA,BANISA,24,815,1066,1881
MANDERA,BANISA,20-24,5739,6216,11955
MANDERA,BANISA,25,1389,1668,3057
MANDERA,BANISA,26,815,1044,1859
MANDERA,BANISA,27,615,770,1385
MANDERA,BANISA,28,1006,1446,2452
MANDERA,BANISA,29,540,736,1276
MANDERA,BANISA,25-29,4365,5664,10029
MANDERA,BANISA,30,2102,2150,4252
MANDERA,BANISA,31,429,501,930
MANDERA,BANISA,32,785,829,1614
MANDERA,BANISA,33,449,509,958
MANDERA,BANISA,34,457,430,887
MANDERA,BANISA,30-34,4222,4419,8641
MANDERA,BANISA,35,1005,1065,2070
MANDERA,BANISA,36,419,586,1005
MANDERA,BANISA,37,321,359,680
MANDERA,BANISA,38,611,681,1292
MANDERA,BANISA,39,340,411,751
MANDERA,BANISA,35-39,2696,3102,5798
MANDERA,BANISA,40,1797,1301,3098
MANDERA,BANISA,41,314,283,597
MANDERA,BANISA,42,470,326,796
MANDERA,BANISA,43,282,241,523
MANDERA,BANISA,44,183,146,329
MANDERA,BANISA,40-44,3046,2297,5343
MANDERA,BANISA,45,785,481,1266
MANDERA,BANISA,46,225,138,363
MANDERA,BANISA,47,200,129,329
MANDERA,BANISA,48,301,231,532
MANDERA,BANISA,49,179,123,302
MANDERA,BANISA,45-49,1690,1102,2792
MANDERA,BANISA,50,896,434,1330
MANDERA,BANISA,51,121,76,197
MANDERA,BANISA,52,243,120,363
MANDERA,BANISA,53,114,75,189
MANDERA,BANISA,54,164,72,236
MANDERA,BANISA,50-54,1538,777,2315
MANDERA,BANISA,55,246,101,347
MANDERA,BANISA,56,180,73,253
MANDERA,BANISA,57,81,42,123
MANDERA,BANISA,58,121,61,182
MANDERA,BANISA,59,88,52,140
MANDERA,BANISA,55-59,716,329,1045
MANDERA,BANISA,60,612,255,867
MANDERA,BANISA,61,65,49,114
MANDERA,BANISA,62,125,44,169
MANDERA,BANISA,63,77,33,110
MANDERA,BANISA,64,67,21,88
MANDERA,BANISA,60-64,946,402,1348
MANDERA,BANISA,65,139,66,205
MANDERA,BANISA,66,33,20,53
MANDERA,BANISA,67,62,12,74
MANDERA,BANISA,68,38,22,60
MANDERA,BANISA,69,61,19,80
MANDERA,BANISA,65-69,333,139,472
MANDERA,BANISA,70,266,134,400
MANDERA,BANISA,71,28,25,53
MANDERA,BANISA,72,59,14,73
MANDERA,BANISA,73,23,10,33
MANDERA,BANISA,74,20,8,28
MANDERA,BANISA,70-74,396,191,587
MANDERA,BANISA,75,60,15,75
MANDERA,BANISA,76,23,8,31
MANDERA,BANISA,77,12,5,17
MANDERA,BANISA,78,32,13,45
MANDERA,BANISA,79,22,13,35
MANDERA,BANISA,75-79,149,54,203
MANDERA,BANISA,80,105,54,159
MANDERA,BANISA,81,24,9,33
MANDERA,BANISA,82,24,7,31
MANDERA,BANISA,83,11,1,12
MANDERA,BANISA,84,8,5,13
MANDERA,BANISA,80-84,172,76,248
MANDERA,BANISA,85,15,7,22
MANDERA,BANISA,86,9,5,14
MANDERA,BANISA,87,4,1,5
MANDERA,BANISA,88,6,2,8
MANDERA,BANISA,89,1,5,6
MANDERA,BANISA,85-89,35,20,55
MANDERA,BANISA,90,24,16,40
MANDERA,BANISA,91,1,1,2
MANDERA,BANISA,92,3,-,3
MANDERA,BANISA,93,2,-,2
MANDERA,BANISA,94,1,-,1
MANDERA,BANISA,90-94,31,17,48
MANDERA,BANISA,95,1,5,6
MANDERA,BANISA,96,2,-,2
MANDERA,BANISA,97,-,1,1
MANDERA,BANISA,98,1,1,2
MANDERA,BANISA,99,1,-,1
MANDERA,BANISA,95-99,5,7,12
MANDERA,BANISA,100+,1,2,3
MANDERA,BANISA,Not Stated,1,-,1
MANDERA,KOTULO,Total,35799,36593,72392
MANDERA,KOTULO,0,877,1214,2091
MANDERA,KOTULO,1,904,1183,2087
MANDERA,KOTULO,2,1627,2121,3748
MANDERA,KOTULO,3,1118,1465,2583
MANDERA,KOTULO,4,1559,2016,3575
MANDERA,KOTULO,0 - 4,6085,7999,14084
MANDERA,KOTULO,5,1147,1371,2518
MANDERA,KOTULO,6,1540,1982,3522
MANDERA,KOTULO,7,1003,1283,2286
MANDERA,KOTULO,8,1640,1887,3527
MANDERA,KOTULO,9,952,1206,2158
MANDERA,KOTULO,05-Sep,6282,7729,14011
MANDERA,KOTULO,10,1828,2054,3882
MANDERA,KOTULO,11,766,1058,1824
MANDERA,KOTULO,12,1717,1281,2998
MANDERA,KOTULO,13,1071,769,1840
MANDERA,KOTULO,14,1386,1001,2387
MANDERA,KOTULO,Oct-14,6768,6163,12931
MANDERA,KOTULO,15,1290,896,2186
MANDERA,KOTULO,16,1199,894,2093
MANDERA,KOTULO,17,960,795,1755
MANDERA,KOTULO,18,1079,843,1922
MANDERA,KOTULO,19,387,365,752
MANDERA,KOTULO,15-19,4915,3793,8708
MANDERA,KOTULO,20,1034,976,2010
MANDERA,KOTULO,21,386,348,734
MANDERA,KOTULO,22,509,631,1140
MANDERA,KOTULO,23,342,383,725
MANDERA,KOTULO,24,414,415,829
MANDERA,KOTULO,20-24,2685,2753,5438
MANDERA,KOTULO,25,652,644,1296
MANDERA,KOTULO,26,427,486,913
MANDERA,KOTULO,27,364,373,737
MANDERA,KOTULO,28,472,494,966
MANDERA,KOTULO,29,300,264,564
MANDERA,KOTULO,25-29,2215,2261,4476
MANDERA,KOTULO,30,737,735,1472
MANDERA,KOTULO,31,225,290,515
MANDERA,KOTULO,32,381,411,792
MANDERA,KOTULO,33,257,256,513
MANDERA,KOTULO,34,195,187,382
MANDERA,KOTULO,30-34,1795,1879,3674
MANDERA,KOTULO,35,437,433,870
MANDERA,KOTULO,36,191,241,432
MANDERA,KOTULO,37,157,146,303
MANDERA,KOTULO,38,264,291,555
MANDERA,KOTULO,39,178,198,376
MANDERA,KOTULO,35-39,1227,1309,2536
MANDERA,KOTULO,40,545,421,966
MANDERA,KOTULO,41,187,204,391
MANDERA,KOTULO,42,183,202,385
MANDERA,KOTULO,43,151,124,275
MANDERA,KOTULO,44,109,47,156
MANDERA,KOTULO,40-44,1175,998,2173
MANDERA,KOTULO,45,315,204,519
MANDERA,KOTULO,46,100,85,185
MANDERA,KOTULO,47,86,69,155
MANDERA,KOTULO,48,122,90,212
MANDERA,KOTULO,49,93,65,158
MANDERA,KOTULO,45-49,716,513,1229
MANDERA,KOTULO,50,259,184,443
MANDERA,KOTULO,51,66,60,126
MANDERA,KOTULO,52,103,65,168
MANDERA,KOTULO,53,79,48,127
MANDERA,KOTULO,54,82,60,142
MANDERA,KOTULO,50-54,589,417,1006
MANDERA,KOTULO,55,121,51,172
MANDERA,KOTULO,56,70,56,126
MANDERA,KOTULO,57,50,45,95
MANDERA,KOTULO,58,65,39,104
MANDERA,KOTULO,59,54,28,82
MANDERA,KOTULO,55-59,360,219,579
MANDERA,KOTULO,60,174,109,283
MANDERA,KOTULO,61,50,58,108
MANDERA,KOTULO,62,51,26,77
MANDERA,KOTULO,63,47,31,78
MANDERA,KOTULO,64,45,18,63
MANDERA,KOTULO,60-64,367,242,609
MANDERA,KOTULO,65,87,34,121
MANDERA,KOTULO,66,18,17,35
MANDERA,KOTULO,67,34,22,56
MANDERA,KOTULO,68,28,14,42
MANDERA,KOTULO,69,36,11,47
MANDERA,KOTULO,65-69,203,98,301
MANDERA,KOTULO,70,95,54,149
MANDERA,KOTULO,71,31,33,64
MANDERA,KOTULO,72,26,15,41
MANDERA,KOTULO,73,18,4,22
MANDERA,KOTULO,74,9,5,14
MANDERA,KOTULO,70-74,179,111,290
MANDERA,KOTULO,75,26,12,38
MANDERA,KOTULO,76,18,7,25
MANDERA,KOTULO,77,12,5,17
MANDERA,KOTULO,78,11,4,15
MANDERA,KOTULO,79,20,4,24
MANDERA,KOTULO,75-79,87,32,119
MANDERA,KOTULO,80,47,24,71
MANDERA,KOTULO,81,15,9,24
MANDERA,KOTULO,82,13,4,17
MANDERA,KOTULO,83,6,2,8
MANDERA,KOTULO,84,8,1,9
MANDERA,KOTULO,80-84,89,40,129
MANDERA,KOTULO,85,12,6,18
MANDERA,KOTULO,86,6,2,8
MANDERA,KOTULO,87,8,3,11
MANDERA,KOTULO,88,7,-,7
MANDERA,KOTULO,89,9,3,12
MANDERA,KOTULO,85-89,42,14,56
MANDERA,KOTULO,90,7,7,14
MANDERA,KOTULO,91,1,5,6
MANDERA,KOTULO,92,1,3,4
MANDERA,KOTULO,93,2,2,4
MANDERA,KOTULO,94,3,3,6
MANDERA,KOTULO,90-94,14,20,34
MANDERA,KOTULO,95,3,-,3
MANDERA,KOTULO,96,-,1,1
MANDERA,KOTULO,97,-,1,1
MANDERA,KOTULO,98,-,1,1
MANDERA,KOTULO,99,1,-,1
MANDERA,KOTULO,95-99,4,3,7
MANDERA,KOTULO,100+,2,-,2
MANDERA,KOTULO,Not Stated,-,-,-
MANDERA,LAFEY,Total,40476,42976,83452
MANDERA,LAFEY,0,764,1055,1819
MANDERA,LAFEY,1,1105,1462,2567
MANDERA,LAFEY,2,1870,2156,4026
MANDERA,LAFEY,3,1282,1664,2946
MANDERA,LAFEY,4,1663,1978,3641
MANDERA,LAFEY,0 - 4,6684,8315,14999
MANDERA,LAFEY,5,1199,1537,2736
MANDERA,LAFEY,6,1594,1892,3486
MANDERA,LAFEY,7,1084,1330,2414
MANDERA,LAFEY,8,1507,1909,3416
MANDERA,LAFEY,9,1159,1320,2479
MANDERA,LAFEY,05-Sep,6543,7988,14531
MANDERA,LAFEY,10,1899,2087,3986
MANDERA,LAFEY,11,932,1134,2066
MANDERA,LAFEY,12,1574,1515,3089
MANDERA,LAFEY,13,1088,1092,2180
MANDERA,LAFEY,14,1331,1286,2617
MANDERA,LAFEY,Oct-14,6824,7114,13938
MANDERA,LAFEY,15,1461,1399,2860
MANDERA,LAFEY,16,1355,1373,2728
MANDERA,LAFEY,17,1493,1672,3165
MANDERA,LAFEY,18,1269,1237,2506
MANDERA,LAFEY,19,839,862,1701
MANDERA,LAFEY,15-19,6417,6543,12960
MANDERA,LAFEY,20,1658,1459,3117
MANDERA,LAFEY,21,727,631,1358
MANDERA,LAFEY,22,656,660,1316
MANDERA,LAFEY,23,654,649,1303
MANDERA,LAFEY,24,488,469,957
MANDERA,LAFEY,20-24,4183,3868,8051
MANDERA,LAFEY,25,872,832,1704
MANDERA,LAFEY,26,455,372,827
MANDERA,LAFEY,27,353,308,661
MANDERA,LAFEY,28,424,474,898
MANDERA,LAFEY,29,461,457,918
MANDERA,LAFEY,25-29,2565,2443,5008
MANDERA,LAFEY,30,863,885,1748
MANDERA,LAFEY,31,272,316,588
MANDERA,LAFEY,32,422,415,837
MANDERA,LAFEY,33,243,304,547
MANDERA,LAFEY,34,260,216,476
MANDERA,LAFEY,30-34,2060,2136,4196
MANDERA,LAFEY,35,369,372,741
MANDERA,LAFEY,36,195,208,403
MANDERA,LAFEY,37,189,198,387
MANDERA,LAFEY,38,210,218,428
MANDERA,LAFEY,39,266,303,569
MANDERA,LAFEY,35-39,1229,1299,2528
MANDERA,LAFEY,40,541,471,1012
MANDERA,LAFEY,41,213,239,452
MANDERA,LAFEY,42,216,200,416
MANDERA,LAFEY,43,141,116,257
MANDERA,LAFEY,44,92,82,174
MANDERA,LAFEY,40-44,1203,1108,2311
MANDERA,LAFEY,45,202,158,360
MANDERA,LAFEY,46,97,70,167
MANDERA,LAFEY,47,100,78,178
MANDERA,LAFEY,48,106,73,179
MANDERA,LAFEY,49,111,110,221
MANDERA,LAFEY,45-49,616,489,1105
MANDERA,LAFEY,50,266,222,488
MANDERA,LAFEY,51,92,81,173
MANDERA,LAFEY,52,100,97,197
MANDERA,LAFEY,53,74,52,126
MANDERA,LAFEY,54,81,68,149
MANDERA,LAFEY,50-54,613,520,1133
MANDERA,LAFEY,55,101,68,169
MANDERA,LAFEY,56,54,45,99
MANDERA,LAFEY,57,63,54,117
MANDERA,LAFEY,58,58,55,113
MANDERA,LAFEY,59,103,78,181
MANDERA,LAFEY,55-59,379,300,679
MANDERA,LAFEY,60,196,165,361
MANDERA,LAFEY,61,60,64,124
MANDERA,LAFEY,62,59,33,92
MANDERA,LAFEY,63,44,29,73
MANDERA,LAFEY,64,39,17,56
MANDERA,LAFEY,60-64,398,308,706
MANDERA,LAFEY,65,51,41,92
MANDERA,LAFEY,66,30,20,50
MANDERA,LAFEY,67,40,22,62
MANDERA,LAFEY,68,24,20,44
MANDERA,LAFEY,69,51,37,88
MANDERA,LAFEY,65-69,196,140,336
MANDERA,LAFEY,70,134,125,259
MANDERA,LAFEY,71,37,24,61
MANDERA,LAFEY,72,32,17,49
MANDERA,LAFEY,73,11,10,21
MANDERA,LAFEY,74,32,7,39
MANDERA,LAFEY,70-74,246,183,429
MANDERA,LAFEY,75,26,20,46
MANDERA,LAFEY,76,12,5,17
MANDERA,LAFEY,77,20,11,31
MANDERA,LAFEY,78,26,12,38
MANDERA,LAFEY,79,25,15,40
MANDERA,LAFEY,75-79,109,63,172
MANDERA,LAFEY,80,59,64,123
MANDERA,LAFEY,81,11,13,24
MANDERA,LAFEY,82,17,8,25
MANDERA,LAFEY,83,11,5,16
MANDERA,LAFEY,84,14,7,21
MANDERA,LAFEY,80-84,112,97,209
MANDERA,LAFEY,85,16,10,26
MANDERA,LAFEY,86,5,1,6
MANDERA,LAFEY,87,13,7,20
MANDERA,LAFEY,88,4,2,6
MANDERA,LAFEY,89,11,8,19
MANDERA,LAFEY,85-89,49,28,77
MANDERA,LAFEY,90,12,19,31
MANDERA,LAFEY,91,7,2,9
MANDERA,LAFEY,92,10,1,11
MANDERA,LAFEY,93,-,1,1
MANDERA,LAFEY,94,2,-,2
MANDERA,LAFEY,90-94,31,23,54
MANDERA,LAFEY,95,3,-,3
MANDERA,LAFEY,96,1,1,2
MANDERA,LAFEY,97,2,1,3
MANDERA,LAFEY,98,-,2,2
MANDERA,LAFEY,99,1,2,3
MANDERA,LAFEY,95-99,7,6,13
MANDERA,LAFEY,100+,12,5,17
MANDERA,LAFEY,Not Stated,-,-,-
MANDERA,MANDERA CENTRAL,Total,71688,85527,157215
MANDERA,MANDERA CENTRAL,0,1331,1867,3198
MANDERA,MANDERA CENTRAL,1,2057,2898,4955
MANDERA,MANDERA CENTRAL,2,3159,4595,7754
MANDERA,MANDERA CENTRAL,3,2504,3661,6165
MANDERA,MANDERA CENTRAL,4,3216,4450,7666
MANDERA,MANDERA CENTRAL,0 - 4,12267,17471,29738
MANDERA,MANDERA CENTRAL,5,2568,3538,6106
MANDERA,MANDERA CENTRAL,6,3215,4617,7832
MANDERA,MANDERA CENTRAL,7,2259,3066,5325
MANDERA,MANDERA CENTRAL,8,3331,4484,7815
MANDERA,MANDERA CENTRAL,9,2102,2727,4829
MANDERA,MANDERA CENTRAL,05-Sep,13475,18432,31907
MANDERA,MANDERA CENTRAL,10,3604,4616,8220
MANDERA,MANDERA CENTRAL,11,1698,2484,4182
MANDERA,MANDERA CENTRAL,12,3008,3124,6132
MANDERA,MANDERA CENTRAL,13,2206,2101,4307
MANDERA,MANDERA CENTRAL,14,2551,2583,5134
MANDERA,MANDERA CENTRAL,Oct-14,13067,14908,27975
MANDERA,MANDERA CENTRAL,15,2712,2511,5223
MANDERA,MANDERA CENTRAL,16,2279,2402,4681
MANDERA,MANDERA CENTRAL,17,1941,2027,3968
MANDERA,MANDERA CENTRAL,18,2001,2370,4371
MANDERA,MANDERA CENTRAL,19,962,1123,2085
MANDERA,MANDERA CENTRAL,15-19,9895,10433,20328
MANDERA,MANDERA CENTRAL,20,2149,2455,4604
MANDERA,MANDERA CENTRAL,21,748,901,1649
MANDERA,MANDERA CENTRAL,22,1098,1483,2581
MANDERA,MANDERA CENTRAL,23,786,914,1700
MANDERA,MANDERA CENTRAL,24,779,944,1723
MANDERA,MANDERA CENTRAL,20-24,5560,6697,12257
MANDERA,MANDERA CENTRAL,25,1432,1632,3064
MANDERA,MANDERA CENTRAL,26,728,818,1546
MANDERA,MANDERA CENTRAL,27,813,998,1811
MANDERA,MANDERA CENTRAL,28,782,1010,1792
MANDERA,MANDERA CENTRAL,29,562,614,1176
MANDERA,MANDERA CENTRAL,25-29,4317,5072,9389
MANDERA,MANDERA CENTRAL,30,1588,1669,3257
MANDERA,MANDERA CENTRAL,31,419,556,975
MANDERA,MANDERA CENTRAL,32,696,833,1529
MANDERA,MANDERA CENTRAL,33,410,528,938
MANDERA,MANDERA CENTRAL,34,339,392,731
MANDERA,MANDERA CENTRAL,30-34,3452,3978,7430
MANDERA,MANDERA CENTRAL,35,884,895,1779
MANDERA,MANDERA CENTRAL,36,324,462,786
MANDERA,MANDERA CENTRAL,37,312,395,707
MANDERA,MANDERA CENTRAL,38,491,607,1098
MANDERA,MANDERA CENTRAL,39,326,369,695
MANDERA,MANDERA CENTRAL,35-39,2337,2728,5065
MANDERA,MANDERA CENTRAL,40,1088,942,2030
MANDERA,MANDERA CENTRAL,41,410,479,889
MANDERA,MANDERA CENTRAL,42,375,306,681
MANDERA,MANDERA CENTRAL,43,256,216,472
MANDERA,MANDERA CENTRAL,44,170,120,290
MANDERA,MANDERA CENTRAL,40-44,2299,2063,4362
MANDERA,MANDERA CENTRAL,45,619,460,1079
MANDERA,MANDERA CENTRAL,46,222,173,395
MANDERA,MANDERA CENTRAL,47,202,174,376
MANDERA,MANDERA CENTRAL,48,218,176,394
MANDERA,MANDERA CENTRAL,49,173,137,310
MANDERA,MANDERA CENTRAL,45-49,1434,1120,2554
MANDERA,MANDERA CENTRAL,50,481,359,840
MANDERA,MANDERA CENTRAL,51,127,123,250
MANDERA,MANDERA CENTRAL,52,224,100,324
MANDERA,MANDERA CENTRAL,53,103,85,188
MANDERA,MANDERA CENTRAL,54,156,111,267
MANDERA,MANDERA CENTRAL,50-54,1091,778,1869
MANDERA,MANDERA CENTRAL,55,203,128,331
MANDERA,MANDERA CENTRAL,56,129,105,234
MANDERA,MANDERA CENTRAL,57,93,73,166
MANDERA,MANDERA CENTRAL,58,115,92,207
MANDERA,MANDERA CENTRAL,59,102,105,207
MANDERA,MANDERA CENTRAL,55-59,642,503,1145
MANDERA,MANDERA CENTRAL,60,322,233,555
MANDERA,MANDERA CENTRAL,61,122,111,233
MANDERA,MANDERA CENTRAL,62,104,57,161
MANDERA,MANDERA CENTRAL,63,96,57,153
MANDERA,MANDERA CENTRAL,64,78,38,116
MANDERA,MANDERA CENTRAL,60-64,722,496,1218
MANDERA,MANDERA CENTRAL,65,120,83,203
MANDERA,MANDERA CENTRAL,66,52,49,101
MANDERA,MANDERA CENTRAL,67,54,46,100
MANDERA,MANDERA CENTRAL,68,59,39,98
MANDERA,MANDERA CENTRAL,69,82,39,121
MANDERA,MANDERA CENTRAL,65-69,367,256,623
MANDERA,MANDERA CENTRAL,70,178,114,292
MANDERA,MANDERA CENTRAL,71,46,90,136
MANDERA,MANDERA CENTRAL,72,49,40,89
MANDERA,MANDERA CENTRAL,73,27,16,43
MANDERA,MANDERA CENTRAL,74,30,17,47
MANDERA,MANDERA CENTRAL,70-74,330,277,607
MANDERA,MANDERA CENTRAL,75,42,40,82
MANDERA,MANDERA CENTRAL,76,26,27,53
MANDERA,MANDERA CENTRAL,77,14,21,35
MANDERA,MANDERA CENTRAL,78,38,12,50
MANDERA,MANDERA CENTRAL,79,28,8,36
MANDERA,MANDERA CENTRAL,75-79,148,108,256
MANDERA,MANDERA CENTRAL,80,76,56,132
MANDERA,MANDERA CENTRAL,81,33,42,75
MANDERA,MANDERA CENTRAL,82,29,10,39
MANDERA,MANDERA CENTRAL,83,15,12,27
MANDERA,MANDERA CENTRAL,84,8,7,15
MANDERA,MANDERA CENTRAL,80-84,161,127,288
MANDERA,MANDERA CENTRAL,85,21,6,27
MANDERA,MANDERA CENTRAL,86,11,14,25
MANDERA,MANDERA CENTRAL,87,15,6,21
MANDERA,MANDERA CENTRAL,88,9,2,11
MANDERA,MANDERA CENTRAL,89,16,4,20
MANDERA,MANDERA CENTRAL,85-89,72,32,104
MANDERA,MANDERA CENTRAL,90,14,15,29
MANDERA,MANDERA CENTRAL,91,10,13,23
MANDERA,MANDERA CENTRAL,92,5,5,10
MANDERA,MANDERA CENTRAL,93,2,1,3
MANDERA,MANDERA CENTRAL,94,4,4,8
MANDERA,MANDERA CENTRAL,90-94,35,38,73
MANDERA,MANDERA CENTRAL,95,3,3,6
MANDERA,MANDERA CENTRAL,96,2,-,2
MANDERA,MANDERA CENTRAL,97,-,1,1
MANDERA,MANDERA CENTRAL,98,3,1,4
MANDERA,MANDERA CENTRAL,99,3,-,3
MANDERA,MANDERA CENTRAL,95-99,11,5,16
MANDERA,MANDERA CENTRAL,100+,6,5,11
MANDERA,MANDERA CENTRAL,Not Stated,-,-,-
MANDERA,MANDERA EAST,Total,83538,76095,159633
MANDERA,MANDERA EAST,0,1642,1591,3233
MANDERA,MANDERA EAST,1,2375,2247,4622
MANDERA,MANDERA EAST,2,3318,3250,6568
MANDERA,MANDERA EAST,3,2746,2694,5440
MANDERA,MANDERA EAST,4,3216,3148,6364
MANDERA,MANDERA EAST,0 - 4,13297,12930,26227
MANDERA,MANDERA EAST,5,2679,2553,5232
MANDERA,MANDERA EAST,6,3261,2980,6241
MANDERA,MANDERA EAST,7,2422,2349,4771
MANDERA,MANDERA EAST,8,3249,2961,6210
MANDERA,MANDERA EAST,9,2115,2072,4187
MANDERA,MANDERA EAST,05-Sep,13726,12915,26641
MANDERA,MANDERA EAST,10,3479,3130,6609
MANDERA,MANDERA EAST,11,2052,1790,3842
MANDERA,MANDERA EAST,12,3118,2489,5607
MANDERA,MANDERA EAST,13,2381,2020,4401
MANDERA,MANDERA EAST,14,2726,2173,4899
MANDERA,MANDERA EAST,Oct-14,13756,11602,25358
MANDERA,MANDERA EAST,15,2641,2150,4791
MANDERA,MANDERA EAST,16,2507,1960,4467
MANDERA,MANDERA EAST,17,2324,1762,4086
MANDERA,MANDERA EAST,18,2466,2111,4577
MANDERA,MANDERA EAST,19,1521,1350,2871
MANDERA,MANDERA EAST,15-19,11459,9333,20792
MANDERA,MANDERA EAST,20,2518,2322,4840
MANDERA,MANDERA EAST,21,1189,1144,2333
MANDERA,MANDERA EAST,22,1583,1699,3282
MANDERA,MANDERA EAST,23,1358,1270,2628
MANDERA,MANDERA EAST,24,1235,1099,2334
MANDERA,MANDERA EAST,20-24,7883,7534,15417
MANDERA,MANDERA EAST,25,1925,1684,3609
MANDERA,MANDERA EAST,26,1188,1084,2272
MANDERA,MANDERA EAST,27,1086,950,2036
MANDERA,MANDERA EAST,28,1139,1136,2275
MANDERA,MANDERA EAST,29,837,731,1568
MANDERA,MANDERA EAST,25-29,6175,5585,11760
MANDERA,MANDERA EAST,30,2029,1747,3776
MANDERA,MANDERA EAST,31,651,689,1340
MANDERA,MANDERA EAST,32,956,882,1838
MANDERA,MANDERA EAST,33,579,514,1093
MANDERA,MANDERA EAST,34,497,372,869
MANDERA,MANDERA EAST,30-34,4712,4204,8916
MANDERA,MANDERA EAST,35,1137,1100,2237
MANDERA,MANDERA EAST,36,437,472,909
MANDERA,MANDERA EAST,37,447,469,916
MANDERA,MANDERA EAST,38,502,547,1049
MANDERA,MANDERA EAST,39,406,353,759
MANDERA,MANDERA EAST,35-39,2929,2941,5870
MANDERA,MANDERA EAST,40,1446,1245,2691
MANDERA,MANDERA EAST,41,508,571,1079
MANDERA,MANDERA EAST,42,483,418,901
MANDERA,MANDERA EAST,43,288,255,543
MANDERA,MANDERA EAST,44,210,171,381
MANDERA,MANDERA EAST,40-44,2935,2660,5595
MANDERA,MANDERA EAST,45,700,635,1335
MANDERA,MANDERA EAST,46,252,210,462
MANDERA,MANDERA EAST,47,284,286,570
MANDERA,MANDERA EAST,48,254,171,425
MANDERA,MANDERA EAST,49,191,161,352
MANDERA,MANDERA EAST,45-49,1681,1463,3144
MANDERA,MANDERA EAST,50,684,581,1265
MANDERA,MANDERA EAST,51,153,158,311
MANDERA,MANDERA EAST,52,223,211,434
MANDERA,MANDERA EAST,53,161,181,342
MANDERA,MANDERA EAST,54,203,170,373
MANDERA,MANDERA EAST,50-54,1424,1301,2725
MANDERA,MANDERA EAST,55,322,308,630
MANDERA,MANDERA EAST,56,173,155,328
MANDERA,MANDERA EAST,57,166,195,361
MANDERA,MANDERA EAST,58,145,191,336
MANDERA,MANDERA EAST,59,182,172,354
MANDERA,MANDERA EAST,55-59,988,1021,2009
MANDERA,MANDERA EAST,60,496,483,979
MANDERA,MANDERA EAST,61,116,125,241
MANDERA,MANDERA EAST,62,155,101,256
MANDERA,MANDERA EAST,63,105,93,198
MANDERA,MANDERA EAST,64,112,69,181
MANDERA,MANDERA EAST,60-64,984,871,1855
MANDERA,MANDERA EAST,65,208,193,401
MANDERA,MANDERA EAST,66,67,73,140
MANDERA,MANDERA EAST,67,104,81,185
MANDERA,MANDERA EAST,68,67,68,135
MANDERA,MANDERA EAST,69,84,72,156
MANDERA,MANDERA EAST,65-69,530,487,1017
MANDERA,MANDERA EAST,70,263,400,663
MANDERA,MANDERA EAST,71,51,60,111
MANDERA,MANDERA EAST,72,65,42,107
MANDERA,MANDERA EAST,73,38,30,68
MANDERA,MANDERA EAST,74,33,39,72
MANDERA,MANDERA EAST,70-74,450,571,1021
MANDERA,MANDERA EAST,75,78,81,159
MANDERA,MANDERA EAST,76,28,27,55
MANDERA,MANDERA EAST,77,45,30,75
MANDERA,MANDERA EAST,78,37,27,64
MANDERA,MANDERA EAST,79,34,25,59
MANDERA,MANDERA EAST,75-79,222,190,412
MANDERA,MANDERA EAST,80,129,217,346
MANDERA,MANDERA EAST,81,20,38,58
MANDERA,MANDERA EAST,82,35,19,54
MANDERA,MANDERA EAST,83,14,11,25
MANDERA,MANDERA EAST,84,22,13,35
MANDERA,MANDERA EAST,80-84,220,298,518
MANDERA,MANDERA EAST,85,36,19,55
MANDERA,MANDERA EAST,86,13,14,27
MANDERA,MANDERA EAST,87,23,4,27
MANDERA,MANDERA EAST,88,13,12,25
MANDERA,MANDERA EAST,89,8,12,20
MANDERA,MANDERA EAST,85-89,93,61,154
MANDERA,MANDERA EAST,90,30,66,96
MANDERA,MANDERA EAST,91,3,14,17
MANDERA,MANDERA EAST,92,9,8,17
MANDERA,MANDERA EAST,93,5,4,9
MANDERA,MANDERA EAST,94,2,2,4
MANDERA,MANDERA EAST,90-94,49,94,143
MANDERA,MANDERA EAST,95,6,7,13
MANDERA,MANDERA EAST,96,1,3,4
MANDERA,MANDERA EAST,97,2,3,5
MANDERA,MANDERA EAST,98,4,1,5
MANDERA,MANDERA EAST,99,3,-,3
MANDERA,MANDERA EAST,95-99,16,14,30
MANDERA,MANDERA EAST,100+,8,20,28
MANDERA,MANDERA EAST,Not Stated,1,-,1
MANDERA,MANDERA NORTH,Total,77008,66835,143843
MANDERA,MANDERA NORTH,0,1050,1249,2299
MANDERA,MANDERA NORTH,1,1928,2009,3937
MANDERA,MANDERA NORTH,2,3194,3349,6543
MANDERA,MANDERA NORTH,3,2246,2397,4643
MANDERA,MANDERA NORTH,4,3507,3401,6908
MANDERA,MANDERA NORTH,0 - 4,11925,12405,24330
MANDERA,MANDERA NORTH,5,2304,2299,4603
MANDERA,MANDERA NORTH,6,3638,3455,7093
MANDERA,MANDERA NORTH,7,2072,2015,4087
MANDERA,MANDERA NORTH,8,3955,3557,7512
MANDERA,MANDERA NORTH,9,2013,1980,3993
MANDERA,MANDERA NORTH,05-Sep,13982,13306,27288
MANDERA,MANDERA NORTH,10,4508,3727,8235
MANDERA,MANDERA NORTH,11,1769,1888,3657
MANDERA,MANDERA NORTH,12,3989,2588,6577
MANDERA,MANDERA NORTH,13,2198,1562,3760
MANDERA,MANDERA NORTH,14,3280,2020,5300
MANDERA,MANDERA NORTH,Oct-14,15744,11785,27529
MANDERA,MANDERA NORTH,15,2970,1739,4709
MANDERA,MANDERA NORTH,16,2889,1871,4760
MANDERA,MANDERA NORTH,17,2354,1490,3844
MANDERA,MANDERA NORTH,18,2459,1743,4202
MANDERA,MANDERA NORTH,19,1024,765,1789
MANDERA,MANDERA NORTH,15-19,11696,7608,19304
MANDERA,MANDERA NORTH,20,2603,1978,4581
MANDERA,MANDERA NORTH,21,796,736,1532
MANDERA,MANDERA NORTH,22,1229,1227,2456
MANDERA,MANDERA NORTH,23,897,806,1703
MANDERA,MANDERA NORTH,24,909,795,1704
MANDERA,MANDERA NORTH,20-24,6434,5542,11976
MANDERA,MANDERA NORTH,25,1424,1267,2691
MANDERA,MANDERA NORTH,26,757,710,1467
MANDERA,MANDERA NORTH,27,648,710,1358
MANDERA,MANDERA NORTH,28,886,904,1790
MANDERA,MANDERA NORTH,29,498,577,1075
MANDERA,MANDERA NORTH,25-29,4213,4168,8381
MANDERA,MANDERA NORTH,30,1703,1605,3308
MANDERA,MANDERA NORTH,31,382,489,871
MANDERA,MANDERA NORTH,32,644,715,1359
MANDERA,MANDERA NORTH,33,340,437,777
MANDERA,MANDERA NORTH,34,324,355,679
MANDERA,MANDERA NORTH,30-34,3393,3601,6994
MANDERA,MANDERA NORTH,35,707,797,1504
MANDERA,MANDERA NORTH,36,336,359,695
MANDERA,MANDERA NORTH,37,264,285,549
MANDERA,MANDERA NORTH,38,366,465,831
MANDERA,MANDERA NORTH,39,277,310,587
MANDERA,MANDERA NORTH,35-39,1950,2216,4166
MANDERA,MANDERA NORTH,40,1145,1065,2210
MANDERA,MANDERA NORTH,41,409,408,817
MANDERA,MANDERA NORTH,42,351,300,651
MANDERA,MANDERA NORTH,43,251,208,459
MANDERA,MANDERA NORTH,44,197,147,344
MANDERA,MANDERA NORTH,40-44,2353,2128,4481
MANDERA,MANDERA NORTH,45,545,512,1057
MANDERA,MANDERA NORTH,46,172,167,339
MANDERA,MANDERA NORTH,47,201,176,377
MANDERA,MANDERA NORTH,48,207,183,390
MANDERA,MANDERA NORTH,49,185,137,322
MANDERA,MANDERA NORTH,45-49,1310,1175,2485
MANDERA,MANDERA NORTH,50,701,463,1164
MANDERA,MANDERA NORTH,51,118,91,209
MANDERA,MANDERA NORTH,52,207,159,366
MANDERA,MANDERA NORTH,53,133,124,257
MANDERA,MANDERA NORTH,54,135,97,232
MANDERA,MANDERA NORTH,50-54,1294,934,2228
MANDERA,MANDERA NORTH,55,213,165,378
MANDERA,MANDERA NORTH,56,142,119,261
MANDERA,MANDERA NORTH,57,97,81,178
MANDERA,MANDERA NORTH,58,138,83,221
MANDERA,MANDERA NORTH,59,119,113,232
MANDERA,MANDERA NORTH,55-59,709,561,1270
MANDERA,MANDERA NORTH,60,403,288,691
MANDERA,MANDERA NORTH,61,78,85,163
MANDERA,MANDERA NORTH,62,124,59,183
MANDERA,MANDERA NORTH,63,88,61,149
MANDERA,MANDERA NORTH,64,74,64,138
MANDERA,MANDERA NORTH,60-64,767,557,1324
MANDERA,MANDERA NORTH,65,113,101,214
MANDERA,MANDERA NORTH,66,58,50,108
MANDERA,MANDERA NORTH,67,70,42,112
MANDERA,MANDERA NORTH,68,58,37,95
MANDERA,MANDERA NORTH,69,86,39,125
MANDERA,MANDERA NORTH,65-69,385,269,654
MANDERA,MANDERA NORTH,70,205,159,364
MANDERA,MANDERA NORTH,71,38,53,91
MANDERA,MANDERA NORTH,72,63,47,110
MANDERA,MANDERA NORTH,73,26,11,37
MANDERA,MANDERA NORTH,74,41,16,57
MANDERA,MANDERA NORTH,70-74,373,286,659
MANDERA,MANDERA NORTH,75,50,21,71
MANDERA,MANDERA NORTH,76,26,20,46
MANDERA,MANDERA NORTH,77,33,8,41
MANDERA,MANDERA NORTH,78,30,19,49
MANDERA,MANDERA NORTH,79,29,16,45
MANDERA,MANDERA NORTH,75-79,168,84,252
MANDERA,MANDERA NORTH,80,116,80,196
MANDERA,MANDERA NORTH,81,23,35,58
MANDERA,MANDERA NORTH,82,28,9,37
MANDERA,MANDERA NORTH,83,9,3,12
MANDERA,MANDERA NORTH,84,14,7,21
MANDERA,MANDERA NORTH,80-84,190,134,324
MANDERA,MANDERA NORTH,85,14,8,22
MANDERA,MANDERA NORTH,86,13,6,19
MANDERA,MANDERA NORTH,87,4,4,8
MANDERA,MANDERA NORTH,88,4,2,6
MANDERA,MANDERA NORTH,89,6,9,15
MANDERA,MANDERA NORTH,85-89,41,29,70
MANDERA,MANDERA NORTH,90,44,25,69
MANDERA,MANDERA NORTH,91,7,8,15
MANDERA,MANDERA NORTH,92,11,5,16
MANDERA,MANDERA NORTH,93,5,-,5
MANDERA,MANDERA NORTH,94,5,-,5
MANDERA,MANDERA NORTH,90-94,72,38,110
MANDERA,MANDERA NORTH,95,4,1,5
MANDERA,MANDERA NORTH,96,1,1,2
MANDERA,MANDERA NORTH,97,2,1,3
MANDERA,MANDERA NORTH,98,-,-,-
MANDERA,MANDERA NORTH,99,2,-,2
MANDERA,MANDERA NORTH,95-99,9,3,12
MANDERA,MANDERA NORTH,100+,-,6,6
MANDERA,MANDERA NORTH,Not Stated,-,-,-
MARSABIT,ALL,Total,243548,216219,459767
MARSABIT,ALL,0,5308,5244,10552
MARSABIT,ALL,1,6108,5906,12014
MARSABIT,ALL,2,7681,7409,15090
MARSABIT,ALL,3,7749,7520,15269
MARSABIT,ALL,4,8350,7885,16235
MARSABIT,ALL,0 - 4,35196,33964,69160
MARSABIT,ALL,5,8032,7705,15737
MARSABIT,ALL,6,8525,8122,16647
MARSABIT,ALL,7,7044,6726,13770
MARSABIT,ALL,8,8651,8575,17226
MARSABIT,ALL,9,5983,5853,11836
MARSABIT,ALL,05-Sep,38235,36981,75216
MARSABIT,ALL,10,10725,9901,20626
MARSABIT,ALL,11,4799,5290,10089
MARSABIT,ALL,12,9087,7101,16188
MARSABIT,ALL,13,6406,5464,11870
MARSABIT,ALL,14,6932,5726,12658
MARSABIT,ALL,Oct-14,37949,33482,71431
MARSABIT,ALL,15,8790,6622,15412
MARSABIT,ALL,16,6410,5030,11440
MARSABIT,ALL,17,6708,4736,11444
MARSABIT,ALL,18,6531,5260,11791
MARSABIT,ALL,19,3919,3193,7112
MARSABIT,ALL,15-19,32358,24841,57199
MARSABIT,ALL,20,7731,6336,14067
MARSABIT,ALL,21,3544,3093,6637
MARSABIT,ALL,22,4078,3932,8010
MARSABIT,ALL,23,3783,3611,7394
MARSABIT,ALL,24,3609,3237,6846
MARSABIT,ALL,20-24,22745,20209,42954
MARSABIT,ALL,25,5900,5229,11129
MARSABIT,ALL,26,3236,2799,6035
MARSABIT,ALL,27,3135,2711,5846
MARSABIT,ALL,28,3503,2953,6456
MARSABIT,ALL,29,2798,2447,5245
MARSABIT,ALL,25-29,18572,16139,34711
MARSABIT,ALL,30,6351,4987,11338
MARSABIT,ALL,31,1938,2176,4114
MARSABIT,ALL,32,2679,2341,5020
MARSABIT,ALL,33,2005,1945,3950
MARSABIT,ALL,34,1770,1664,3434
MARSABIT,ALL,30-34,14743,13113,27856
MARSABIT,ALL,35,3421,2872,6293
MARSABIT,ALL,36,1756,1602,3358
MARSABIT,ALL,37,1644,1384,3028
MARSABIT,ALL,38,1477,1206,2683
MARSABIT,ALL,39,1174,893,2067
MARSABIT,ALL,35-39,9472,7957,17429
MARSABIT,ALL,40,3807,2588,6395
MARSABIT,ALL,41,1681,1696,3377
MARSABIT,ALL,42,1409,1032,2441
MARSABIT,ALL,43,1151,923,2074
MARSABIT,ALL,44,670,558,1228
MARSABIT,ALL,40-44,8718,6797,15515
MARSABIT,ALL,45,2406,2033,4439
MARSABIT,ALL,46,998,1004,2002
MARSABIT,ALL,47,991,850,1841
MARSABIT,ALL,48,857,677,1534
MARSABIT,ALL,49,714,645,1359
MARSABIT,ALL,45-49,5966,5209,11175
MARSABIT,ALL,50,2392,1927,4319
MARSABIT,ALL,51,655,703,1358
MARSABIT,ALL,52,917,764,1681
MARSABIT,ALL,53,539,485,1024
MARSABIT,ALL,54,738,611,1349
MARSABIT,ALL,50-54,5241,4490,9731
MARSABIT,ALL,55,999,829,1828
MARSABIT,ALL,56,711,576,1287
MARSABIT,ALL,57,602,560,1162
MARSABIT,ALL,58,642,612,1254
MARSABIT,ALL,59,612,750,1362
MARSABIT,ALL,55-59,3566,3327,6893
MARSABIT,ALL,60,1847,1430,3277
MARSABIT,ALL,61,484,570,1054
MARSABIT,ALL,62,453,409,862
MARSABIT,ALL,63,428,383,811
MARSABIT,ALL,64,314,286,600
MARSABIT,ALL,60-64,3526,3078,6604
MARSABIT,ALL,65,701,585,1286
MARSABIT,ALL,66,302,349,651
MARSABIT,ALL,67,389,292,681
MARSABIT,ALL,68,326,231,557
MARSABIT,ALL,69,375,463,838
MARSABIT,ALL,65-69,2093,1920,4013
MARSABIT,ALL,70,1317,1116,2433
MARSABIT,ALL,71,321,441,762
MARSABIT,ALL,72,334,253,587
MARSABIT,ALL,73,216,190,406
MARSABIT,ALL,74,234,194,428
MARSABIT,ALL,70-74,2422,2194,4616
MARSABIT,ALL,75,325,261,586
MARSABIT,ALL,76,173,153,326
MARSABIT,ALL,77,143,97,240
MARSABIT,ALL,78,140,105,245
MARSABIT,ALL,79,154,192,346
MARSABIT,ALL,75-79,935,808,1743
MARSABIT,ALL,80,549,512,1061
MARSABIT,ALL,81,139,197,336
MARSABIT,ALL,82,126,88,214
MARSABIT,ALL,83,66,62,128
MARSABIT,ALL,84,90,91,181
MARSABIT,ALL,80-84,970,950,1920
MARSABIT,ALL,85,109,86,195
MARSABIT,ALL,86,72,59,131
MARSABIT,ALL,87,62,52,114
MARSABIT,ALL,88,44,24,68
MARSABIT,ALL,89,78,99,177
MARSABIT,ALL,85-89,365,320,685
MARSABIT,ALL,90,194,160,354
MARSABIT,ALL,91,41,46,87
MARSABIT,ALL,92,44,28,72
MARSABIT,ALL,93,14,15,29
MARSABIT,ALL,94,21,19,40
MARSABIT,ALL,90-94,314,268,582
MARSABIT,ALL,95,26,31,57
MARSABIT,ALL,96,18,13,31
MARSABIT,ALL,97,12,7,19
MARSABIT,ALL,98,14,17,31
MARSABIT,ALL,99,14,12,26
MARSABIT,ALL,95-99,84,80,164
MARSABIT,ALL,100+,74,90,164
MARSABIT,ALL,Not Stated,4,2,6
MARSABIT,LOIYANGALANI,Total,17659,18051,35710
MARSABIT,LOIYANGALANI,0,519,504,1023
MARSABIT,LOIYANGALANI,1,622,598,1220
MARSABIT,LOIYANGALANI,2,737,720,1457
MARSABIT,LOIYANGALANI,3,793,679,1472
MARSABIT,LOIYANGALANI,4,724,721,1445
MARSABIT,LOIYANGALANI,0 - 4,3395,3222,6617
MARSABIT,LOIYANGALANI,5,767,773,1540
MARSABIT,LOIYANGALANI,6,713,732,1445
MARSABIT,LOIYANGALANI,7,581,616,1197
MARSABIT,LOIYANGALANI,8,671,686,1357
MARSABIT,LOIYANGALANI,9,453,450,903
MARSABIT,LOIYANGALANI,05-Sep,3185,3257,6442
MARSABIT,LOIYANGALANI,10,893,846,1739
MARSABIT,LOIYANGALANI,11,276,332,608
MARSABIT,LOIYANGALANI,12,654,597,1251
MARSABIT,LOIYANGALANI,13,412,418,830
MARSABIT,LOIYANGALANI,14,439,379,818
MARSABIT,LOIYANGALANI,Oct-14,2674,2572,5246
MARSABIT,LOIYANGALANI,15,570,448,1018
MARSABIT,LOIYANGALANI,16,337,252,589
MARSABIT,LOIYANGALANI,17,319,218,537
MARSABIT,LOIYANGALANI,18,337,294,631
MARSABIT,LOIYANGALANI,19,215,203,418
MARSABIT,LOIYANGALANI,15-19,1778,1415,3193
MARSABIT,LOIYANGALANI,20,400,449,849
MARSABIT,LOIYANGALANI,21,177,226,403
MARSABIT,LOIYANGALANI,22,220,328,548
MARSABIT,LOIYANGALANI,23,210,302,512
MARSABIT,LOIYANGALANI,24,257,242,499
MARSABIT,LOIYANGALANI,20-24,1264,1547,2811
MARSABIT,LOIYANGALANI,25,377,445,822
MARSABIT,LOIYANGALANI,26,196,216,412
MARSABIT,LOIYANGALANI,27,157,211,368
MARSABIT,LOIYANGALANI,28,217,204,421
MARSABIT,LOIYANGALANI,29,229,296,525
MARSABIT,LOIYANGALANI,25-29,1176,1372,2548
MARSABIT,LOIYANGALANI,30,532,499,1031
MARSABIT,LOIYANGALANI,31,152,229,381
MARSABIT,LOIYANGALANI,32,189,224,413
MARSABIT,LOIYANGALANI,33,144,190,334
MARSABIT,LOIYANGALANI,34,146,185,331
MARSABIT,LOIYANGALANI,30-34,1163,1327,2490
MARSABIT,LOIYANGALANI,35,249,227,476
MARSABIT,LOIYANGALANI,36,114,171,285
MARSABIT,LOIYANGALANI,37,126,89,215
MARSABIT,LOIYANGALANI,38,89,77,166
MARSABIT,LOIYANGALANI,39,77,59,136
MARSABIT,LOIYANGALANI,35-39,655,623,1278
MARSABIT,LOIYANGALANI,40,248,200,448
MARSABIT,LOIYANGALANI,41,112,162,274
MARSABIT,LOIYANGALANI,42,92,107,199
MARSABIT,LOIYANGALANI,43,71,58,129
MARSABIT,LOIYANGALANI,44,38,25,63
MARSABIT,LOIYANGALANI,40-44,561,552,1113
MARSABIT,LOIYANGALANI,45,170,195,365
MARSABIT,LOIYANGALANI,46,75,127,202
MARSABIT,LOIYANGALANI,47,60,76,136
MARSABIT,LOIYANGALANI,48,37,64,101
MARSABIT,LOIYANGALANI,49,69,71,140
MARSABIT,LOIYANGALANI,45-49,411,533,944
MARSABIT,LOIYANGALANI,50,182,153,335
MARSABIT,LOIYANGALANI,51,52,115,167
MARSABIT,LOIYANGALANI,52,58,56,114
MARSABIT,LOIYANGALANI,53,25,24,49
MARSABIT,LOIYANGALANI,54,44,72,116
MARSABIT,LOIYANGALANI,50-54,361,420,781
MARSABIT,LOIYANGALANI,55,71,53,124
MARSABIT,LOIYANGALANI,56,49,50,99
MARSABIT,LOIYANGALANI,57,31,31,62
MARSABIT,LOIYANGALANI,58,50,44,94
MARSABIT,LOIYANGALANI,59,54,80,134
MARSABIT,LOIYANGALANI,55-59,255,258,513
MARSABIT,LOIYANGALANI,60,138,122,260
MARSABIT,LOIYANGALANI,61,31,51,82
MARSABIT,LOIYANGALANI,62,27,43,70
MARSABIT,LOIYANGALANI,63,37,42,79
MARSABIT,LOIYANGALANI,64,17,28,45
MARSABIT,LOIYANGALANI,60-64,250,286,536
MARSABIT,LOIYANGALANI,65,46,56,102
MARSABIT,LOIYANGALANI,66,18,22,40
MARSABIT,LOIYANGALANI,67,25,34,59
MARSABIT,LOIYANGALANI,68,15,16,31
MARSABIT,LOIYANGALANI,69,42,71,113
MARSABIT,LOIYANGALANI,65-69,146,199,345
MARSABIT,LOIYANGALANI,70,86,103,189
MARSABIT,LOIYANGALANI,71,34,56,90
MARSABIT,LOIYANGALANI,72,27,46,73
MARSABIT,LOIYANGALANI,73,28,34,62
MARSABIT,LOIYANGALANI,74,25,32,57
MARSABIT,LOIYANGALANI,70-74,200,271,471
MARSABIT,LOIYANGALANI,75,27,28,55
MARSABIT,LOIYANGALANI,76,13,16,29
MARSABIT,LOIYANGALANI,77,11,15,26
MARSABIT,LOIYANGALANI,78,8,10,18
MARSABIT,LOIYANGALANI,79,11,14,25
MARSABIT,LOIYANGALANI,75-79,70,83,153
MARSABIT,LOIYANGALANI,80,25,27,52
MARSABIT,LOIYANGALANI,81,7,10,17
MARSABIT,LOIYANGALANI,82,8,11,19
MARSABIT,LOIYANGALANI,83,5,3,8
MARSABIT,LOIYANGALANI,84,13,5,18
MARSABIT,LOIYANGALANI,80-84,58,56,114
MARSABIT,LOIYANGALANI,85,7,5,12
MARSABIT,LOIYANGALANI,86,3,7,10
MARSABIT,LOIYANGALANI,87,7,6,13
MARSABIT,LOIYANGALANI,88,4,-,4
MARSABIT,LOIYANGALANI,89,12,14,26
MARSABIT,LOIYANGALANI,85-89,33,32,65
MARSABIT,LOIYANGALANI,90,5,13,18
MARSABIT,LOIYANGALANI,91,1,-,1
MARSABIT,LOIYANGALANI,92,4,-,4
MARSABIT,LOIYANGALANI,93,1,2,3
MARSABIT,LOIYANGALANI,94,2,3,5
MARSABIT,LOIYANGALANI,90-94,13,18,31
MARSABIT,LOIYANGALANI,95,4,2,6
MARSABIT,LOIYANGALANI,96,2,1,3
MARSABIT,LOIYANGALANI,97,2,1,3
MARSABIT,LOIYANGALANI,98,2,1,3
MARSABIT,LOIYANGALANI,99,1,1,2
MARSABIT,LOIYANGALANI,95-99,11,6,17
MARSABIT,LOIYANGALANI,100+,-,2,2
MARSABIT,LOIYANGALANI,Not Stated,-,-,-
MARSABIT,MARSABIT CENTRAL,Total,40956,38214,79170
MARSABIT,MARSABIT CENTRAL,0,908,931,1839
MARSABIT,MARSABIT CENTRAL,1,1105,1138,2243
MARSABIT,MARSABIT CENTRAL,2,1260,1252,2512
MARSABIT,MARSABIT CENTRAL,3,1263,1256,2519
MARSABIT,MARSABIT CENTRAL,4,1264,1218,2482
MARSABIT,MARSABIT CENTRAL,0 - 4,5800,5795,11595
MARSABIT,MARSABIT CENTRAL,5,1357,1284,2641
MARSABIT,MARSABIT CENTRAL,6,1264,1134,2398
MARSABIT,MARSABIT CENTRAL,7,1178,1112,2290
MARSABIT,MARSABIT CENTRAL,8,1233,1224,2457
MARSABIT,MARSABIT CENTRAL,9,976,951,1927
MARSABIT,MARSABIT CENTRAL,05-Sep,6008,5705,11713
MARSABIT,MARSABIT CENTRAL,10,1481,1418,2899
MARSABIT,MARSABIT CENTRAL,11,805,886,1691
MARSABIT,MARSABIT CENTRAL,12,1264,1161,2425
MARSABIT,MARSABIT CENTRAL,13,1143,1041,2184
MARSABIT,MARSABIT CENTRAL,14,1139,1038,2177
MARSABIT,MARSABIT CENTRAL,Oct-14,5832,5544,11376
MARSABIT,MARSABIT CENTRAL,15,1332,1173,2505
MARSABIT,MARSABIT CENTRAL,16,1033,917,1950
MARSABIT,MARSABIT CENTRAL,17,1177,1145,2322
MARSABIT,MARSABIT CENTRAL,18,991,951,1942
MARSABIT,MARSABIT CENTRAL,19,697,675,1372
MARSABIT,MARSABIT CENTRAL,15-19,5230,4861,10091
MARSABIT,MARSABIT CENTRAL,20,1132,1155,2287
MARSABIT,MARSABIT CENTRAL,21,755,703,1458
MARSABIT,MARSABIT CENTRAL,22,721,783,1504
MARSABIT,MARSABIT CENTRAL,23,710,730,1440
MARSABIT,MARSABIT CENTRAL,24,632,652,1284
MARSABIT,MARSABIT CENTRAL,20-24,3950,4023,7973
MARSABIT,MARSABIT CENTRAL,25,1043,941,1984
MARSABIT,MARSABIT CENTRAL,26,637,520,1157
MARSABIT,MARSABIT CENTRAL,27,645,562,1207
MARSABIT,MARSABIT CENTRAL,28,657,576,1233
MARSABIT,MARSABIT CENTRAL,29,548,447,995
MARSABIT,MARSABIT CENTRAL,25-29,3530,3046,6576
MARSABIT,MARSABIT CENTRAL,30,1010,764,1774
MARSABIT,MARSABIT CENTRAL,31,393,386,779
MARSABIT,MARSABIT CENTRAL,32,531,413,944
MARSABIT,MARSABIT CENTRAL,33,419,393,812
MARSABIT,MARSABIT CENTRAL,34,352,287,639
MARSABIT,MARSABIT CENTRAL,30-34,2705,2243,4948
MARSABIT,MARSABIT CENTRAL,35,614,451,1065
MARSABIT,MARSABIT CENTRAL,36,373,300,673
MARSABIT,MARSABIT CENTRAL,37,358,309,667
MARSABIT,MARSABIT CENTRAL,38,241,209,450
MARSABIT,MARSABIT CENTRAL,39,225,142,367
MARSABIT,MARSABIT CENTRAL,35-39,1811,1411,3222
MARSABIT,MARSABIT CENTRAL,40,563,410,973
MARSABIT,MARSABIT CENTRAL,41,300,267,567
MARSABIT,MARSABIT CENTRAL,42,256,198,454
MARSABIT,MARSABIT CENTRAL,43,209,171,380
MARSABIT,MARSABIT CENTRAL,44,172,127,299
MARSABIT,MARSABIT CENTRAL,40-44,1500,1173,2673
MARSABIT,MARSABIT CENTRAL,45,477,385,862
MARSABIT,MARSABIT CENTRAL,46,190,170,360
MARSABIT,MARSABIT CENTRAL,47,229,195,424
MARSABIT,MARSABIT CENTRAL,48,169,131,300
MARSABIT,MARSABIT CENTRAL,49,128,112,240
MARSABIT,MARSABIT CENTRAL,45-49,1193,993,2186
MARSABIT,MARSABIT CENTRAL,50,320,331,651
MARSABIT,MARSABIT CENTRAL,51,136,138,274
MARSABIT,MARSABIT CENTRAL,52,164,154,318
MARSABIT,MARSABIT CENTRAL,53,87,93,180
MARSABIT,MARSABIT CENTRAL,54,152,126,278
MARSABIT,MARSABIT CENTRAL,50-54,859,842,1701
MARSABIT,MARSABIT CENTRAL,55,197,179,376
MARSABIT,MARSABIT CENTRAL,56,126,119,245
MARSABIT,MARSABIT CENTRAL,57,134,110,244
MARSABIT,MARSABIT CENTRAL,58,127,147,274
MARSABIT,MARSABIT CENTRAL,59,113,190,303
MARSABIT,MARSABIT CENTRAL,55-59,697,745,1442
MARSABIT,MARSABIT CENTRAL,60,267,241,508
MARSABIT,MARSABIT CENTRAL,61,95,112,207
MARSABIT,MARSABIT CENTRAL,62,85,84,169
MARSABIT,MARSABIT CENTRAL,63,80,69,149
MARSABIT,MARSABIT CENTRAL,64,58,65,123
MARSABIT,MARSABIT CENTRAL,60-64,585,571,1156
MARSABIT,MARSABIT CENTRAL,65,121,127,248
MARSABIT,MARSABIT CENTRAL,66,57,89,146
MARSABIT,MARSABIT CENTRAL,67,83,65,148
MARSABIT,MARSABIT CENTRAL,68,53,40,93
MARSABIT,MARSABIT CENTRAL,69,65,93,158
MARSABIT,MARSABIT CENTRAL,65-69,379,414,793
MARSABIT,MARSABIT CENTRAL,70,180,190,370
MARSABIT,MARSABIT CENTRAL,71,61,94,155
MARSABIT,MARSABIT CENTRAL,72,65,47,112
MARSABIT,MARSABIT CENTRAL,73,35,37,72
MARSABIT,MARSABIT CENTRAL,74,58,49,107
MARSABIT,MARSABIT CENTRAL,70-74,399,417,816
MARSABIT,MARSABIT CENTRAL,75,61,37,98
MARSABIT,MARSABIT CENTRAL,76,39,18,57
MARSABIT,MARSABIT CENTRAL,77,32,21,53
MARSABIT,MARSABIT CENTRAL,78,28,13,41
MARSABIT,MARSABIT CENTRAL,79,33,38,71
MARSABIT,MARSABIT CENTRAL,75-79,193,127,320
MARSABIT,MARSABIT CENTRAL,80,74,75,149
MARSABIT,MARSABIT CENTRAL,81,25,28,53
MARSABIT,MARSABIT CENTRAL,82,18,14,32
MARSABIT,MARSABIT CENTRAL,83,18,18,36
MARSABIT,MARSABIT CENTRAL,84,25,27,52
MARSABIT,MARSABIT CENTRAL,80-84,160,162,322
MARSABIT,MARSABIT CENTRAL,85,19,11,30
MARSABIT,MARSABIT CENTRAL,86,13,13,26
MARSABIT,MARSABIT CENTRAL,87,14,8,22
MARSABIT,MARSABIT CENTRAL,88,4,12,16
MARSABIT,MARSABIT CENTRAL,89,16,16,32
MARSABIT,MARSABIT CENTRAL,85-89,66,60,126
MARSABIT,MARSABIT CENTRAL,90,16,21,37
MARSABIT,MARSABIT CENTRAL,91,4,10,14
MARSABIT,MARSABIT CENTRAL,92,8,3,11
MARSABIT,MARSABIT CENTRAL,93,2,2,4
MARSABIT,MARSABIT CENTRAL,94,6,4,10
MARSABIT,MARSABIT CENTRAL,90-94,36,40,76
MARSABIT,MARSABIT CENTRAL,95,-,6,6
MARSABIT,MARSABIT CENTRAL,96,5,2,7
MARSABIT,MARSABIT CENTRAL,97,2,3,5
MARSABIT,MARSABIT CENTRAL,98,1,2,3
MARSABIT,MARSABIT CENTRAL,99,2,6,8
MARSABIT,MARSABIT CENTRAL,95-99,10,19,29
MARSABIT,MARSABIT CENTRAL,100+,12,23,35
MARSABIT,MARSABIT CENTRAL,Not Stated,1,-,1
MARSABIT,MARSABIT NORTH,Total,30091,24205,54296
MARSABIT,MARSABIT NORTH,0,566,566,1132
MARSABIT,MARSABIT NORTH,1,546,504,1050
MARSABIT,MARSABIT NORTH,2,625,608,1233
MARSABIT,MARSABIT NORTH,3,876,772,1648
MARSABIT,MARSABIT NORTH,4,773,688,1461
MARSABIT,MARSABIT NORTH,0 - 4,3386,3138,6524
MARSABIT,MARSABIT NORTH,5,882,793,1675
MARSABIT,MARSABIT NORTH,6,886,826,1712
MARSABIT,MARSABIT NORTH,7,798,730,1528
MARSABIT,MARSABIT NORTH,8,873,867,1740
MARSABIT,MARSABIT NORTH,9,694,709,1403
MARSABIT,MARSABIT NORTH,05-Sep,4133,3925,8058
MARSABIT,MARSABIT NORTH,10,1139,1113,2252
MARSABIT,MARSABIT NORTH,11,560,674,1234
MARSABIT,MARSABIT NORTH,12,1015,709,1724
MARSABIT,MARSABIT NORTH,13,761,604,1365
MARSABIT,MARSABIT NORTH,14,727,582,1309
MARSABIT,MARSABIT NORTH,Oct-14,4202,3682,7884
MARSABIT,MARSABIT NORTH,15,1111,800,1911
MARSABIT,MARSABIT NORTH,16,717,552,1269
MARSABIT,MARSABIT NORTH,17,879,558,1437
MARSABIT,MARSABIT NORTH,18,729,567,1296
MARSABIT,MARSABIT NORTH,19,525,348,873
MARSABIT,MARSABIT NORTH,15-19,3961,2825,6786
MARSABIT,MARSABIT NORTH,20,1043,731,1774
MARSABIT,MARSABIT NORTH,21,464,353,817
MARSABIT,MARSABIT NORTH,22,528,472,1000
MARSABIT,MARSABIT NORTH,23,534,425,959
MARSABIT,MARSABIT NORTH,24,476,344,820
MARSABIT,MARSABIT NORTH,20-24,3045,2325,5370
MARSABIT,MARSABIT NORTH,25,807,651,1458
MARSABIT,MARSABIT NORTH,26,446,318,764
MARSABIT,MARSABIT NORTH,27,445,327,772
MARSABIT,MARSABIT NORTH,28,543,394,937
MARSABIT,MARSABIT NORTH,29,390,315,705
MARSABIT,MARSABIT NORTH,25-29,2631,2005,4636
MARSABIT,MARSABIT NORTH,30,877,573,1450
MARSABIT,MARSABIT NORTH,31,280,265,545
MARSABIT,MARSABIT NORTH,32,391,301,692
MARSABIT,MARSABIT NORTH,33,296,224,520
MARSABIT,MARSABIT NORTH,34,285,194,479
MARSABIT,MARSABIT NORTH,30-34,2129,1557,3686
MARSABIT,MARSABIT NORTH,35,462,386,848
MARSABIT,MARSABIT NORTH,36,277,177,454
MARSABIT,MARSABIT NORTH,37,245,219,464
MARSABIT,MARSABIT NORTH,38,271,164,435
MARSABIT,MARSABIT NORTH,39,183,136,319
MARSABIT,MARSABIT NORTH,35-39,1438,1082,2520
MARSABIT,MARSABIT NORTH,40,524,309,833
MARSABIT,MARSABIT NORTH,41,212,235,447
MARSABIT,MARSABIT NORTH,42,191,147,338
MARSABIT,MARSABIT NORTH,43,191,161,352
MARSABIT,MARSABIT NORTH,44,90,78,168
MARSABIT,MARSABIT NORTH,40-44,1208,930,2138
MARSABIT,MARSABIT NORTH,45,364,251,615
MARSABIT,MARSABIT NORTH,46,145,115,260
MARSABIT,MARSABIT NORTH,47,137,108,245
MARSABIT,MARSABIT NORTH,48,148,114,262
MARSABIT,MARSABIT NORTH,49,92,72,164
MARSABIT,MARSABIT NORTH,45-49,886,660,1546
MARSABIT,MARSABIT NORTH,50,367,252,619
MARSABIT,MARSABIT NORTH,51,84,49,133
MARSABIT,MARSABIT NORTH,52,186,137,323
MARSABIT,MARSABIT NORTH,53,114,90,204
MARSABIT,MARSABIT NORTH,54,120,51,171
MARSABIT,MARSABIT NORTH,50-54,871,579,1450
MARSABIT,MARSABIT NORTH,55,124,70,194
MARSABIT,MARSABIT NORTH,56,151,76,227
MARSABIT,MARSABIT NORTH,57,98,79,177
MARSABIT,MARSABIT NORTH,58,126,68,194
MARSABIT,MARSABIT NORTH,59,78,60,138
MARSABIT,MARSABIT NORTH,55-59,577,353,930
MARSABIT,MARSABIT NORTH,60,287,222,509
MARSABIT,MARSABIT NORTH,61,66,55,121
MARSABIT,MARSABIT NORTH,62,78,62,140
MARSABIT,MARSABIT NORTH,63,71,39,110
MARSABIT,MARSABIT NORTH,64,44,31,75
MARSABIT,MARSABIT NORTH,60-64,546,409,955
MARSABIT,MARSABIT NORTH,65,100,49,149
MARSABIT,MARSABIT NORTH,66,54,37,91
MARSABIT,MARSABIT NORTH,67,42,22,64
MARSABIT,MARSABIT NORTH,68,55,25,80
MARSABIT,MARSABIT NORTH,69,36,28,64
MARSABIT,MARSABIT NORTH,65-69,287,161,448
MARSABIT,MARSABIT NORTH,70,243,148,391
MARSABIT,MARSABIT NORTH,71,18,31,49
MARSABIT,MARSABIT NORTH,72,65,36,101
MARSABIT,MARSABIT NORTH,73,32,16,48
MARSABIT,MARSABIT NORTH,74,21,12,33
MARSABIT,MARSABIT NORTH,70-74,379,243,622
MARSABIT,MARSABIT NORTH,75,35,37,72
MARSABIT,MARSABIT NORTH,76,20,16,36
MARSABIT,MARSABIT NORTH,77,15,6,21
MARSABIT,MARSABIT NORTH,78,24,10,34
MARSABIT,MARSABIT NORTH,79,15,17,32
MARSABIT,MARSABIT NORTH,75-79,109,86,195
MARSABIT,MARSABIT NORTH,80,114,78,192
MARSABIT,MARSABIT NORTH,81,19,20,39
MARSABIT,MARSABIT NORTH,82,22,19,41
MARSABIT,MARSABIT NORTH,83,8,8,16
MARSABIT,MARSABIT NORTH,84,8,5,13
MARSABIT,MARSABIT NORTH,80-84,171,130,301
MARSABIT,MARSABIT NORTH,85,14,18,32
MARSABIT,MARSABIT NORTH,86,10,6,16
MARSABIT,MARSABIT NORTH,87,6,9,15
MARSABIT,MARSABIT NORTH,88,4,3,7
MARSABIT,MARSABIT NORTH,89,4,6,10
MARSABIT,MARSABIT NORTH,85-89,38,42,80
MARSABIT,MARSABIT NORTH,90,49,28,77
MARSABIT,MARSABIT NORTH,91,6,5,11
MARSABIT,MARSABIT NORTH,92,12,12,24
MARSABIT,MARSABIT NORTH,93,3,1,4
MARSABIT,MARSABIT NORTH,94,1,1,2
MARSABIT,MARSABIT NORTH,90-94,71,47,118
MARSABIT,MARSABIT NORTH,95,4,4,8
MARSABIT,MARSABIT NORTH,96,2,1,3
MARSABIT,MARSABIT NORTH,97,1,-,1
MARSABIT,MARSABIT NORTH,98,2,4,6
MARSABIT,MARSABIT NORTH,99,1,2,3
MARSABIT,MARSABIT NORTH,95-99,10,11,21
MARSABIT,MARSABIT NORTH,100+,13,15,28
MARSABIT,MARSABIT NORTH,Not Stated,-,-,-
MARSABIT,MARSABIT SOUTH,Total,33215,32161,65376
MARSABIT,MARSABIT SOUTH,0,783,705,1488
MARSABIT,MARSABIT SOUTH,1,845,886,1731
MARSABIT,MARSABIT SOUTH,2,1114,1117,2231
MARSABIT,MARSABIT SOUTH,3,1096,1094,2190
MARSABIT,MARSABIT SOUTH,4,1229,1197,2426
MARSABIT,MARSABIT SOUTH,0 - 4,5067,4999,10066
MARSABIT,MARSABIT SOUTH,5,1244,1237,2481
MARSABIT,MARSABIT SOUTH,6,1199,1256,2455
MARSABIT,MARSABIT SOUTH,7,944,944,1888
MARSABIT,MARSABIT SOUTH,8,1297,1306,2603
MARSABIT,MARSABIT SOUTH,9,898,906,1804
MARSABIT,MARSABIT SOUTH,05-Sep,5582,5649,11231
MARSABIT,MARSABIT SOUTH,10,1697,1648,3345
MARSABIT,MARSABIT SOUTH,11,750,756,1506
MARSABIT,MARSABIT SOUTH,12,1447,1201,2648
MARSABIT,MARSABIT SOUTH,13,875,801,1676
MARSABIT,MARSABIT SOUTH,14,1019,817,1836
MARSABIT,MARSABIT SOUTH,Oct-14,5788,5223,11011
MARSABIT,MARSABIT SOUTH,15,1233,976,2209
MARSABIT,MARSABIT SOUTH,16,849,642,1491
MARSABIT,MARSABIT SOUTH,17,719,424,1143
MARSABIT,MARSABIT SOUTH,18,807,648,1455
MARSABIT,MARSABIT SOUTH,19,497,455,952
MARSABIT,MARSABIT SOUTH,15-19,4105,3145,7250
MARSABIT,MARSABIT SOUTH,20,997,901,1898
MARSABIT,MARSABIT SOUTH,21,415,444,859
MARSABIT,MARSABIT SOUTH,22,553,688,1241
MARSABIT,MARSABIT SOUTH,23,480,616,1096
MARSABIT,MARSABIT SOUTH,24,450,503,953
MARSABIT,MARSABIT SOUTH,20-24,2895,3152,6047
MARSABIT,MARSABIT SOUTH,25,725,775,1500
MARSABIT,MARSABIT SOUTH,26,379,457,836
MARSABIT,MARSABIT SOUTH,27,364,313,677
MARSABIT,MARSABIT SOUTH,28,421,462,883
MARSABIT,MARSABIT SOUTH,29,364,316,680
MARSABIT,MARSABIT SOUTH,25-29,2253,2323,4576
MARSABIT,MARSABIT SOUTH,30,900,761,1661
MARSABIT,MARSABIT SOUTH,31,280,490,770
MARSABIT,MARSABIT SOUTH,32,344,428,772
MARSABIT,MARSABIT SOUTH,33,248,411,659
MARSABIT,MARSABIT SOUTH,34,206,277,483
MARSABIT,MARSABIT SOUTH,30-34,1978,2367,4345
MARSABIT,MARSABIT SOUTH,35,493,457,950
MARSABIT,MARSABIT SOUTH,36,171,188,359
MARSABIT,MARSABIT SOUTH,37,164,128,292
MARSABIT,MARSABIT SOUTH,38,161,104,265
MARSABIT,MARSABIT SOUTH,39,185,112,297
MARSABIT,MARSABIT SOUTH,35-39,1174,989,2163
MARSABIT,MARSABIT SOUTH,40,548,303,851
MARSABIT,MARSABIT SOUTH,41,279,186,465
MARSABIT,MARSABIT SOUTH,42,217,174,391
MARSABIT,MARSABIT SOUTH,43,131,95,226
MARSABIT,MARSABIT SOUTH,44,51,57,108
MARSABIT,MARSABIT SOUTH,40-44,1226,815,2041
MARSABIT,MARSABIT SOUTH,45,310,275,585
MARSABIT,MARSABIT SOUTH,46,137,248,385
MARSABIT,MARSABIT SOUTH,47,91,129,220
MARSABIT,MARSABIT SOUTH,48,77,100,177
MARSABIT,MARSABIT SOUTH,49,110,128,238
MARSABIT,MARSABIT SOUTH,45-49,725,880,1605
MARSABIT,MARSABIT SOUTH,50,312,324,636
MARSABIT,MARSABIT SOUTH,51,87,110,197
MARSABIT,MARSABIT SOUTH,52,114,105,219
MARSABIT,MARSABIT SOUTH,53,56,61,117
MARSABIT,MARSABIT SOUTH,54,81,76,157
MARSABIT,MARSABIT SOUTH,50-54,650,676,1326
MARSABIT,MARSABIT SOUTH,55,105,74,179
MARSABIT,MARSABIT SOUTH,56,78,82,160
MARSABIT,MARSABIT SOUTH,57,54,47,101
MARSABIT,MARSABIT SOUTH,58,73,86,159
MARSABIT,MARSABIT SOUTH,59,80,113,193
MARSABIT,MARSABIT SOUTH,55-59,390,402,792
MARSABIT,MARSABIT SOUTH,60,234,206,440
MARSABIT,MARSABIT SOUTH,61,59,73,132
MARSABIT,MARSABIT SOUTH,62,49,52,101
MARSABIT,MARSABIT SOUTH,63,44,74,118
MARSABIT,MARSABIT SOUTH,64,39,64,103
MARSABIT,MARSABIT SOUTH,60-64,425,469,894
MARSABIT,MARSABIT SOUTH,65,80,80,160
MARSABIT,MARSABIT SOUTH,66,26,41,67
MARSABIT,MARSABIT SOUTH,67,39,52,91
MARSABIT,MARSABIT SOUTH,68,49,51,100
MARSABIT,MARSABIT SOUTH,69,67,120,187
MARSABIT,MARSABIT SOUTH,65-69,261,344,605
MARSABIT,MARSABIT SOUTH,70,164,182,346
MARSABIT,MARSABIT SOUTH,71,60,61,121
MARSABIT,MARSABIT SOUTH,72,41,34,75
MARSABIT,MARSABIT SOUTH,73,32,46,78
MARSABIT,MARSABIT SOUTH,74,43,35,78
MARSABIT,MARSABIT SOUTH,70-74,340,358,698
MARSABIT,MARSABIT SOUTH,75,51,28,79
MARSABIT,MARSABIT SOUTH,76,20,21,41
MARSABIT,MARSABIT SOUTH,77,18,18,36
MARSABIT,MARSABIT SOUTH,78,18,25,43
MARSABIT,MARSABIT SOUTH,79,31,41,72
MARSABIT,MARSABIT SOUTH,75-79,138,133,271
MARSABIT,MARSABIT SOUTH,80,64,68,132
MARSABIT,MARSABIT SOUTH,81,21,21,42
MARSABIT,MARSABIT SOUTH,82,24,11,35
MARSABIT,MARSABIT SOUTH,83,7,11,18
MARSABIT,MARSABIT SOUTH,84,11,20,31
MARSABIT,MARSABIT SOUTH,80-84,127,131,258
MARSABIT,MARSABIT SOUTH,85,11,11,22
MARSABIT,MARSABIT SOUTH,86,15,7,22
MARSABIT,MARSABIT SOUTH,87,13,12,25
MARSABIT,MARSABIT SOUTH,88,4,1,5
MARSABIT,MARSABIT SOUTH,89,13,26,39
MARSABIT,MARSABIT SOUTH,85-89,56,57,113
MARSABIT,MARSABIT SOUTH,90,10,17,27
MARSABIT,MARSABIT SOUTH,91,5,6,11
MARSABIT,MARSABIT SOUTH,92,3,2,5
MARSABIT,MARSABIT SOUTH,93,2,3,5
MARSABIT,MARSABIT SOUTH,94,1,6,7
MARSABIT,MARSABIT SOUTH,90-94,21,34,55
MARSABIT,MARSABIT SOUTH,95,3,4,7
MARSABIT,MARSABIT SOUTH,96,3,3,6
MARSABIT,MARSABIT SOUTH,97,1,2,3
MARSABIT,MARSABIT SOUTH,98,1,1,2
MARSABIT,MARSABIT SOUTH,99,2,-,2
MARSABIT,MARSABIT SOUTH,95-99,10,10,20
MARSABIT,MARSABIT SOUTH,100+,3,5,8
MARSABIT,MARSABIT SOUTH,Not Stated,1,-,1
MARSABIT,MOYALE,Total,56440,52508,108948
MARSABIT,MOYALE,0,1390,1470,2860
MARSABIT,MOYALE,1,1645,1538,3183
MARSABIT,MOYALE,2,2251,2176,4427
MARSABIT,MOYALE,3,1936,1910,3846
MARSABIT,MOYALE,4,2462,2183,4645
MARSABIT,MOYALE,0 - 4,9684,9277,18961
MARSABIT,MOYALE,5,1852,1801,3653
MARSABIT,MOYALE,6,2382,2272,4654
MARSABIT,MOYALE,7,1667,1640,3307
MARSABIT,MOYALE,8,2355,2387,4742
MARSABIT,MOYALE,9,1377,1365,2742
MARSABIT,MOYALE,05-Sep,9633,9465,19098
MARSABIT,MOYALE,10,2544,2365,4909
MARSABIT,MOYALE,11,1139,1286,2425
MARSABIT,MOYALE,12,2220,1790,4010
MARSABIT,MOYALE,13,1560,1259,2819
MARSABIT,MOYALE,14,1804,1528,3332
MARSABIT,MOYALE,Oct-14,9267,8228,17495
MARSABIT,MOYALE,15,1989,1516,3505
MARSABIT,MOYALE,16,1710,1431,3141
MARSABIT,MOYALE,17,1815,1292,3107
MARSABIT,MOYALE,18,1745,1512,3257
MARSABIT,MOYALE,19,867,797,1664
MARSABIT,MOYALE,15-19,8126,6548,14674
MARSABIT,MOYALE,20,1699,1562,3261
MARSABIT,MOYALE,21,703,659,1362
MARSABIT,MOYALE,22,912,890,1802
MARSABIT,MOYALE,23,722,866,1588
MARSABIT,MOYALE,24,724,780,1504
MARSABIT,MOYALE,20-24,4760,4757,9517
MARSABIT,MOYALE,25,1205,1241,2446
MARSABIT,MOYALE,26,657,653,1310
MARSABIT,MOYALE,27,701,745,1446
MARSABIT,MOYALE,28,631,626,1257
MARSABIT,MOYALE,29,554,522,1076
MARSABIT,MOYALE,25-29,3748,3787,7535
MARSABIT,MOYALE,30,1175,1079,2254
MARSABIT,MOYALE,31,347,368,715
MARSABIT,MOYALE,32,540,495,1035
MARSABIT,MOYALE,33,382,331,713
MARSABIT,MOYALE,34,358,378,736
MARSABIT,MOYALE,30-34,2802,2651,5453
MARSABIT,MOYALE,35,711,650,1361
MARSABIT,MOYALE,36,377,351,728
MARSABIT,MOYALE,37,313,281,594
MARSABIT,MOYALE,38,276,272,548
MARSABIT,MOYALE,39,189,167,356
MARSABIT,MOYALE,35-39,1866,1721,3587
MARSABIT,MOYALE,40,694,547,1241
MARSABIT,MOYALE,41,368,424,792
MARSABIT,MOYALE,42,259,174,433
MARSABIT,MOYALE,43,212,199,411
MARSABIT,MOYALE,44,157,157,314
MARSABIT,MOYALE,40-44,1690,1501,3191
MARSABIT,MOYALE,45,437,411,848
MARSABIT,MOYALE,46,189,159,348
MARSABIT,MOYALE,47,247,188,435
MARSABIT,MOYALE,48,142,117,259
MARSABIT,MOYALE,49,132,117,249
MARSABIT,MOYALE,45-49,1147,992,2139
MARSABIT,MOYALE,50,400,342,742
MARSABIT,MOYALE,51,142,154,296
MARSABIT,MOYALE,52,136,120,256
MARSABIT,MOYALE,53,100,101,201
MARSABIT,MOYALE,54,177,122,299
MARSABIT,MOYALE,50-54,955,839,1794
MARSABIT,MOYALE,55,199,197,396
MARSABIT,MOYALE,56,119,106,225
MARSABIT,MOYALE,57,128,148,276
MARSABIT,MOYALE,58,113,127,240
MARSABIT,MOYALE,59,149,186,335
MARSABIT,MOYALE,55-59,708,764,1472
MARSABIT,MOYALE,60,325,262,587
MARSABIT,MOYALE,61,112,149,261
MARSABIT,MOYALE,62,97,79,176
MARSABIT,MOYALE,63,94,78,172
MARSABIT,MOYALE,64,80,58,138
MARSABIT,MOYALE,60-64,708,626,1334
MARSABIT,MOYALE,65,142,112,254
MARSABIT,MOYALE,66,67,85,152
MARSABIT,MOYALE,67,84,55,139
MARSABIT,MOYALE,68,70,44,114
MARSABIT,MOYALE,69,87,63,150
MARSABIT,MOYALE,65-69,450,359,809
MARSABIT,MOYALE,70,192,193,385
MARSABIT,MOYALE,71,68,117,185
MARSABIT,MOYALE,72,44,43,87
MARSABIT,MOYALE,73,29,26,55
MARSABIT,MOYALE,74,42,34,76
MARSABIT,MOYALE,70-74,375,413,788
MARSABIT,MOYALE,75,59,59,118
MARSABIT,MOYALE,76,33,52,85
MARSABIT,MOYALE,77,29,18,47
MARSABIT,MOYALE,78,31,24,55
MARSABIT,MOYALE,79,35,49,84
MARSABIT,MOYALE,75-79,187,202,389
MARSABIT,MOYALE,80,98,117,215
MARSABIT,MOYALE,81,25,70,95
MARSABIT,MOYALE,82,24,8,32
MARSABIT,MOYALE,83,12,11,23
MARSABIT,MOYALE,84,16,16,32
MARSABIT,MOYALE,80-84,175,222,397
MARSABIT,MOYALE,85,21,19,40
MARSABIT,MOYALE,86,15,15,30
MARSABIT,MOYALE,87,9,4,13
MARSABIT,MOYALE,88,14,3,17
MARSABIT,MOYALE,89,19,20,39
MARSABIT,MOYALE,85-89,78,61,139
MARSABIT,MOYALE,90,29,30,59
MARSABIT,MOYALE,91,8,17,25
MARSABIT,MOYALE,92,9,5,14
MARSABIT,MOYALE,93,3,1,4
MARSABIT,MOYALE,94,5,3,8
MARSABIT,MOYALE,90-94,54,56,110
MARSABIT,MOYALE,95,3,6,9
MARSABIT,MOYALE,96,-,4,4
MARSABIT,MOYALE,97,2,1,3
MARSABIT,MOYALE,98,2,7,9
MARSABIT,MOYALE,99,5,1,6
MARSABIT,MOYALE,95-99,12,19,31
MARSABIT,MOYALE,100+,14,20,34
MARSABIT,MOYALE,Not Stated,1,-,1
MARSABIT,NORTH HORR,Total,41719,29726,71445
MARSABIT,NORTH HORR,0,666,632,1298
MARSABIT,NORTH HORR,1,724,618,1342
MARSABIT,NORTH HORR,2,881,777,1658
MARSABIT,NORTH HORR,3,1075,1036,2111
MARSABIT,NORTH HORR,4,1021,953,1974
MARSABIT,NORTH HORR,0 - 4,4367,4016,8383
MARSABIT,NORTH HORR,5,1171,1043,2214
MARSABIT,NORTH HORR,6,1168,1021,2189
MARSABIT,NORTH HORR,7,1175,1022,2197
MARSABIT,NORTH HORR,8,1241,1118,2359
MARSABIT,NORTH HORR,9,1035,914,1949
MARSABIT,NORTH HORR,05-Sep,5790,5118,10908
MARSABIT,NORTH HORR,10,1731,1454,3185
MARSABIT,NORTH HORR,11,785,785,1570
MARSABIT,NORTH HORR,12,1507,945,2452
MARSABIT,NORTH HORR,13,1070,757,1827
MARSABIT,NORTH HORR,14,1105,746,1851
MARSABIT,NORTH HORR,Oct-14,6198,4687,10885
MARSABIT,NORTH HORR,15,1645,988,2633
MARSABIT,NORTH HORR,16,1084,731,1815
MARSABIT,NORTH HORR,17,1060,628,1688
MARSABIT,NORTH HORR,18,1254,701,1955
MARSABIT,NORTH HORR,19,842,478,1320
MARSABIT,NORTH HORR,15-19,5885,3526,9411
MARSABIT,NORTH HORR,20,1669,930,2599
MARSABIT,NORTH HORR,21,742,411,1153
MARSABIT,NORTH HORR,22,752,448,1200
MARSABIT,NORTH HORR,23,793,355,1148
MARSABIT,NORTH HORR,24,782,443,1225
MARSABIT,NORTH HORR,20-24,4738,2587,7325
MARSABIT,NORTH HORR,25,1169,705,1874
MARSABIT,NORTH HORR,26,635,390,1025
MARSABIT,NORTH HORR,27,537,327,864
MARSABIT,NORTH HORR,28,751,488,1239
MARSABIT,NORTH HORR,29,520,344,864
MARSABIT,NORTH HORR,25-29,3612,2254,5866
MARSABIT,NORTH HORR,30,1293,887,2180
MARSABIT,NORTH HORR,31,355,297,652
MARSABIT,NORTH HORR,32,506,316,822
MARSABIT,NORTH HORR,33,350,239,589
MARSABIT,NORTH HORR,34,309,225,534
MARSABIT,NORTH HORR,30-34,2813,1964,4777
MARSABIT,NORTH HORR,35,610,431,1041
MARSABIT,NORTH HORR,36,315,274,589
MARSABIT,NORTH HORR,37,265,193,458
MARSABIT,NORTH HORR,38,331,254,585
MARSABIT,NORTH HORR,39,235,196,431
MARSABIT,NORTH HORR,35-39,1756,1348,3104
MARSABIT,NORTH HORR,40,886,563,1449
MARSABIT,NORTH HORR,41,261,201,462
MARSABIT,NORTH HORR,42,276,158,434
MARSABIT,NORTH HORR,43,228,147,375
MARSABIT,NORTH HORR,44,99,78,177
MARSABIT,NORTH HORR,40-44,1750,1147,2897
MARSABIT,NORTH HORR,45,459,307,766
MARSABIT,NORTH HORR,46,185,128,313
MARSABIT,NORTH HORR,47,151,103,254
MARSABIT,NORTH HORR,48,225,107,332
MARSABIT,NORTH HORR,49,132,96,228
MARSABIT,NORTH HORR,45-49,1152,741,1893
MARSABIT,NORTH HORR,50,629,351,980
MARSABIT,NORTH HORR,51,101,59,160
MARSABIT,NORTH HORR,52,183,106,289
MARSABIT,NORTH HORR,53,104,58,162
MARSABIT,NORTH HORR,54,91,61,152
MARSABIT,NORTH HORR,50-54,1108,635,1743
MARSABIT,NORTH HORR,55,169,124,293
MARSABIT,NORTH HORR,56,134,74,208
MARSABIT,NORTH HORR,57,99,63,162
MARSABIT,NORTH HORR,58,98,76,174
MARSABIT,NORTH HORR,59,72,46,118
MARSABIT,NORTH HORR,55-59,572,383,955
MARSABIT,NORTH HORR,60,412,248,660
MARSABIT,NORTH HORR,61,72,62,134
MARSABIT,NORTH HORR,62,78,50,128
MARSABIT,NORTH HORR,63,60,35,95
MARSABIT,NORTH HORR,64,43,18,61
MARSABIT,NORTH HORR,60-64,665,413,1078
MARSABIT,NORTH HORR,65,112,97,209
MARSABIT,NORTH HORR,66,43,37,80
MARSABIT,NORTH HORR,67,70,34,104
MARSABIT,NORTH HORR,68,44,36,80
MARSABIT,NORTH HORR,69,40,32,72
MARSABIT,NORTH HORR,65-69,309,236,545
MARSABIT,NORTH HORR,70,318,208,526
MARSABIT,NORTH HORR,71,46,37,83
MARSABIT,NORTH HORR,72,54,36,90
MARSABIT,NORTH HORR,73,37,16,53
MARSABIT,NORTH HORR,74,26,18,44
MARSABIT,NORTH HORR,70-74,481,315,796
MARSABIT,NORTH HORR,75,68,41,109
MARSABIT,NORTH HORR,76,35,17,52
MARSABIT,NORTH HORR,77,27,12,39
MARSABIT,NORTH HORR,78,19,11,30
MARSABIT,NORTH HORR,79,13,17,30
MARSABIT,NORTH HORR,75-79,162,98,260
MARSABIT,NORTH HORR,80,123,93,216
MARSABIT,NORTH HORR,81,23,17,40
MARSABIT,NORTH HORR,82,16,10,26
MARSABIT,NORTH HORR,83,8,7,15
MARSABIT,NORTH HORR,84,7,9,16
MARSABIT,NORTH HORR,80-84,177,136,313
MARSABIT,NORTH HORR,85,26,16,42
MARSABIT,NORTH HORR,86,6,3,9
MARSABIT,NORTH HORR,87,8,7,15
MARSABIT,NORTH HORR,88,9,5,14
MARSABIT,NORTH HORR,89,6,4,10
MARSABIT,NORTH HORR,85-89,55,35,90
MARSABIT,NORTH HORR,90,69,45,114
MARSABIT,NORTH HORR,91,9,5,14
MARSABIT,NORTH HORR,92,3,5,8
MARSABIT,NORTH HORR,93,-,2,2
MARSABIT,NORTH HORR,94,2,1,3
MARSABIT,NORTH HORR,90-94,83,58,141
MARSABIT,NORTH HORR,95,8,4,12
MARSABIT,NORTH HORR,96,4,2,6
MARSABIT,NORTH HORR,97,-,-,-
MARSABIT,NORTH HORR,98,3,1,4
MARSABIT,NORTH HORR,99,2,1,3
MARSABIT,NORTH HORR,95-99,17,8,25
MARSABIT,NORTH HORR,100+,28,19,47
MARSABIT,NORTH HORR,Not Stated,1,2,3
MARSABIT,SOLOLO,Total,23468,21354,44822
MARSABIT,SOLOLO,0,476,436,912
MARSABIT,SOLOLO,1,621,624,1245
MARSABIT,SOLOLO,2,813,759,1572
MARSABIT,SOLOLO,3,710,773,1483
MARSABIT,SOLOLO,4,877,925,1802
MARSABIT,SOLOLO,0 - 4,3497,3517,7014
MARSABIT,SOLOLO,5,759,774,1533
MARSABIT,SOLOLO,6,913,881,1794
MARSABIT,SOLOLO,7,701,662,1363
MARSABIT,SOLOLO,8,981,987,1968
MARSABIT,SOLOLO,9,550,558,1108
MARSABIT,SOLOLO,05-Sep,3904,3862,7766
MARSABIT,SOLOLO,10,1240,1057,2297
MARSABIT,SOLOLO,11,484,571,1055
MARSABIT,SOLOLO,12,980,698,1678
MARSABIT,SOLOLO,13,585,584,1169
MARSABIT,SOLOLO,14,699,636,1335
MARSABIT,SOLOLO,Oct-14,3988,3546,7534
MARSABIT,SOLOLO,15,910,721,1631
MARSABIT,SOLOLO,16,680,505,1185
MARSABIT,SOLOLO,17,739,471,1210
MARSABIT,SOLOLO,18,668,587,1255
MARSABIT,SOLOLO,19,276,237,513
MARSABIT,SOLOLO,15-19,3273,2521,5794
MARSABIT,SOLOLO,20,791,608,1399
MARSABIT,SOLOLO,21,288,297,585
MARSABIT,SOLOLO,22,392,323,715
MARSABIT,SOLOLO,23,334,317,651
MARSABIT,SOLOLO,24,288,273,561
MARSABIT,SOLOLO,20-24,2093,1818,3911
MARSABIT,SOLOLO,25,574,471,1045
MARSABIT,SOLOLO,26,286,245,531
MARSABIT,SOLOLO,27,286,226,512
MARSABIT,SOLOLO,28,283,203,486
MARSABIT,SOLOLO,29,193,207,400
MARSABIT,SOLOLO,25-29,1622,1352,2974
MARSABIT,SOLOLO,30,564,424,988
MARSABIT,SOLOLO,31,131,141,272
MARSABIT,SOLOLO,32,178,164,342
MARSABIT,SOLOLO,33,166,157,323
MARSABIT,SOLOLO,34,114,118,232
MARSABIT,SOLOLO,30-34,1153,1004,2157
MARSABIT,SOLOLO,35,282,270,552
MARSABIT,SOLOLO,36,129,141,270
MARSABIT,SOLOLO,37,173,165,338
MARSABIT,SOLOLO,38,108,126,234
MARSABIT,SOLOLO,39,80,81,161
MARSABIT,SOLOLO,35-39,772,783,1555
MARSABIT,SOLOLO,40,344,256,600
MARSABIT,SOLOLO,41,149,221,370
MARSABIT,SOLOLO,42,118,74,192
MARSABIT,SOLOLO,43,109,92,201
MARSABIT,SOLOLO,44,63,36,99
MARSABIT,SOLOLO,40-44,783,679,1462
MARSABIT,SOLOLO,45,189,209,398
MARSABIT,SOLOLO,46,77,57,134
MARSABIT,SOLOLO,47,76,51,127
MARSABIT,SOLOLO,48,59,44,103
MARSABIT,SOLOLO,49,51,49,100
MARSABIT,SOLOLO,45-49,452,410,862
MARSABIT,SOLOLO,50,182,174,356
MARSABIT,SOLOLO,51,53,78,131
MARSABIT,SOLOLO,52,76,86,162
MARSABIT,SOLOLO,53,53,58,111
MARSABIT,SOLOLO,54,73,103,176
MARSABIT,SOLOLO,50-54,437,499,936
MARSABIT,SOLOLO,55,134,132,266
MARSABIT,SOLOLO,56,54,69,123
MARSABIT,SOLOLO,57,58,82,140
MARSABIT,SOLOLO,58,55,64,119
MARSABIT,SOLOLO,59,66,75,141
MARSABIT,SOLOLO,55-59,367,422,789
MARSABIT,SOLOLO,60,184,129,313
MARSABIT,SOLOLO,61,49,68,117
MARSABIT,SOLOLO,62,39,39,78
MARSABIT,SOLOLO,63,42,46,88
MARSABIT,SOLOLO,64,33,22,55
MARSABIT,SOLOLO,60-64,347,304,651
MARSABIT,SOLOLO,65,100,64,164
MARSABIT,SOLOLO,66,37,38,75
MARSABIT,SOLOLO,67,46,30,76
MARSABIT,SOLOLO,68,40,19,59
MARSABIT,SOLOLO,69,38,56,94
MARSABIT,SOLOLO,65-69,261,207,468
MARSABIT,SOLOLO,70,134,92,226
MARSABIT,SOLOLO,71,34,45,79
MARSABIT,SOLOLO,72,38,11,49
MARSABIT,SOLOLO,73,23,15,38
MARSABIT,SOLOLO,74,19,14,33
MARSABIT,SOLOLO,70-74,248,177,425
MARSABIT,SOLOLO,75,24,31,55
MARSABIT,SOLOLO,76,13,13,26
MARSABIT,SOLOLO,77,11,7,18
MARSABIT,SOLOLO,78,12,12,24
MARSABIT,SOLOLO,79,16,16,32
MARSABIT,SOLOLO,75-79,76,79,155
MARSABIT,SOLOLO,80,51,54,105
MARSABIT,SOLOLO,81,19,31,50
MARSABIT,SOLOLO,82,14,15,29
MARSABIT,SOLOLO,83,8,4,12
MARSABIT,SOLOLO,84,10,9,19
MARSABIT,SOLOLO,80-84,102,113,215
MARSABIT,SOLOLO,85,11,6,17
MARSABIT,SOLOLO,86,10,8,18
MARSABIT,SOLOLO,87,5,6,11
MARSABIT,SOLOLO,88,5,-,5
MARSABIT,SOLOLO,89,8,13,21
MARSABIT,SOLOLO,85-89,39,33,72
MARSABIT,SOLOLO,90,16,6,22
MARSABIT,SOLOLO,91,8,3,11
MARSABIT,SOLOLO,92,5,1,6
MARSABIT,SOLOLO,93,3,4,7
MARSABIT,SOLOLO,94,4,1,5
MARSABIT,SOLOLO,90-94,36,15,51
MARSABIT,SOLOLO,95,4,5,9
MARSABIT,SOLOLO,96,2,-,2
MARSABIT,SOLOLO,97,4,-,4
MARSABIT,SOLOLO,98,3,1,4
MARSABIT,SOLOLO,99,1,1,2
MARSABIT,SOLOLO,95-99,14,7,21
MARSABIT,SOLOLO,100+,4,6,10
MARSABIT,SOLOLO,Not Stated,-,-,-
MERU,ALL,Total,767698,777975,1545673
MERU,ALL,0,15548,15670,31218
MERU,ALL,1,17210,16949,34159
MERU,ALL,2,17143,17099,34242
MERU,ALL,3,17974,17913,35887
MERU,ALL,4,17509,17247,34756
MERU,ALL,0 - 4,85384,84878,170262
MERU,ALL,5,17623,16846,34469
MERU,ALL,6,17603,17418,35021
MERU,ALL,7,17585,17241,34826
MERU,ALL,8,16659,16942,33601
MERU,ALL,9,18512,18621,37133
MERU,ALL,05-Sep,87982,87068,175050
MERU,ALL,10,20343,19535,39878
MERU,ALL,11,17689,18241,35930
MERU,ALL,12,20144,19732,39876
MERU,ALL,13,20349,20559,40908
MERU,ALL,14,19317,19013,38330
MERU,ALL,Oct-14,97842,97080,194922
MERU,ALL,15,18461,18591,37052
MERU,ALL,16,16680,17304,33984
MERU,ALL,17,16911,16893,33804
MERU,ALL,18,14479,14840,29319
MERU,ALL,19,15335,15757,31092
MERU,ALL,15-19,81866,83385,165251
MERU,ALL,20,15365,15960,31325
MERU,ALL,21,12087,13021,25108
MERU,ALL,22,12819,13013,25832
MERU,ALL,23,12808,13370,26178
MERU,ALL,24,11855,11812,23667
MERU,ALL,20-24,64934,67176,132110
MERU,ALL,25,14035,13267,27302
MERU,ALL,26,10440,10918,21358
MERU,ALL,27,11501,11543,23044
MERU,ALL,28,10201,10256,20457
MERU,ALL,29,10191,10478,20669
MERU,ALL,25-29,56368,56462,112830
MERU,ALL,30,15926,16011,31937
MERU,ALL,31,9362,9449,18811
MERU,ALL,32,11876,12891,24767
MERU,ALL,33,10661,11918,22579
MERU,ALL,34,9257,10159,19416
MERU,ALL,30-34,57082,60428,117510
MERU,ALL,35,16901,16646,33547
MERU,ALL,36,9037,8778,17815
MERU,ALL,37,9892,8826,18718
MERU,ALL,38,7832,7968,15800
MERU,ALL,39,9341,8735,18076
MERU,ALL,35-39,53003,50953,103956
MERU,ALL,40,13958,12926,26884
MERU,ALL,41,9031,7708,16739
MERU,ALL,42,8327,7307,15634
MERU,ALL,43,7071,7005,14076
MERU,ALL,44,6535,6178,12713
MERU,ALL,40-44,44922,41124,86046
MERU,ALL,45,10280,9794,20074
MERU,ALL,46,7022,6802,13824
MERU,ALL,47,6861,6788,13649
MERU,ALL,48,5264,5318,10582
MERU,ALL,49,6388,6444,12832
MERU,ALL,45-49,35815,35146,70961
MERU,ALL,50,8746,9238,17984
MERU,ALL,51,5264,4607,9871
MERU,ALL,52,4090,3483,7573
MERU,ALL,53,2953,2741,5694
MERU,ALL,54,3707,3280,6987
MERU,ALL,50-54,24760,23349,48109
MERU,ALL,55,5055,4883,9938
MERU,ALL,56,5395,5340,10735
MERU,ALL,57,4064,4783,8847
MERU,ALL,58,3730,3960,7690
MERU,ALL,59,4192,4589,8781
MERU,ALL,55-59,22436,23555,45991
MERU,ALL,60,6204,7076,13280
MERU,ALL,61,3291,3463,6754
MERU,ALL,62,3071,3006,6077
MERU,ALL,63,2756,2940,5696
MERU,ALL,64,1975,2156,4131
MERU,ALL,60-64,17297,18641,35938
MERU,ALL,65,3909,4642,8551
MERU,ALL,66,1960,2128,4088
MERU,ALL,67,3524,3575,7099
MERU,ALL,68,1883,1809,3692
MERU,ALL,69,2745,3265,6010
MERU,ALL,65-69,14021,15419,29440
MERU,ALL,70,4702,6546,11248
MERU,ALL,71,1890,2083,3973
MERU,ALL,72,1887,1889,3776
MERU,ALL,73,1294,1408,2702
MERU,ALL,74,1184,1756,2940
MERU,ALL,70-74,10957,13682,24639
MERU,ALL,75,1508,1953,3461
MERU,ALL,76,808,859,1667
MERU,ALL,77,1171,1272,2443
MERU,ALL,78,858,808,1666
MERU,ALL,79,949,1821,2770
MERU,ALL,75-79,5294,6713,12007
MERU,ALL,80,1695,3241,4936
MERU,ALL,81,565,746,1311
MERU,ALL,82,547,574,1121
MERU,ALL,83,541,650,1191
MERU,ALL,84,561,863,1424
MERU,ALL,80-84,3909,6074,9983
MERU,ALL,85,631,914,1545
MERU,ALL,86,413,381,794
MERU,ALL,87,359,506,865
MERU,ALL,88,224,280,504
MERU,ALL,89,444,1136,1580
MERU,ALL,85-89,2071,3217,5288
MERU,ALL,90,455,1032,1487
MERU,ALL,91,156,287,443
MERU,ALL,92,111,175,286
MERU,ALL,93,97,157,254
MERU,ALL,94,107,250,357
MERU,ALL,90-94,926,1901,2827
MERU,ALL,95,174,314,488
MERU,ALL,96,63,107,170
MERU,ALL,97,100,122,222
MERU,ALL,98,66,90,156
MERU,ALL,99,115,293,408
MERU,ALL,95-99,518,926,1444
MERU,ALL,100+,295,784,1079
MERU,ALL,Not Stated,16,14,30
MERU,BUURI EAST,Total,38101,38497,76598
MERU,BUURI EAST,0,674,638,1312
MERU,BUURI EAST,1,731,697,1428
MERU,BUURI EAST,2,734,722,1456
MERU,BUURI EAST,3,768,785,1553
MERU,BUURI EAST,4,695,748,1443
MERU,BUURI EAST,0 - 4,3602,3590,7192
MERU,BUURI EAST,5,729,667,1396
MERU,BUURI EAST,6,788,755,1543
MERU,BUURI EAST,7,716,746,1462
MERU,BUURI EAST,8,686,699,1385
MERU,BUURI EAST,9,791,804,1595
MERU,BUURI EAST,05-Sep,3710,3671,7381
MERU,BUURI EAST,10,865,827,1692
MERU,BUURI EAST,11,740,788,1528
MERU,BUURI EAST,12,879,915,1794
MERU,BUURI EAST,13,978,902,1880
MERU,BUURI EAST,14,885,839,1724
MERU,BUURI EAST,Oct-14,4347,4271,8618
MERU,BUURI EAST,15,890,818,1708
MERU,BUURI EAST,16,789,773,1562
MERU,BUURI EAST,17,861,755,1616
MERU,BUURI EAST,18,709,593,1302
MERU,BUURI EAST,19,721,660,1381
MERU,BUURI EAST,15-19,3970,3599,7569
MERU,BUURI EAST,20,650,623,1273
MERU,BUURI EAST,21,559,480,1039
MERU,BUURI EAST,22,552,537,1089
MERU,BUURI EAST,23,620,553,1173
MERU,BUURI EAST,24,540,487,1027
MERU,BUURI EAST,20-24,2921,2680,5601
MERU,BUURI EAST,25,568,507,1075
MERU,BUURI EAST,26,485,450,935
MERU,BUURI EAST,27,503,499,1002
MERU,BUURI EAST,28,414,459,873
MERU,BUURI EAST,29,489,494,983
MERU,BUURI EAST,25-29,2459,2409,4868
MERU,BUURI EAST,30,685,700,1385
MERU,BUURI EAST,31,445,440,885
MERU,BUURI EAST,32,542,624,1166
MERU,BUURI EAST,33,521,587,1108
MERU,BUURI EAST,34,528,543,1071
MERU,BUURI EAST,30-34,2721,2894,5615
MERU,BUURI EAST,35,776,754,1530
MERU,BUURI EAST,36,504,548,1052
MERU,BUURI EAST,37,553,455,1008
MERU,BUURI EAST,38,434,462,896
MERU,BUURI EAST,39,571,587,1158
MERU,BUURI EAST,35-39,2838,2806,5644
MERU,BUURI EAST,40,748,739,1487
MERU,BUURI EAST,41,487,424,911
MERU,BUURI EAST,42,493,433,926
MERU,BUURI EAST,43,389,440,829
MERU,BUURI EAST,44,375,367,742
MERU,BUURI EAST,40-44,2492,2403,4895
MERU,BUURI EAST,45,586,567,1153
MERU,BUURI EAST,46,405,392,797
MERU,BUURI EAST,47,448,427,875
MERU,BUURI EAST,48,361,355,716
MERU,BUURI EAST,49,384,430,814
MERU,BUURI EAST,45-49,2184,2171,4355
MERU,BUURI EAST,50,491,587,1078
MERU,BUURI EAST,51,352,394,746
MERU,BUURI EAST,52,344,295,639
MERU,BUURI EAST,53,246,230,476
MERU,BUURI EAST,54,297,271,568
MERU,BUURI EAST,50-54,1730,1777,3507
MERU,BUURI EAST,55,337,372,709
MERU,BUURI EAST,56,356,379,735
MERU,BUURI EAST,57,303,410,713
MERU,BUURI EAST,58,278,317,595
MERU,BUURI EAST,59,285,338,623
MERU,BUURI EAST,55-59,1559,1816,3375
MERU,BUURI EAST,60,367,454,821
MERU,BUURI EAST,61,258,256,514
MERU,BUURI EAST,62,221,181,402
MERU,BUURI EAST,63,176,210,386
MERU,BUURI EAST,64,136,141,277
MERU,BUURI EAST,60-64,1158,1242,2400
MERU,BUURI EAST,65,217,271,488
MERU,BUURI EAST,66,136,172,308
MERU,BUURI EAST,67,232,253,485
MERU,BUURI EAST,68,124,125,249
MERU,BUURI EAST,69,172,211,383
MERU,BUURI EAST,65-69,881,1032,1913
MERU,BUURI EAST,70,275,407,682
MERU,BUURI EAST,71,126,131,257
MERU,BUURI EAST,72,132,124,256
MERU,BUURI EAST,73,71,100,171
MERU,BUURI EAST,74,68,120,188
MERU,BUURI EAST,70-74,672,882,1554
MERU,BUURI EAST,75,108,107,215
MERU,BUURI EAST,76,61,60,121
MERU,BUURI EAST,77,73,103,176
MERU,BUURI EAST,78,47,61,108
MERU,BUURI EAST,79,38,100,138
MERU,BUURI EAST,75-79,327,431,758
MERU,BUURI EAST,80,108,197,305
MERU,BUURI EAST,81,48,64,112
MERU,BUURI EAST,82,43,42,85
MERU,BUURI EAST,83,46,40,86
MERU,BUURI EAST,84,51,65,116
MERU,BUURI EAST,80-84,296,408,704
MERU,BUURI EAST,85,41,48,89
MERU,BUURI EAST,86,28,31,59
MERU,BUURI EAST,87,21,25,46
MERU,BUURI EAST,88,17,15,32
MERU,BUURI EAST,89,21,62,83
MERU,BUURI EAST,85-89,128,181,309
MERU,BUURI EAST,90,27,59,86
MERU,BUURI EAST,91,7,36,43
MERU,BUURI EAST,92,8,9,17
MERU,BUURI EAST,93,10,7,17
MERU,BUURI EAST,94,8,20,28
MERU,BUURI EAST,90-94,60,131,191
MERU,BUURI EAST,95,7,20,27
MERU,BUURI EAST,96,2,17,19
MERU,BUURI EAST,97,8,6,14
MERU,BUURI EAST,98,6,7,13
MERU,BUURI EAST,99,6,12,18
MERU,BUURI EAST,95-99,29,62,91
MERU,BUURI EAST,100+,16,39,55
MERU,BUURI EAST,Not Stated,1,2,3
MERU,BUURI WEST,Total,40496,40264,80760
MERU,BUURI WEST,0,831,810,1641
MERU,BUURI WEST,1,881,872,1753
MERU,BUURI WEST,2,829,857,1686
MERU,BUURI WEST,3,875,813,1688
MERU,BUURI WEST,4,831,839,1670
MERU,BUURI WEST,0 - 4,4247,4191,8438
MERU,BUURI WEST,5,785,796,1581
MERU,BUURI WEST,6,807,811,1618
MERU,BUURI WEST,7,857,818,1675
MERU,BUURI WEST,8,810,776,1586
MERU,BUURI WEST,9,884,915,1799
MERU,BUURI WEST,05-Sep,4143,4116,8259
MERU,BUURI WEST,10,859,865,1724
MERU,BUURI WEST,11,830,844,1674
MERU,BUURI WEST,12,893,882,1775
MERU,BUURI WEST,13,948,897,1845
MERU,BUURI WEST,14,927,825,1752
MERU,BUURI WEST,Oct-14,4457,4313,8770
MERU,BUURI WEST,15,851,848,1699
MERU,BUURI WEST,16,812,829,1641
MERU,BUURI WEST,17,813,802,1615
MERU,BUURI WEST,18,665,654,1319
MERU,BUURI WEST,19,709,700,1409
MERU,BUURI WEST,15-19,3850,3833,7683
MERU,BUURI WEST,20,696,701,1397
MERU,BUURI WEST,21,693,690,1383
MERU,BUURI WEST,22,723,665,1388
MERU,BUURI WEST,23,760,751,1511
MERU,BUURI WEST,24,750,721,1471
MERU,BUURI WEST,20-24,3622,3528,7150
MERU,BUURI WEST,25,766,777,1543
MERU,BUURI WEST,26,615,665,1280
MERU,BUURI WEST,27,710,667,1377
MERU,BUURI WEST,28,631,639,1270
MERU,BUURI WEST,29,664,741,1405
MERU,BUURI WEST,25-29,3386,3489,6875
MERU,BUURI WEST,30,867,921,1788
MERU,BUURI WEST,31,616,631,1247
MERU,BUURI WEST,32,739,843,1582
MERU,BUURI WEST,33,655,751,1406
MERU,BUURI WEST,34,569,679,1248
MERU,BUURI WEST,30-34,3446,3825,7271
MERU,BUURI WEST,35,889,893,1782
MERU,BUURI WEST,36,594,580,1174
MERU,BUURI WEST,37,683,584,1267
MERU,BUURI WEST,38,558,542,1100
MERU,BUURI WEST,39,630,563,1193
MERU,BUURI WEST,35-39,3354,3162,6516
MERU,BUURI WEST,40,785,709,1494
MERU,BUURI WEST,41,575,510,1085
MERU,BUURI WEST,42,627,501,1128
MERU,BUURI WEST,43,445,478,923
MERU,BUURI WEST,44,403,356,759
MERU,BUURI WEST,40-44,2835,2554,5389
MERU,BUURI WEST,45,601,560,1161
MERU,BUURI WEST,46,432,425,857
MERU,BUURI WEST,47,409,384,793
MERU,BUURI WEST,48,347,310,657
MERU,BUURI WEST,49,371,343,714
MERU,BUURI WEST,45-49,2160,2022,4182
MERU,BUURI WEST,50,455,485,940
MERU,BUURI WEST,51,323,266,589
MERU,BUURI WEST,52,246,233,479
MERU,BUURI WEST,53,180,179,359
MERU,BUURI WEST,54,223,234,457
MERU,BUURI WEST,50-54,1427,1397,2824
MERU,BUURI WEST,55,325,254,579
MERU,BUURI WEST,56,296,267,563
MERU,BUURI WEST,57,217,236,453
MERU,BUURI WEST,58,204,192,396
MERU,BUURI WEST,59,191,192,383
MERU,BUURI WEST,55-59,1233,1141,2374
MERU,BUURI WEST,60,267,283,550
MERU,BUURI WEST,61,157,166,323
MERU,BUURI WEST,62,154,144,298
MERU,BUURI WEST,63,103,143,246
MERU,BUURI WEST,64,98,89,187
MERU,BUURI WEST,60-64,779,825,1604
MERU,BUURI WEST,65,167,154,321
MERU,BUURI WEST,66,101,102,203
MERU,BUURI WEST,67,158,190,348
MERU,BUURI WEST,68,83,70,153
MERU,BUURI WEST,69,122,139,261
MERU,BUURI WEST,65-69,631,655,1286
MERU,BUURI WEST,70,173,191,364
MERU,BUURI WEST,71,80,86,166
MERU,BUURI WEST,72,83,87,170
MERU,BUURI WEST,73,57,56,113
MERU,BUURI WEST,74,49,66,115
MERU,BUURI WEST,70-74,442,486,928
MERU,BUURI WEST,75,47,71,118
MERU,BUURI WEST,76,38,52,90
MERU,BUURI WEST,77,48,61,109
MERU,BUURI WEST,78,40,32,72
MERU,BUURI WEST,79,35,61,96
MERU,BUURI WEST,75-79,208,277,485
MERU,BUURI WEST,80,49,104,153
MERU,BUURI WEST,81,22,23,45
MERU,BUURI WEST,82,22,21,43
MERU,BUURI WEST,83,23,22,45
MERU,BUURI WEST,84,18,33,51
MERU,BUURI WEST,80-84,134,203,337
MERU,BUURI WEST,85,20,26,46
MERU,BUURI WEST,86,18,16,34
MERU,BUURI WEST,87,17,27,44
MERU,BUURI WEST,88,10,13,23
MERU,BUURI WEST,89,18,44,62
MERU,BUURI WEST,85-89,83,126,209
MERU,BUURI WEST,90,13,32,45
MERU,BUURI WEST,91,6,17,23
MERU,BUURI WEST,92,6,7,13
MERU,BUURI WEST,93,4,7,11
MERU,BUURI WEST,94,6,9,15
MERU,BUURI WEST,90-94,35,72,107
MERU,BUURI WEST,95,3,7,10
MERU,BUURI WEST,96,3,6,9
MERU,BUURI WEST,97,7,1,8
MERU,BUURI WEST,98,2,2,4
MERU,BUURI WEST,99,1,13,14
MERU,BUURI WEST,95-99,16,29,45
MERU,BUURI WEST,100+,8,20,28
MERU,BUURI WEST,Not Stated,-,-,-
MERU,IGEMBE CENTRAL,Total,111208,110200,221408
MERU,IGEMBE CENTRAL,0,2225,2315,4540
MERU,IGEMBE CENTRAL,1,2766,2662,5428
MERU,IGEMBE CENTRAL,2,2778,2735,5513
MERU,IGEMBE CENTRAL,3,2966,2943,5909
MERU,IGEMBE CENTRAL,4,2944,2669,5613
MERU,IGEMBE CENTRAL,0 - 4,13679,13324,27003
MERU,IGEMBE CENTRAL,5,2856,2846,5702
MERU,IGEMBE CENTRAL,6,2868,2879,5747
MERU,IGEMBE CENTRAL,7,2756,2715,5471
MERU,IGEMBE CENTRAL,8,2549,2657,5206
MERU,IGEMBE CENTRAL,9,2977,2818,5795
MERU,IGEMBE CENTRAL,05-Sep,14006,13915,27921
MERU,IGEMBE CENTRAL,10,3336,3128,6464
MERU,IGEMBE CENTRAL,11,2776,2810,5586
MERU,IGEMBE CENTRAL,12,3142,3138,6280
MERU,IGEMBE CENTRAL,13,3215,3203,6418
MERU,IGEMBE CENTRAL,14,3059,3118,6177
MERU,IGEMBE CENTRAL,Oct-14,15528,15397,30925
MERU,IGEMBE CENTRAL,15,2937,2839,5776
MERU,IGEMBE CENTRAL,16,2730,2687,5417
MERU,IGEMBE CENTRAL,17,2727,2599,5326
MERU,IGEMBE CENTRAL,18,2315,2451,4766
MERU,IGEMBE CENTRAL,19,2390,2507,4897
MERU,IGEMBE CENTRAL,15-19,13099,13083,26182
MERU,IGEMBE CENTRAL,20,2541,2716,5257
MERU,IGEMBE CENTRAL,21,1769,1865,3634
MERU,IGEMBE CENTRAL,22,1952,1913,3865
MERU,IGEMBE CENTRAL,23,1855,1776,3631
MERU,IGEMBE CENTRAL,24,1639,1589,3228
MERU,IGEMBE CENTRAL,20-24,9756,9859,19615
MERU,IGEMBE CENTRAL,25,2292,1974,4266
MERU,IGEMBE CENTRAL,26,1476,1474,2950
MERU,IGEMBE CENTRAL,27,1677,1537,3214
MERU,IGEMBE CENTRAL,28,1483,1377,2860
MERU,IGEMBE CENTRAL,29,1416,1412,2828
MERU,IGEMBE CENTRAL,25-29,8344,7774,16118
MERU,IGEMBE CENTRAL,30,2529,2454,4983
MERU,IGEMBE CENTRAL,31,1191,1166,2357
MERU,IGEMBE CENTRAL,32,1662,1691,3353
MERU,IGEMBE CENTRAL,33,1328,1422,2750
MERU,IGEMBE CENTRAL,34,1125,1334,2459
MERU,IGEMBE CENTRAL,30-34,7835,8067,15902
MERU,IGEMBE CENTRAL,35,2655,2612,5267
MERU,IGEMBE CENTRAL,36,1177,1071,2248
MERU,IGEMBE CENTRAL,37,1242,1180,2422
MERU,IGEMBE CENTRAL,38,925,1003,1928
MERU,IGEMBE CENTRAL,39,1114,1104,2218
MERU,IGEMBE CENTRAL,35-39,7113,6970,14083
MERU,IGEMBE CENTRAL,40,2056,1945,4001
MERU,IGEMBE CENTRAL,41,1169,962,2131
MERU,IGEMBE CENTRAL,42,1052,890,1942
MERU,IGEMBE CENTRAL,43,777,814,1591
MERU,IGEMBE CENTRAL,44,815,779,1594
MERU,IGEMBE CENTRAL,40-44,5869,5390,11259
MERU,IGEMBE CENTRAL,45,1509,1301,2810
MERU,IGEMBE CENTRAL,46,848,768,1616
MERU,IGEMBE CENTRAL,47,819,705,1524
MERU,IGEMBE CENTRAL,48,572,556,1128
MERU,IGEMBE CENTRAL,49,786,777,1563
MERU,IGEMBE CENTRAL,45-49,4534,4107,8641
MERU,IGEMBE CENTRAL,50,1285,1200,2485
MERU,IGEMBE CENTRAL,51,554,383,937
MERU,IGEMBE CENTRAL,52,446,292,738
MERU,IGEMBE CENTRAL,53,231,216,447
MERU,IGEMBE CENTRAL,54,393,250,643
MERU,IGEMBE CENTRAL,50-54,2909,2341,5250
MERU,IGEMBE CENTRAL,55,601,528,1129
MERU,IGEMBE CENTRAL,56,677,595,1272
MERU,IGEMBE CENTRAL,57,383,429,812
MERU,IGEMBE CENTRAL,58,426,402,828
MERU,IGEMBE CENTRAL,59,437,494,931
MERU,IGEMBE CENTRAL,55-59,2524,2448,4972
MERU,IGEMBE CENTRAL,60,781,934,1715
MERU,IGEMBE CENTRAL,61,316,315,631
MERU,IGEMBE CENTRAL,62,316,328,644
MERU,IGEMBE CENTRAL,63,297,310,607
MERU,IGEMBE CENTRAL,64,216,235,451
MERU,IGEMBE CENTRAL,60-64,1926,2122,4048
MERU,IGEMBE CENTRAL,65,538,651,1189
MERU,IGEMBE CENTRAL,66,182,174,356
MERU,IGEMBE CENTRAL,67,358,303,661
MERU,IGEMBE CENTRAL,68,207,173,380
MERU,IGEMBE CENTRAL,69,271,373,644
MERU,IGEMBE CENTRAL,65-69,1556,1674,3230
MERU,IGEMBE CENTRAL,70,677,980,1657
MERU,IGEMBE CENTRAL,71,170,170,340
MERU,IGEMBE CENTRAL,72,162,203,365
MERU,IGEMBE CENTRAL,73,101,110,211
MERU,IGEMBE CENTRAL,74,107,185,292
MERU,IGEMBE CENTRAL,70-74,1217,1648,2865
MERU,IGEMBE CENTRAL,75,179,240,419
MERU,IGEMBE CENTRAL,76,60,71,131
MERU,IGEMBE CENTRAL,77,121,102,223
MERU,IGEMBE CENTRAL,78,53,75,128
MERU,IGEMBE CENTRAL,79,100,212,312
MERU,IGEMBE CENTRAL,75-79,513,700,1213
MERU,IGEMBE CENTRAL,80,218,438,656
MERU,IGEMBE CENTRAL,81,50,60,110
MERU,IGEMBE CENTRAL,82,48,52,100
MERU,IGEMBE CENTRAL,83,30,45,75
MERU,IGEMBE CENTRAL,84,46,80,126
MERU,IGEMBE CENTRAL,80-84,392,675,1067
MERU,IGEMBE CENTRAL,85,82,103,185
MERU,IGEMBE CENTRAL,86,37,30,67
MERU,IGEMBE CENTRAL,87,28,42,70
MERU,IGEMBE CENTRAL,88,15,26,41
MERU,IGEMBE CENTRAL,89,45,110,155
MERU,IGEMBE CENTRAL,85-89,207,311,518
MERU,IGEMBE CENTRAL,90,61,133,194
MERU,IGEMBE CENTRAL,91,13,15,28
MERU,IGEMBE CENTRAL,92,7,11,18
MERU,IGEMBE CENTRAL,93,9,12,21
MERU,IGEMBE CENTRAL,94,10,20,30
MERU,IGEMBE CENTRAL,90-94,100,191,291
MERU,IGEMBE CENTRAL,95,18,29,47
MERU,IGEMBE CENTRAL,96,6,8,14
MERU,IGEMBE CENTRAL,97,14,10,24
MERU,IGEMBE CENTRAL,98,2,7,9
MERU,IGEMBE CENTRAL,99,19,19,38
MERU,IGEMBE CENTRAL,95-99,59,73,132
MERU,IGEMBE CENTRAL,100+,40,128,168
MERU,IGEMBE CENTRAL,Not Stated,2,3,5
MERU,IGEMBE NORTH,Total,83364,85949,169313
MERU,IGEMBE NORTH,0,1825,1832,3657
MERU,IGEMBE NORTH,1,2133,2179,4312
MERU,IGEMBE NORTH,2,2188,2223,4411
MERU,IGEMBE NORTH,3,2265,2274,4539
MERU,IGEMBE NORTH,4,2195,2182,4377
MERU,IGEMBE NORTH,0 - 4,10606,10690,21296
MERU,IGEMBE NORTH,5,2337,2165,4502
MERU,IGEMBE NORTH,6,2255,2164,4419
MERU,IGEMBE NORTH,7,2133,2033,4166
MERU,IGEMBE NORTH,8,2187,2144,4331
MERU,IGEMBE NORTH,9,2392,2358,4750
MERU,IGEMBE NORTH,05-Sep,11304,10864,22168
MERU,IGEMBE NORTH,10,2798,2648,5446
MERU,IGEMBE NORTH,11,2181,2267,4448
MERU,IGEMBE NORTH,12,2717,2610,5327
MERU,IGEMBE NORTH,13,2666,2870,5536
MERU,IGEMBE NORTH,14,2445,2532,4977
MERU,IGEMBE NORTH,Oct-14,12807,12927,25734
MERU,IGEMBE NORTH,15,2355,2505,4860
MERU,IGEMBE NORTH,16,2013,2168,4181
MERU,IGEMBE NORTH,17,1965,2065,4030
MERU,IGEMBE NORTH,18,1635,1909,3544
MERU,IGEMBE NORTH,19,1731,1902,3633
MERU,IGEMBE NORTH,15-19,9699,10549,20248
MERU,IGEMBE NORTH,20,1958,2072,4030
MERU,IGEMBE NORTH,21,1256,1413,2669
MERU,IGEMBE NORTH,22,1381,1431,2812
MERU,IGEMBE NORTH,23,1184,1437,2621
MERU,IGEMBE NORTH,24,1237,1168,2405
MERU,IGEMBE NORTH,20-24,7016,7521,14537
MERU,IGEMBE NORTH,25,1627,1575,3202
MERU,IGEMBE NORTH,26,1065,1034,2099
MERU,IGEMBE NORTH,27,1155,1137,2292
MERU,IGEMBE NORTH,28,963,1046,2009
MERU,IGEMBE NORTH,29,931,959,1890
MERU,IGEMBE NORTH,25-29,5741,5751,11492
MERU,IGEMBE NORTH,30,1878,1906,3784
MERU,IGEMBE NORTH,31,742,847,1589
MERU,IGEMBE NORTH,32,1117,1200,2317
MERU,IGEMBE NORTH,33,925,1162,2087
MERU,IGEMBE NORTH,34,802,942,1744
MERU,IGEMBE NORTH,30-34,5464,6057,11521
MERU,IGEMBE NORTH,35,1934,1981,3915
MERU,IGEMBE NORTH,36,740,758,1498
MERU,IGEMBE NORTH,37,846,845,1691
MERU,IGEMBE NORTH,38,686,724,1410
MERU,IGEMBE NORTH,39,753,720,1473
MERU,IGEMBE NORTH,35-39,4959,5028,9987
MERU,IGEMBE NORTH,40,1552,1482,3034
MERU,IGEMBE NORTH,41,781,629,1410
MERU,IGEMBE NORTH,42,632,609,1241
MERU,IGEMBE NORTH,43,510,562,1072
MERU,IGEMBE NORTH,44,612,609,1221
MERU,IGEMBE NORTH,40-44,4087,3891,7978
MERU,IGEMBE NORTH,45,1049,1039,2088
MERU,IGEMBE NORTH,46,549,539,1088
MERU,IGEMBE NORTH,47,602,504,1106
MERU,IGEMBE NORTH,48,376,372,748
MERU,IGEMBE NORTH,49,616,604,1220
MERU,IGEMBE NORTH,45-49,3192,3058,6250
MERU,IGEMBE NORTH,50,951,1022,1973
MERU,IGEMBE NORTH,51,360,293,653
MERU,IGEMBE NORTH,52,293,222,515
MERU,IGEMBE NORTH,53,205,157,362
MERU,IGEMBE NORTH,54,221,226,447
MERU,IGEMBE NORTH,50-54,2030,1920,3950
MERU,IGEMBE NORTH,55,411,419,830
MERU,IGEMBE NORTH,56,462,470,932
MERU,IGEMBE NORTH,57,234,255,489
MERU,IGEMBE NORTH,58,241,219,460
MERU,IGEMBE NORTH,59,309,375,684
MERU,IGEMBE NORTH,55-59,1657,1738,3395
MERU,IGEMBE NORTH,60,634,753,1387
MERU,IGEMBE NORTH,61,203,243,446
MERU,IGEMBE NORTH,62,270,261,531
MERU,IGEMBE NORTH,63,199,216,415
MERU,IGEMBE NORTH,64,169,192,361
MERU,IGEMBE NORTH,60-64,1475,1665,3140
MERU,IGEMBE NORTH,65,449,531,980
MERU,IGEMBE NORTH,66,128,122,250
MERU,IGEMBE NORTH,67,237,229,466
MERU,IGEMBE NORTH,68,123,148,271
MERU,IGEMBE NORTH,69,215,325,540
MERU,IGEMBE NORTH,65-69,1152,1355,2507
MERU,IGEMBE NORTH,70,602,802,1404
MERU,IGEMBE NORTH,71,144,141,285
MERU,IGEMBE NORTH,72,121,123,244
MERU,IGEMBE NORTH,73,78,101,179
MERU,IGEMBE NORTH,74,90,107,197
MERU,IGEMBE NORTH,70-74,1035,1274,2309
MERU,IGEMBE NORTH,75,167,191,358
MERU,IGEMBE NORTH,76,51,58,109
MERU,IGEMBE NORTH,77,77,76,153
MERU,IGEMBE NORTH,78,63,47,110
MERU,IGEMBE NORTH,79,106,153,259
MERU,IGEMBE NORTH,75-79,464,525,989
MERU,IGEMBE NORTH,80,197,337,534
MERU,IGEMBE NORTH,81,35,50,85
MERU,IGEMBE NORTH,82,39,42,81
MERU,IGEMBE NORTH,83,33,41,74
MERU,IGEMBE NORTH,84,41,65,106
MERU,IGEMBE NORTH,80-84,345,535,880
MERU,IGEMBE NORTH,85,53,97,150
MERU,IGEMBE NORTH,86,30,35,65
MERU,IGEMBE NORTH,87,16,45,61
MERU,IGEMBE NORTH,88,19,16,35
MERU,IGEMBE NORTH,89,51,94,145
MERU,IGEMBE NORTH,85-89,169,287,456
MERU,IGEMBE NORTH,90,53,116,169
MERU,IGEMBE NORTH,91,11,16,27
MERU,IGEMBE NORTH,92,7,11,18
MERU,IGEMBE NORTH,93,6,4,10
MERU,IGEMBE NORTH,94,13,8,21
MERU,IGEMBE NORTH,90-94,90,155,245
MERU,IGEMBE NORTH,95,16,15,31
MERU,IGEMBE NORTH,96,4,4,8
MERU,IGEMBE NORTH,97,4,6,10
MERU,IGEMBE NORTH,98,4,5,9
MERU,IGEMBE NORTH,99,10,36,46
MERU,IGEMBE NORTH,95-99,38,66,104
MERU,IGEMBE NORTH,100+,33,92,125
MERU,IGEMBE NORTH,Not Stated,1,1,2
MERU,IGEMBE SOUTH,Total,80192,81446,161638
MERU,IGEMBE SOUTH,0,1855,1859,3714
MERU,IGEMBE SOUTH,1,1910,1922,3832
MERU,IGEMBE SOUTH,2,1941,1933,3874
MERU,IGEMBE SOUTH,3,2071,2113,4184
MERU,IGEMBE SOUTH,4,1972,2055,4027
MERU,IGEMBE SOUTH,0 - 4,9749,9882,19631
MERU,IGEMBE SOUTH,5,2049,1919,3968
MERU,IGEMBE SOUTH,6,1969,1938,3907
MERU,IGEMBE SOUTH,7,1964,1908,3872
MERU,IGEMBE SOUTH,8,1774,1825,3599
MERU,IGEMBE SOUTH,9,1929,1942,3871
MERU,IGEMBE SOUTH,05-Sep,9685,9532,19217
MERU,IGEMBE SOUTH,10,2209,2219,4428
MERU,IGEMBE SOUTH,11,1842,1931,3773
MERU,IGEMBE SOUTH,12,2067,2064,4131
MERU,IGEMBE SOUTH,13,2005,2106,4111
MERU,IGEMBE SOUTH,14,1946,1975,3921
MERU,IGEMBE SOUTH,Oct-14,10069,10295,20364
MERU,IGEMBE SOUTH,15,1879,1949,3828
MERU,IGEMBE SOUTH,16,1702,1898,3600
MERU,IGEMBE SOUTH,17,1718,1876,3594
MERU,IGEMBE SOUTH,18,1571,1715,3286
MERU,IGEMBE SOUTH,19,1652,1855,3507
MERU,IGEMBE SOUTH,15-19,8522,9293,17815
MERU,IGEMBE SOUTH,20,1876,1979,3855
MERU,IGEMBE SOUTH,21,1359,1610,2969
MERU,IGEMBE SOUTH,22,1585,1699,3284
MERU,IGEMBE SOUTH,23,1497,1745,3242
MERU,IGEMBE SOUTH,24,1381,1409,2790
MERU,IGEMBE SOUTH,20-24,7698,8442,16140
MERU,IGEMBE SOUTH,25,1858,1759,3617
MERU,IGEMBE SOUTH,26,1276,1372,2648
MERU,IGEMBE SOUTH,27,1415,1479,2894
MERU,IGEMBE SOUTH,28,1275,1272,2547
MERU,IGEMBE SOUTH,29,1155,1127,2282
MERU,IGEMBE SOUTH,25-29,6979,7009,13988
MERU,IGEMBE SOUTH,30,2070,1895,3965
MERU,IGEMBE SOUTH,31,947,936,1883
MERU,IGEMBE SOUTH,32,1246,1374,2620
MERU,IGEMBE SOUTH,33,1097,1253,2350
MERU,IGEMBE SOUTH,34,886,1036,1922
MERU,IGEMBE SOUTH,30-34,6246,6494,12740
MERU,IGEMBE SOUTH,35,2034,1915,3949
MERU,IGEMBE SOUTH,36,938,850,1788
MERU,IGEMBE SOUTH,37,1023,918,1941
MERU,IGEMBE SOUTH,38,779,814,1593
MERU,IGEMBE SOUTH,39,916,764,1680
MERU,IGEMBE SOUTH,35-39,5690,5261,10951
MERU,IGEMBE SOUTH,40,1631,1397,3028
MERU,IGEMBE SOUTH,41,827,734,1561
MERU,IGEMBE SOUTH,42,744,695,1439
MERU,IGEMBE SOUTH,43,605,561,1166
MERU,IGEMBE SOUTH,44,552,546,1098
MERU,IGEMBE SOUTH,40-44,4359,3933,8292
MERU,IGEMBE SOUTH,45,1005,924,1929
MERU,IGEMBE SOUTH,46,619,595,1214
MERU,IGEMBE SOUTH,47,551,544,1095
MERU,IGEMBE SOUTH,48,439,400,839
MERU,IGEMBE SOUTH,49,520,513,1033
MERU,IGEMBE SOUTH,45-49,3134,2976,6110
MERU,IGEMBE SOUTH,50,789,799,1588
MERU,IGEMBE SOUTH,51,420,259,679
MERU,IGEMBE SOUTH,52,336,237,573
MERU,IGEMBE SOUTH,53,213,163,376
MERU,IGEMBE SOUTH,54,263,183,446
MERU,IGEMBE SOUTH,50-54,2021,1641,3662
MERU,IGEMBE SOUTH,55,425,337,762
MERU,IGEMBE SOUTH,56,525,470,995
MERU,IGEMBE SOUTH,57,305,314,619
MERU,IGEMBE SOUTH,58,241,249,490
MERU,IGEMBE SOUTH,59,357,337,694
MERU,IGEMBE SOUTH,55-59,1853,1707,3560
MERU,IGEMBE SOUTH,60,516,578,1094
MERU,IGEMBE SOUTH,61,182,216,398
MERU,IGEMBE SOUTH,62,220,248,468
MERU,IGEMBE SOUTH,63,203,232,435
MERU,IGEMBE SOUTH,64,169,160,329
MERU,IGEMBE SOUTH,60-64,1290,1434,2724
MERU,IGEMBE SOUTH,65,393,447,840
MERU,IGEMBE SOUTH,66,149,121,270
MERU,IGEMBE SOUTH,67,269,219,488
MERU,IGEMBE SOUTH,68,119,115,234
MERU,IGEMBE SOUTH,69,235,252,487
MERU,IGEMBE SOUTH,65-69,1165,1154,2319
MERU,IGEMBE SOUTH,70,455,567,1022
MERU,IGEMBE SOUTH,71,143,170,313
MERU,IGEMBE SOUTH,72,106,139,245
MERU,IGEMBE SOUTH,73,66,79,145
MERU,IGEMBE SOUTH,74,86,113,199
MERU,IGEMBE SOUTH,70-74,856,1068,1924
MERU,IGEMBE SOUTH,75,117,153,270
MERU,IGEMBE SOUTH,76,42,47,89
MERU,IGEMBE SOUTH,77,72,82,154
MERU,IGEMBE SOUTH,78,45,53,98
MERU,IGEMBE SOUTH,79,71,136,207
MERU,IGEMBE SOUTH,75-79,347,471,818
MERU,IGEMBE SOUTH,80,132,261,393
MERU,IGEMBE SOUTH,81,21,31,52
MERU,IGEMBE SOUTH,82,39,48,87
MERU,IGEMBE SOUTH,83,24,22,46
MERU,IGEMBE SOUTH,84,31,53,84
MERU,IGEMBE SOUTH,80-84,247,415,662
MERU,IGEMBE SOUTH,85,39,62,101
MERU,IGEMBE SOUTH,86,42,16,58
MERU,IGEMBE SOUTH,87,20,32,52
MERU,IGEMBE SOUTH,88,12,15,27
MERU,IGEMBE SOUTH,89,34,77,111
MERU,IGEMBE SOUTH,85-89,147,202,349
MERU,IGEMBE SOUTH,90,37,74,111
MERU,IGEMBE SOUTH,91,7,13,20
MERU,IGEMBE SOUTH,92,6,13,19
MERU,IGEMBE SOUTH,93,5,6,11
MERU,IGEMBE SOUTH,94,12,17,29
MERU,IGEMBE SOUTH,90-94,67,123,190
MERU,IGEMBE SOUTH,95,15,26,41
MERU,IGEMBE SOUTH,96,4,4,8
MERU,IGEMBE SOUTH,97,9,8,17
MERU,IGEMBE SOUTH,98,5,4,9
MERU,IGEMBE SOUTH,99,7,21,28
MERU,IGEMBE SOUTH,95-99,40,63,103
MERU,IGEMBE SOUTH,100+,26,49,75
MERU,IGEMBE SOUTH,Not Stated,2,2,4
MERU,IMENTI NORTH,Total,88506,89056,177562
MERU,IMENTI NORTH,0,1879,1846,3725
MERU,IMENTI NORTH,1,1925,1865,3790
MERU,IMENTI NORTH,2,1824,1838,3662
MERU,IMENTI NORTH,3,1794,1786,3580
MERU,IMENTI NORTH,4,1733,1745,3478
MERU,IMENTI NORTH,0 - 4,9155,9080,18235
MERU,IMENTI NORTH,5,1667,1599,3266
MERU,IMENTI NORTH,6,1635,1720,3355
MERU,IMENTI NORTH,7,1685,1684,3369
MERU,IMENTI NORTH,8,1620,1569,3189
MERU,IMENTI NORTH,9,1673,1730,3403
MERU,IMENTI NORTH,05-Sep,8280,8302,16582
MERU,IMENTI NORTH,10,1716,1608,3324
MERU,IMENTI NORTH,11,1550,1621,3171
MERU,IMENTI NORTH,12,1748,1735,3483
MERU,IMENTI NORTH,13,1747,1717,3464
MERU,IMENTI NORTH,14,1662,1710,3372
MERU,IMENTI NORTH,Oct-14,8423,8391,16814
MERU,IMENTI NORTH,15,1562,1707,3269
MERU,IMENTI NORTH,16,1477,1572,3049
MERU,IMENTI NORTH,17,1693,1620,3313
MERU,IMENTI NORTH,18,1438,1448,2886
MERU,IMENTI NORTH,19,1631,1761,3392
MERU,IMENTI NORTH,15-19,7801,8108,15909
MERU,IMENTI NORTH,20,1619,1835,3454
MERU,IMENTI NORTH,21,1606,1873,3479
MERU,IMENTI NORTH,22,1723,1840,3563
MERU,IMENTI NORTH,23,1958,2019,3977
MERU,IMENTI NORTH,24,1813,1853,3666
MERU,IMENTI NORTH,20-24,8719,9420,18139
MERU,IMENTI NORTH,25,1817,1727,3544
MERU,IMENTI NORTH,26,1598,1620,3218
MERU,IMENTI NORTH,27,1679,1686,3365
MERU,IMENTI NORTH,28,1496,1494,2990
MERU,IMENTI NORTH,29,1563,1642,3205
MERU,IMENTI NORTH,25-29,8153,8169,16322
MERU,IMENTI NORTH,30,1994,1996,3990
MERU,IMENTI NORTH,31,1443,1369,2812
MERU,IMENTI NORTH,32,1771,1754,3525
MERU,IMENTI NORTH,33,1469,1573,3042
MERU,IMENTI NORTH,34,1337,1344,2681
MERU,IMENTI NORTH,30-34,8014,8036,16050
MERU,IMENTI NORTH,35,1982,1871,3853
MERU,IMENTI NORTH,36,1310,1276,2586
MERU,IMENTI NORTH,37,1373,1160,2533
MERU,IMENTI NORTH,38,1141,1165,2306
MERU,IMENTI NORTH,39,1292,1172,2464
MERU,IMENTI NORTH,35-39,7098,6644,13742
MERU,IMENTI NORTH,40,1720,1444,3164
MERU,IMENTI NORTH,41,1221,1039,2260
MERU,IMENTI NORTH,42,1105,969,2074
MERU,IMENTI NORTH,43,980,904,1884
MERU,IMENTI NORTH,44,824,713,1537
MERU,IMENTI NORTH,40-44,5850,5069,10919
MERU,IMENTI NORTH,45,1150,1118,2268
MERU,IMENTI NORTH,46,911,822,1733
MERU,IMENTI NORTH,47,900,850,1750
MERU,IMENTI NORTH,48,716,681,1397
MERU,IMENTI NORTH,49,802,724,1526
MERU,IMENTI NORTH,45-49,4479,4195,8674
MERU,IMENTI NORTH,50,977,995,1972
MERU,IMENTI NORTH,51,756,722,1478
MERU,IMENTI NORTH,52,587,555,1142
MERU,IMENTI NORTH,53,467,467,934
MERU,IMENTI NORTH,54,580,505,1085
MERU,IMENTI NORTH,50-54,3367,3244,6611
MERU,IMENTI NORTH,55,638,630,1268
MERU,IMENTI NORTH,56,696,697,1393
MERU,IMENTI NORTH,57,573,660,1233
MERU,IMENTI NORTH,58,487,493,980
MERU,IMENTI NORTH,59,559,550,1109
MERU,IMENTI NORTH,55-59,2953,3030,5983
MERU,IMENTI NORTH,60,690,808,1498
MERU,IMENTI NORTH,61,433,477,910
MERU,IMENTI NORTH,62,402,380,782
MERU,IMENTI NORTH,63,347,374,721
MERU,IMENTI NORTH,64,258,285,543
MERU,IMENTI NORTH,60-64,2130,2324,4454
MERU,IMENTI NORTH,65,391,473,864
MERU,IMENTI NORTH,66,228,258,486
MERU,IMENTI NORTH,67,417,446,863
MERU,IMENTI NORTH,68,239,203,442
MERU,IMENTI NORTH,69,317,336,653
MERU,IMENTI NORTH,65-69,1592,1716,3308
MERU,IMENTI NORTH,70,422,581,1003
MERU,IMENTI NORTH,71,231,252,483
MERU,IMENTI NORTH,72,207,169,376
MERU,IMENTI NORTH,73,165,167,332
MERU,IMENTI NORTH,74,153,157,310
MERU,IMENTI NORTH,70-74,1178,1326,2504
MERU,IMENTI NORTH,75,165,189,354
MERU,IMENTI NORTH,76,94,110,204
MERU,IMENTI NORTH,77,142,176,318
MERU,IMENTI NORTH,78,72,65,137
MERU,IMENTI NORTH,79,88,175,263
MERU,IMENTI NORTH,75-79,561,715,1276
MERU,IMENTI NORTH,80,157,301,458
MERU,IMENTI NORTH,81,68,95,163
MERU,IMENTI NORTH,82,69,61,130
MERU,IMENTI NORTH,83,75,76,151
MERU,IMENTI NORTH,84,45,87,132
MERU,IMENTI NORTH,80-84,414,620,1034
MERU,IMENTI NORTH,85,49,84,133
MERU,IMENTI NORTH,86,33,40,73
MERU,IMENTI NORTH,87,39,49,88
MERU,IMENTI NORTH,88,24,29,53
MERU,IMENTI NORTH,89,39,104,143
MERU,IMENTI NORTH,85-89,184,306,490
MERU,IMENTI NORTH,90,40,92,132
MERU,IMENTI NORTH,91,17,36,53
MERU,IMENTI NORTH,92,10,22,32
MERU,IMENTI NORTH,93,10,18,28
MERU,IMENTI NORTH,94,6,23,29
MERU,IMENTI NORTH,90-94,83,191,274
MERU,IMENTI NORTH,95,19,38,57
MERU,IMENTI NORTH,96,7,13,20
MERU,IMENTI NORTH,97,8,17,25
MERU,IMENTI NORTH,98,2,15,17
MERU,IMENTI NORTH,99,7,22,29
MERU,IMENTI NORTH,95-99,43,105,148
MERU,IMENTI NORTH,100+,23,64,87
MERU,IMENTI NORTH,Not Stated,6,1,7
MERU,IMENTI SOUTH,Total,103338,103162,206500
MERU,IMENTI SOUTH,0,1830,1905,3735
MERU,IMENTI SOUTH,1,2016,1959,3975
MERU,IMENTI SOUTH,2,1997,2074,4071
MERU,IMENTI SOUTH,3,2064,2123,4187
MERU,IMENTI SOUTH,4,2051,1966,4017
MERU,IMENTI SOUTH,0 - 4,9958,10027,19985
MERU,IMENTI SOUTH,5,1948,1883,3831
MERU,IMENTI SOUTH,6,2012,1927,3939
MERU,IMENTI SOUTH,7,2089,2041,4130
MERU,IMENTI SOUTH,8,1889,1995,3884
MERU,IMENTI SOUTH,9,2127,2123,4250
MERU,IMENTI SOUTH,05-Sep,10065,9969,20034
MERU,IMENTI SOUTH,10,2146,2118,4264
MERU,IMENTI SOUTH,11,2030,2133,4163
MERU,IMENTI SOUTH,12,2245,2231,4476
MERU,IMENTI SOUTH,13,2291,2271,4562
MERU,IMENTI SOUTH,14,2295,2068,4363
MERU,IMENTI SOUTH,Oct-14,11007,10821,21828
MERU,IMENTI SOUTH,15,2074,2014,4088
MERU,IMENTI SOUTH,16,1970,1981,3951
MERU,IMENTI SOUTH,17,1989,2013,4002
MERU,IMENTI SOUTH,18,1807,1715,3522
MERU,IMENTI SOUTH,19,1797,1767,3564
MERU,IMENTI SOUTH,15-19,9637,9490,19127
MERU,IMENTI SOUTH,20,1755,1762,3517
MERU,IMENTI SOUTH,21,1608,1620,3228
MERU,IMENTI SOUTH,22,1673,1613,3286
MERU,IMENTI SOUTH,23,1688,1684,3372
MERU,IMENTI SOUTH,24,1537,1589,3126
MERU,IMENTI SOUTH,20-24,8261,8268,16529
MERU,IMENTI SOUTH,25,1662,1560,3222
MERU,IMENTI SOUTH,26,1343,1486,2829
MERU,IMENTI SOUTH,27,1554,1555,3109
MERU,IMENTI SOUTH,28,1390,1441,2831
MERU,IMENTI SOUTH,29,1530,1534,3064
MERU,IMENTI SOUTH,25-29,7479,7576,15055
MERU,IMENTI SOUTH,30,2081,2090,4171
MERU,IMENTI SOUTH,31,1499,1488,2987
MERU,IMENTI SOUTH,32,1763,1902,3665
MERU,IMENTI SOUTH,33,1673,1740,3413
MERU,IMENTI SOUTH,34,1482,1412,2894
MERU,IMENTI SOUTH,30-34,8498,8632,17130
MERU,IMENTI SOUTH,35,2049,1922,3971
MERU,IMENTI SOUTH,36,1369,1264,2633
MERU,IMENTI SOUTH,37,1448,1284,2732
MERU,IMENTI SOUTH,38,1173,1175,2348
MERU,IMENTI SOUTH,39,1519,1374,2893
MERU,IMENTI SOUTH,35-39,7558,7019,14577
MERU,IMENTI SOUTH,40,1862,1756,3618
MERU,IMENTI SOUTH,41,1458,1190,2648
MERU,IMENTI SOUTH,42,1348,1158,2506
MERU,IMENTI SOUTH,43,1273,1173,2446
MERU,IMENTI SOUTH,44,1117,1036,2153
MERU,IMENTI SOUTH,40-44,7058,6313,13371
MERU,IMENTI SOUTH,45,1584,1469,3053
MERU,IMENTI SOUTH,46,1182,1126,2308
MERU,IMENTI SOUTH,47,1160,1202,2362
MERU,IMENTI SOUTH,48,932,1013,1945
MERU,IMENTI SOUTH,49,1124,1162,2286
MERU,IMENTI SOUTH,45-49,5982,5972,11954
MERU,IMENTI SOUTH,50,1316,1363,2679
MERU,IMENTI SOUTH,51,994,805,1799
MERU,IMENTI SOUTH,52,709,651,1360
MERU,IMENTI SOUTH,53,571,532,1103
MERU,IMENTI SOUTH,54,665,622,1287
MERU,IMENTI SOUTH,50-54,4255,3973,8228
MERU,IMENTI SOUTH,55,821,835,1656
MERU,IMENTI SOUTH,56,895,901,1796
MERU,IMENTI SOUTH,57,717,831,1548
MERU,IMENTI SOUTH,58,737,696,1433
MERU,IMENTI SOUTH,59,834,788,1622
MERU,IMENTI SOUTH,55-59,4004,4051,8055
MERU,IMENTI SOUTH,60,1000,966,1966
MERU,IMENTI SOUTH,61,642,613,1255
MERU,IMENTI SOUTH,62,541,499,1040
MERU,IMENTI SOUTH,63,560,515,1075
MERU,IMENTI SOUTH,64,292,333,625
MERU,IMENTI SOUTH,60-64,3035,2926,5961
MERU,IMENTI SOUTH,65,579,642,1221
MERU,IMENTI SOUTH,66,361,385,746
MERU,IMENTI SOUTH,67,619,667,1286
MERU,IMENTI SOUTH,68,337,343,680
MERU,IMENTI SOUTH,69,482,472,954
MERU,IMENTI SOUTH,65-69,2378,2509,4887
MERU,IMENTI SOUTH,70,596,826,1422
MERU,IMENTI SOUTH,71,342,341,683
MERU,IMENTI SOUTH,72,315,328,643
MERU,IMENTI SOUTH,73,240,247,487
MERU,IMENTI SOUTH,74,246,328,574
MERU,IMENTI SOUTH,70-74,1739,2070,3809
MERU,IMENTI SOUTH,75,222,364,586
MERU,IMENTI SOUTH,76,165,166,331
MERU,IMENTI SOUTH,77,235,243,478
MERU,IMENTI SOUTH,78,152,154,306
MERU,IMENTI SOUTH,79,184,295,479
MERU,IMENTI SOUTH,75-79,958,1222,2180
MERU,IMENTI SOUTH,80,269,517,786
MERU,IMENTI SOUTH,81,111,141,252
MERU,IMENTI SOUTH,82,110,117,227
MERU,IMENTI SOUTH,83,123,143,266
MERU,IMENTI SOUTH,84,131,151,282
MERU,IMENTI SOUTH,80-84,744,1069,1813
MERU,IMENTI SOUTH,85,129,186,315
MERU,IMENTI SOUTH,86,69,78,147
MERU,IMENTI SOUTH,87,66,114,180
MERU,IMENTI SOUTH,88,44,66,110
MERU,IMENTI SOUTH,89,72,174,246
MERU,IMENTI SOUTH,85-89,380,618,998
MERU,IMENTI SOUTH,90,72,170,242
MERU,IMENTI SOUTH,91,42,43,85
MERU,IMENTI SOUTH,92,29,39,68
MERU,IMENTI SOUTH,93,25,44,69
MERU,IMENTI SOUTH,94,18,48,66
MERU,IMENTI SOUTH,90-94,186,344,530
MERU,IMENTI SOUTH,95,34,68,102
MERU,IMENTI SOUTH,96,15,23,38
MERU,IMENTI SOUTH,97,27,30,57
MERU,IMENTI SOUTH,98,15,16,31
MERU,IMENTI SOUTH,99,22,47,69
MERU,IMENTI SOUTH,95-99,113,184,297
MERU,IMENTI SOUTH,100+,43,109,152
MERU,IMENTI SOUTH,Not Stated,-,-,-
MERU,MERU CENTRAL,Total,66920,66894,133814
MERU,MERU CENTRAL,0,1163,1123,2286
MERU,MERU CENTRAL,1,1336,1323,2659
MERU,MERU CENTRAL,2,1322,1260,2582
MERU,MERU CENTRAL,3,1313,1356,2669
MERU,MERU CENTRAL,4,1329,1300,2629
MERU,MERU CENTRAL,0 - 4,6463,6362,12825
MERU,MERU CENTRAL,5,1271,1233,2504
MERU,MERU CENTRAL,6,1346,1357,2703
MERU,MERU CENTRAL,7,1362,1325,2687
MERU,MERU CENTRAL,8,1289,1301,2590
MERU,MERU CENTRAL,9,1415,1459,2874
MERU,MERU CENTRAL,05-Sep,6683,6675,13358
MERU,MERU CENTRAL,10,1541,1426,2967
MERU,MERU CENTRAL,11,1425,1364,2789
MERU,MERU CENTRAL,12,1588,1498,3086
MERU,MERU CENTRAL,13,1513,1526,3039
MERU,MERU CENTRAL,14,1429,1447,2876
MERU,MERU CENTRAL,Oct-14,7496,7261,14757
MERU,MERU CENTRAL,15,1379,1354,2733
MERU,MERU CENTRAL,16,1271,1337,2608
MERU,MERU CENTRAL,17,1396,1377,2773
MERU,MERU CENTRAL,18,1187,1053,2240
MERU,MERU CENTRAL,19,1264,1224,2488
MERU,MERU CENTRAL,15-19,6497,6345,12842
MERU,MERU CENTRAL,20,1106,1061,2167
MERU,MERU CENTRAL,21,1007,971,1978
MERU,MERU CENTRAL,22,1002,962,1964
MERU,MERU CENTRAL,23,1051,998,2049
MERU,MERU CENTRAL,24,973,915,1888
MERU,MERU CENTRAL,20-24,5139,4907,10046
MERU,MERU CENTRAL,25,986,942,1928
MERU,MERU CENTRAL,26,807,868,1675
MERU,MERU CENTRAL,27,922,891,1813
MERU,MERU CENTRAL,28,814,840,1654
MERU,MERU CENTRAL,29,840,903,1743
MERU,MERU CENTRAL,25-29,4369,4444,8813
MERU,MERU CENTRAL,30,1179,1206,2385
MERU,MERU CENTRAL,31,873,889,1762
MERU,MERU CENTRAL,32,1040,1133,2173
MERU,MERU CENTRAL,33,1101,1083,2184
MERU,MERU CENTRAL,34,944,927,1871
MERU,MERU CENTRAL,30-34,5137,5238,10375
MERU,MERU CENTRAL,35,1407,1265,2672
MERU,MERU CENTRAL,36,936,898,1834
MERU,MERU CENTRAL,37,954,827,1781
MERU,MERU CENTRAL,38,808,724,1532
MERU,MERU CENTRAL,39,995,882,1877
MERU,MERU CENTRAL,35-39,5100,4596,9696
MERU,MERU CENTRAL,40,1147,979,2126
MERU,MERU CENTRAL,41,939,739,1678
MERU,MERU CENTRAL,42,864,769,1633
MERU,MERU CENTRAL,43,789,730,1519
MERU,MERU CENTRAL,44,718,616,1334
MERU,MERU CENTRAL,40-44,4457,3833,8290
MERU,MERU CENTRAL,45,962,916,1878
MERU,MERU CENTRAL,46,756,691,1447
MERU,MERU CENTRAL,47,730,750,1480
MERU,MERU CENTRAL,48,610,579,1189
MERU,MERU CENTRAL,49,702,705,1407
MERU,MERU CENTRAL,45-49,3760,3641,7401
MERU,MERU CENTRAL,50,781,781,1562
MERU,MERU CENTRAL,51,559,619,1178
MERU,MERU CENTRAL,52,470,441,911
MERU,MERU CENTRAL,53,391,377,768
MERU,MERU CENTRAL,54,414,435,849
MERU,MERU CENTRAL,50-54,2615,2653,5268
MERU,MERU CENTRAL,55,576,571,1147
MERU,MERU CENTRAL,56,559,564,1123
MERU,MERU CENTRAL,57,479,612,1091
MERU,MERU CENTRAL,58,438,521,959
MERU,MERU CENTRAL,59,558,574,1132
MERU,MERU CENTRAL,55-59,2610,2842,5452
MERU,MERU CENTRAL,60,615,706,1321
MERU,MERU CENTRAL,61,445,435,880
MERU,MERU CENTRAL,62,383,351,734
MERU,MERU CENTRAL,63,362,352,714
MERU,MERU CENTRAL,64,236,254,490
MERU,MERU CENTRAL,60-64,2041,2098,4139
MERU,MERU CENTRAL,65,389,463,852
MERU,MERU CENTRAL,66,240,271,511
MERU,MERU CENTRAL,67,477,505,982
MERU,MERU CENTRAL,68,224,226,450
MERU,MERU CENTRAL,69,339,376,715
MERU,MERU CENTRAL,65-69,1669,1841,3510
MERU,MERU CENTRAL,70,450,666,1116
MERU,MERU CENTRAL,71,254,267,521
MERU,MERU CENTRAL,72,234,220,454
MERU,MERU CENTRAL,73,177,176,353
MERU,MERU CENTRAL,74,162,264,426
MERU,MERU CENTRAL,70-74,1277,1593,2870
MERU,MERU CENTRAL,75,169,214,383
MERU,MERU CENTRAL,76,97,103,200
MERU,MERU CENTRAL,77,160,194,354
MERU,MERU CENTRAL,78,123,106,229
MERU,MERU CENTRAL,79,101,246,347
MERU,MERU CENTRAL,75-79,650,863,1513
MERU,MERU CENTRAL,80,170,356,526
MERU,MERU CENTRAL,81,80,122,202
MERU,MERU CENTRAL,82,67,84,151
MERU,MERU CENTRAL,83,68,97,165
MERU,MERU CENTRAL,84,88,140,228
MERU,MERU CENTRAL,80-84,473,799,1272
MERU,MERU CENTRAL,85,91,97,188
MERU,MERU CENTRAL,86,64,58,122
MERU,MERU CENTRAL,87,54,70,124
MERU,MERU CENTRAL,88,34,40,74
MERU,MERU CENTRAL,89,56,193,249
MERU,MERU CENTRAL,85-89,299,458,757
MERU,MERU CENTRAL,90,47,108,155
MERU,MERU CENTRAL,91,19,48,67
MERU,MERU CENTRAL,92,17,28,45
MERU,MERU CENTRAL,93,11,28,39
MERU,MERU CENTRAL,94,11,38,49
MERU,MERU CENTRAL,90-94,105,250,355
MERU,MERU CENTRAL,95,18,39,57
MERU,MERU CENTRAL,96,3,10,13
MERU,MERU CENTRAL,97,5,16,21
MERU,MERU CENTRAL,98,13,13,26
MERU,MERU CENTRAL,99,10,44,54
MERU,MERU CENTRAL,95-99,49,122,171
MERU,MERU CENTRAL,100+,27,70,97
MERU,MERU CENTRAL,Not Stated,4,3,7
MERU,TIGANIA CENTRAL,Total,51814,52916,104730
MERU,TIGANIA CENTRAL,0,1211,1160,2371
MERU,TIGANIA CENTRAL,1,1204,1191,2395
MERU,TIGANIA CENTRAL,2,1190,1204,2394
MERU,TIGANIA CENTRAL,3,1346,1297,2643
MERU,TIGANIA CENTRAL,4,1266,1283,2549
MERU,TIGANIA CENTRAL,0 - 4,6217,6135,12352
MERU,TIGANIA CENTRAL,5,1358,1274,2632
MERU,TIGANIA CENTRAL,6,1313,1297,2610
MERU,TIGANIA CENTRAL,7,1283,1368,2651
MERU,TIGANIA CENTRAL,8,1275,1296,2571
MERU,TIGANIA CENTRAL,9,1475,1492,2967
MERU,TIGANIA CENTRAL,05-Sep,6704,6727,13431
MERU,TIGANIA CENTRAL,10,1529,1476,3005
MERU,TIGANIA CENTRAL,11,1427,1474,2901
MERU,TIGANIA CENTRAL,12,1575,1531,3106
MERU,TIGANIA CENTRAL,13,1638,1541,3179
MERU,TIGANIA CENTRAL,14,1503,1443,2946
MERU,TIGANIA CENTRAL,Oct-14,7672,7465,15137
MERU,TIGANIA CENTRAL,15,1437,1454,2891
MERU,TIGANIA CENTRAL,16,1356,1369,2725
MERU,TIGANIA CENTRAL,17,1248,1204,2452
MERU,TIGANIA CENTRAL,18,1022,1091,2113
MERU,TIGANIA CENTRAL,19,1034,1120,2154
MERU,TIGANIA CENTRAL,15-19,6097,6238,12335
MERU,TIGANIA CENTRAL,20,1041,1077,2118
MERU,TIGANIA CENTRAL,21,739,804,1543
MERU,TIGANIA CENTRAL,22,769,845,1614
MERU,TIGANIA CENTRAL,23,805,806,1611
MERU,TIGANIA CENTRAL,24,735,713,1448
MERU,TIGANIA CENTRAL,20-24,4089,4245,8334
MERU,TIGANIA CENTRAL,25,867,884,1751
MERU,TIGANIA CENTRAL,26,630,676,1306
MERU,TIGANIA CENTRAL,27,657,734,1391
MERU,TIGANIA CENTRAL,28,617,575,1192
MERU,TIGANIA CENTRAL,29,589,611,1200
MERU,TIGANIA CENTRAL,25-29,3360,3480,6840
MERU,TIGANIA CENTRAL,30,933,981,1914
MERU,TIGANIA CENTRAL,31,582,612,1194
MERU,TIGANIA CENTRAL,32,706,798,1504
MERU,TIGANIA CENTRAL,33,689,857,1546
MERU,TIGANIA CENTRAL,34,641,686,1327
MERU,TIGANIA CENTRAL,30-34,3551,3934,7485
MERU,TIGANIA CENTRAL,35,1112,1099,2211
MERU,TIGANIA CENTRAL,36,488,485,973
MERU,TIGANIA CENTRAL,37,618,520,1138
MERU,TIGANIA CENTRAL,38,420,425,845
MERU,TIGANIA CENTRAL,39,502,502,1004
MERU,TIGANIA CENTRAL,35-39,3140,3031,6171
MERU,TIGANIA CENTRAL,40,845,784,1629
MERU,TIGANIA CENTRAL,41,547,478,1025
MERU,TIGANIA CENTRAL,42,502,361,863
MERU,TIGANIA CENTRAL,43,409,365,774
MERU,TIGANIA CENTRAL,44,381,338,719
MERU,TIGANIA CENTRAL,40-44,2684,2326,5010
MERU,TIGANIA CENTRAL,45,594,534,1128
MERU,TIGANIA CENTRAL,46,412,448,860
MERU,TIGANIA CENTRAL,47,430,442,872
MERU,TIGANIA CENTRAL,48,319,366,685
MERU,TIGANIA CENTRAL,49,372,379,751
MERU,TIGANIA CENTRAL,45-49,2127,2169,4296
MERU,TIGANIA CENTRAL,50,525,601,1126
MERU,TIGANIA CENTRAL,51,307,255,562
MERU,TIGANIA CENTRAL,52,181,170,351
MERU,TIGANIA CENTRAL,53,113,109,222
MERU,TIGANIA CENTRAL,54,176,164,340
MERU,TIGANIA CENTRAL,50-54,1302,1299,2601
MERU,TIGANIA CENTRAL,55,271,270,541
MERU,TIGANIA CENTRAL,56,258,289,547
MERU,TIGANIA CENTRAL,57,239,283,522
MERU,TIGANIA CENTRAL,58,236,258,494
MERU,TIGANIA CENTRAL,59,222,285,507
MERU,TIGANIA CENTRAL,55-59,1226,1385,2611
MERU,TIGANIA CENTRAL,60,445,488,933
MERU,TIGANIA CENTRAL,61,206,208,414
MERU,TIGANIA CENTRAL,62,185,178,363
MERU,TIGANIA CENTRAL,63,155,192,347
MERU,TIGANIA CENTRAL,64,115,149,264
MERU,TIGANIA CENTRAL,60-64,1106,1215,2321
MERU,TIGANIA CENTRAL,65,219,291,510
MERU,TIGANIA CENTRAL,66,150,156,306
MERU,TIGANIA CENTRAL,67,222,203,425
MERU,TIGANIA CENTRAL,68,117,128,245
MERU,TIGANIA CENTRAL,69,186,251,437
MERU,TIGANIA CENTRAL,65-69,894,1029,1923
MERU,TIGANIA CENTRAL,70,315,455,770
MERU,TIGANIA CENTRAL,71,132,163,295
MERU,TIGANIA CENTRAL,72,187,143,330
MERU,TIGANIA CENTRAL,73,81,90,171
MERU,TIGANIA CENTRAL,74,61,122,183
MERU,TIGANIA CENTRAL,70-74,776,973,1749
MERU,TIGANIA CENTRAL,75,111,121,232
MERU,TIGANIA CENTRAL,76,55,51,106
MERU,TIGANIA CENTRAL,77,68,78,146
MERU,TIGANIA CENTRAL,78,81,69,150
MERU,TIGANIA CENTRAL,79,76,119,195
MERU,TIGANIA CENTRAL,75-79,391,438,829
MERU,TIGANIA CENTRAL,80,93,191,284
MERU,TIGANIA CENTRAL,81,36,47,83
MERU,TIGANIA CENTRAL,82,28,32,60
MERU,TIGANIA CENTRAL,83,32,46,78
MERU,TIGANIA CENTRAL,84,31,52,83
MERU,TIGANIA CENTRAL,80-84,220,368,588
MERU,TIGANIA CENTRAL,85,38,53,91
MERU,TIGANIA CENTRAL,86,18,20,38
MERU,TIGANIA CENTRAL,87,28,31,59
MERU,TIGANIA CENTRAL,88,9,21,30
MERU,TIGANIA CENTRAL,89,35,80,115
MERU,TIGANIA CENTRAL,85-89,128,205,333
MERU,TIGANIA CENTRAL,90,28,64,92
MERU,TIGANIA CENTRAL,91,13,27,40
MERU,TIGANIA CENTRAL,92,6,9,15
MERU,TIGANIA CENTRAL,93,7,9,16
MERU,TIGANIA CENTRAL,94,3,20,23
MERU,TIGANIA CENTRAL,90-94,57,129,186
MERU,TIGANIA CENTRAL,95,14,22,36
MERU,TIGANIA CENTRAL,96,4,5,9
MERU,TIGANIA CENTRAL,97,7,2,9
MERU,TIGANIA CENTRAL,98,3,3,6
MERU,TIGANIA CENTRAL,99,12,30,42
MERU,TIGANIA CENTRAL,95-99,40,62,102
MERU,TIGANIA CENTRAL,100+,33,63,96
MERU,TIGANIA CENTRAL,Not Stated,-,-,-
MERU,TIGANIA EAST,Total,35352,37194,72546
MERU,TIGANIA EAST,0,755,791,1546
MERU,TIGANIA EAST,1,812,816,1628
MERU,TIGANIA EAST,2,855,838,1693
MERU,TIGANIA EAST,3,989,847,1836
MERU,TIGANIA EAST,4,929,889,1818
MERU,TIGANIA EAST,0 - 4,4340,4181,8521
MERU,TIGANIA EAST,5,992,911,1903
MERU,TIGANIA EAST,6,1015,959,1974
MERU,TIGANIA EAST,7,1006,966,1972
MERU,TIGANIA EAST,8,945,973,1918
MERU,TIGANIA EAST,9,1005,1091,2096
MERU,TIGANIA EAST,05-Sep,4963,4900,9863
MERU,TIGANIA EAST,10,1236,1186,2422
MERU,TIGANIA EAST,11,1060,1064,2124
MERU,TIGANIA EAST,12,1224,1220,2444
MERU,TIGANIA EAST,13,1230,1306,2536
MERU,TIGANIA EAST,14,1153,1070,2223
MERU,TIGANIA EAST,Oct-14,5903,5846,11749
MERU,TIGANIA EAST,15,1069,1050,2119
MERU,TIGANIA EAST,16,874,962,1836
MERU,TIGANIA EAST,17,858,945,1803
MERU,TIGANIA EAST,18,677,734,1411
MERU,TIGANIA EAST,19,695,728,1423
MERU,TIGANIA EAST,15-19,4173,4419,8592
MERU,TIGANIA EAST,20,698,763,1461
MERU,TIGANIA EAST,21,471,547,1018
MERU,TIGANIA EAST,22,516,558,1074
MERU,TIGANIA EAST,23,426,545,971
MERU,TIGANIA EAST,24,437,423,860
MERU,TIGANIA EAST,20-24,2548,2836,5384
MERU,TIGANIA EAST,25,587,525,1112
MERU,TIGANIA EAST,26,393,426,819
MERU,TIGANIA EAST,27,388,429,817
MERU,TIGANIA EAST,28,356,362,718
MERU,TIGANIA EAST,29,301,331,632
MERU,TIGANIA EAST,25-29,2025,2073,4098
MERU,TIGANIA EAST,30,561,616,1177
MERU,TIGANIA EAST,31,349,363,712
MERU,TIGANIA EAST,32,421,487,908
MERU,TIGANIA EAST,33,370,437,807
MERU,TIGANIA EAST,34,319,393,712
MERU,TIGANIA EAST,30-34,2020,2296,4316
MERU,TIGANIA EAST,35,635,736,1371
MERU,TIGANIA EAST,36,271,338,609
MERU,TIGANIA EAST,37,348,361,709
MERU,TIGANIA EAST,38,287,251,538
MERU,TIGANIA EAST,39,326,309,635
MERU,TIGANIA EAST,35-39,1867,1995,3862
MERU,TIGANIA EAST,40,491,494,985
MERU,TIGANIA EAST,41,343,325,668
MERU,TIGANIA EAST,42,282,299,581
MERU,TIGANIA EAST,43,308,323,631
MERU,TIGANIA EAST,44,220,260,480
MERU,TIGANIA EAST,40-44,1644,1701,3345
MERU,TIGANIA EAST,45,413,441,854
MERU,TIGANIA EAST,46,273,320,593
MERU,TIGANIA EAST,47,265,307,572
MERU,TIGANIA EAST,48,189,214,403
MERU,TIGANIA EAST,49,207,264,471
MERU,TIGANIA EAST,45-49,1347,1546,2893
MERU,TIGANIA EAST,50,385,475,860
MERU,TIGANIA EAST,51,183,186,369
MERU,TIGANIA EAST,52,147,126,273
MERU,TIGANIA EAST,53,111,102,213
MERU,TIGANIA EAST,54,177,116,293
MERU,TIGANIA EAST,50-54,1003,1005,2008
MERU,TIGANIA EAST,55,191,179,370
MERU,TIGANIA EAST,56,204,185,389
MERU,TIGANIA EAST,57,186,238,424
MERU,TIGANIA EAST,58,128,184,312
MERU,TIGANIA EAST,59,146,199,345
MERU,TIGANIA EAST,55-59,855,985,1840
MERU,TIGANIA EAST,60,278,373,651
MERU,TIGANIA EAST,61,141,180,321
MERU,TIGANIA EAST,62,120,132,252
MERU,TIGANIA EAST,63,111,137,248
MERU,TIGANIA EAST,64,82,94,176
MERU,TIGANIA EAST,60-64,732,916,1648
MERU,TIGANIA EAST,65,167,218,385
MERU,TIGANIA EAST,66,92,121,213
MERU,TIGANIA EAST,67,179,202,381
MERU,TIGANIA EAST,68,104,91,195
MERU,TIGANIA EAST,69,114,154,268
MERU,TIGANIA EAST,65-69,656,786,1442
MERU,TIGANIA EAST,70,223,317,540
MERU,TIGANIA EAST,71,92,119,211
MERU,TIGANIA EAST,72,134,134,268
MERU,TIGANIA EAST,73,76,72,148
MERU,TIGANIA EAST,74,43,84,127
MERU,TIGANIA EAST,70-74,568,726,1294
MERU,TIGANIA EAST,75,72,102,174
MERU,TIGANIA EAST,76,55,44,99
MERU,TIGANIA EAST,77,63,54,117
MERU,TIGANIA EAST,78,58,42,100
MERU,TIGANIA EAST,79,47,100,147
MERU,TIGANIA EAST,75-79,295,342,637
MERU,TIGANIA EAST,80,100,171,271
MERU,TIGANIA EAST,81,32,39,71
MERU,TIGANIA EAST,82,26,23,49
MERU,TIGANIA EAST,83,21,37,58
MERU,TIGANIA EAST,84,26,43,69
MERU,TIGANIA EAST,80-84,205,313,518
MERU,TIGANIA EAST,85,35,56,91
MERU,TIGANIA EAST,86,23,14,37
MERU,TIGANIA EAST,87,27,20,47
MERU,TIGANIA EAST,88,13,8,21
MERU,TIGANIA EAST,89,22,60,82
MERU,TIGANIA EAST,85-89,120,158,278
MERU,TIGANIA EAST,90,29,59,88
MERU,TIGANIA EAST,91,5,11,16
MERU,TIGANIA EAST,92,6,5,11
MERU,TIGANIA EAST,93,1,4,5
MERU,TIGANIA EAST,94,3,13,16
MERU,TIGANIA EAST,90-94,44,92,136
MERU,TIGANIA EAST,95,10,17,27
MERU,TIGANIA EAST,96,9,5,14
MERU,TIGANIA EAST,97,1,7,8
MERU,TIGANIA EAST,98,4,5,9
MERU,TIGANIA EAST,99,5,14,19
MERU,TIGANIA EAST,95-99,29,48,77
MERU,TIGANIA EAST,100+,15,29,44
MERU,TIGANIA EAST,Not Stated,-,1,1
MERU,TIGANIA WEST,Total,67715,72241,139956
MERU,TIGANIA WEST,0,1293,1383,2676
MERU,TIGANIA WEST,1,1493,1462,2955
MERU,TIGANIA WEST,2,1482,1409,2891
MERU,TIGANIA WEST,3,1520,1573,3093
MERU,TIGANIA WEST,4,1562,1568,3130
MERU,TIGANIA WEST,0 - 4,7350,7395,14745
MERU,TIGANIA WEST,5,1628,1552,3180
MERU,TIGANIA WEST,6,1590,1609,3199
MERU,TIGANIA WEST,7,1733,1636,3369
MERU,TIGANIA WEST,8,1634,1706,3340
MERU,TIGANIA WEST,9,1842,1888,3730
MERU,TIGANIA WEST,05-Sep,8427,8391,16818
MERU,TIGANIA WEST,10,2106,2031,4137
MERU,TIGANIA WEST,11,1825,1942,3767
MERU,TIGANIA WEST,12,2066,1906,3972
MERU,TIGANIA WEST,13,2114,2220,4334
MERU,TIGANIA WEST,14,2011,1985,3996
MERU,TIGANIA WEST,Oct-14,10122,10084,20206
MERU,TIGANIA WEST,15,2027,2050,4077
MERU,TIGANIA WEST,16,1681,1728,3409
MERU,TIGANIA WEST,17,1641,1634,3275
MERU,TIGANIA WEST,18,1450,1477,2927
MERU,TIGANIA WEST,19,1708,1533,3241
MERU,TIGANIA WEST,15-19,8507,8422,16929
MERU,TIGANIA WEST,20,1424,1368,2792
MERU,TIGANIA WEST,21,1011,1144,2155
MERU,TIGANIA WEST,22,936,947,1883
MERU,TIGANIA WEST,23,959,1053,2012
MERU,TIGANIA WEST,24,803,941,1744
MERU,TIGANIA WEST,20-24,5133,5453,10586
MERU,TIGANIA WEST,25,983,1027,2010
MERU,TIGANIA WEST,26,734,840,1574
MERU,TIGANIA WEST,27,817,921,1738
MERU,TIGANIA WEST,28,738,747,1485
MERU,TIGANIA WEST,29,675,719,1394
MERU,TIGANIA WEST,25-29,3947,4254,8201
MERU,TIGANIA WEST,30,1126,1242,2368
MERU,TIGANIA WEST,31,649,704,1353
MERU,TIGANIA WEST,32,847,1081,1928
MERU,TIGANIA WEST,33,811,1048,1859
MERU,TIGANIA WEST,34,604,859,1463
MERU,TIGANIA WEST,30-34,4037,4934,8971
MERU,TIGANIA WEST,35,1408,1590,2998
MERU,TIGANIA WEST,36,686,709,1395
MERU,TIGANIA WEST,37,788,692,1480
MERU,TIGANIA WEST,38,604,680,1284
MERU,TIGANIA WEST,39,705,755,1460
MERU,TIGANIA WEST,35-39,4191,4426,8617
MERU,TIGANIA WEST,40,1095,1195,2290
MERU,TIGANIA WEST,41,671,675,1346
MERU,TIGANIA WEST,42,659,622,1281
MERU,TIGANIA WEST,43,572,652,1224
MERU,TIGANIA WEST,44,509,554,1063
MERU,TIGANIA WEST,40-44,3506,3698,7204
MERU,TIGANIA WEST,45,818,923,1741
MERU,TIGANIA WEST,46,614,673,1287
MERU,TIGANIA WEST,47,536,671,1207
MERU,TIGANIA WEST,48,391,471,862
MERU,TIGANIA WEST,49,488,541,1029
MERU,TIGANIA WEST,45-49,2847,3279,6126
MERU,TIGANIA WEST,50,779,930,1709
MERU,TIGANIA WEST,51,445,425,870
MERU,TIGANIA WEST,52,322,261,583
MERU,TIGANIA WEST,53,221,209,430
MERU,TIGANIA WEST,54,292,274,566
MERU,TIGANIA WEST,50-54,2059,2099,4158
MERU,TIGANIA WEST,55,455,488,943
MERU,TIGANIA WEST,56,461,522,983
MERU,TIGANIA WEST,57,421,515,936
MERU,TIGANIA WEST,58,312,429,741
MERU,TIGANIA WEST,59,288,455,743
MERU,TIGANIA WEST,55-59,1937,2409,4346
MERU,TIGANIA WEST,60,604,733,1337
MERU,TIGANIA WEST,61,303,353,656
MERU,TIGANIA WEST,62,254,304,558
MERU,TIGANIA WEST,63,236,259,495
MERU,TIGANIA WEST,64,203,224,427
MERU,TIGANIA WEST,60-64,1600,1873,3473
MERU,TIGANIA WEST,65,395,501,896
MERU,TIGANIA WEST,66,191,246,437
MERU,TIGANIA WEST,67,349,358,707
MERU,TIGANIA WEST,68,204,187,391
MERU,TIGANIA WEST,69,289,376,665
MERU,TIGANIA WEST,65-69,1428,1668,3096
MERU,TIGANIA WEST,70,512,754,1266
MERU,TIGANIA WEST,71,175,243,418
MERU,TIGANIA WEST,72,203,219,422
MERU,TIGANIA WEST,73,182,210,392
MERU,TIGANIA WEST,74,119,210,329
MERU,TIGANIA WEST,70-74,1191,1636,2827
MERU,TIGANIA WEST,75,150,201,351
MERU,TIGANIA WEST,76,90,97,187
MERU,TIGANIA WEST,77,111,103,214
MERU,TIGANIA WEST,78,123,104,227
MERU,TIGANIA WEST,79,102,224,326
MERU,TIGANIA WEST,75-79,576,729,1305
MERU,TIGANIA WEST,80,202,368,570
MERU,TIGANIA WEST,81,62,74,136
MERU,TIGANIA WEST,82,56,52,108
MERU,TIGANIA WEST,83,66,81,147
MERU,TIGANIA WEST,84,53,94,147
MERU,TIGANIA WEST,80-84,439,669,1108
MERU,TIGANIA WEST,85,54,102,156
MERU,TIGANIA WEST,86,51,43,94
MERU,TIGANIA WEST,87,43,51,94
MERU,TIGANIA WEST,88,27,31,58
MERU,TIGANIA WEST,89,51,138,189
MERU,TIGANIA WEST,85-89,226,365,591
MERU,TIGANIA WEST,90,48,125,173
MERU,TIGANIA WEST,91,16,25,41
MERU,TIGANIA WEST,92,9,21,30
MERU,TIGANIA WEST,93,9,18,27
MERU,TIGANIA WEST,94,17,34,51
MERU,TIGANIA WEST,90-94,99,223,322
MERU,TIGANIA WEST,95,20,33,53
MERU,TIGANIA WEST,96,6,12,18
MERU,TIGANIA WEST,97,10,19,29
MERU,TIGANIA WEST,98,10,13,23
MERU,TIGANIA WEST,99,16,35,51
MERU,TIGANIA WEST,95-99,62,112,174
MERU,TIGANIA WEST,100+,31,121,152
MERU,TIGANIA WEST,Not Stated,-,1,1
MERU,MERU NATIONAL PARK,Total,283,102,385
MERU,MERU NATIONAL PARK,0,7,5,12
MERU,MERU NATIONAL PARK,1,3,1,4
MERU,MERU NATIONAL PARK,2,3,5,8
MERU,MERU NATIONAL PARK,3,2,3,5
MERU,MERU NATIONAL PARK,4,2,2,4
MERU,MERU NATIONAL PARK,0 - 4,17,16,33
MERU,MERU NATIONAL PARK,5,3,1,4
MERU,MERU NATIONAL PARK,6,4,2,6
MERU,MERU NATIONAL PARK,7,1,-,1
MERU,MERU NATIONAL PARK,8,1,-,1
MERU,MERU NATIONAL PARK,9,2,1,3
MERU,MERU NATIONAL PARK,05-Sep,11,4,15
MERU,MERU NATIONAL PARK,10,-,3,3
MERU,MERU NATIONAL PARK,11,2,3,5
MERU,MERU NATIONAL PARK,12,-,2,2
MERU,MERU NATIONAL PARK,13,2,-,2
MERU,MERU NATIONAL PARK,14,1,1,2
MERU,MERU NATIONAL PARK,Oct-14,5,9,14
MERU,MERU NATIONAL PARK,15,1,2,3
MERU,MERU NATIONAL PARK,16,1,-,1
MERU,MERU NATIONAL PARK,17,1,3,4
MERU,MERU NATIONAL PARK,18,-,-,-
MERU,MERU NATIONAL PARK,19,2,-,2
MERU,MERU NATIONAL PARK,15-19,5,5,10
MERU,MERU NATIONAL PARK,20,-,3,3
MERU,MERU NATIONAL PARK,21,3,3,6
MERU,MERU NATIONAL PARK,22,-,3,3
MERU,MERU NATIONAL PARK,23,1,3,4
MERU,MERU NATIONAL PARK,24,7,1,8
MERU,MERU NATIONAL PARK,20-24,11,13,24
MERU,MERU NATIONAL PARK,25,7,7,14
MERU,MERU NATIONAL PARK,26,11,4,15
MERU,MERU NATIONAL PARK,27,14,8,22
MERU,MERU NATIONAL PARK,28,11,2,13
MERU,MERU NATIONAL PARK,29,24,4,28
MERU,MERU NATIONAL PARK,25-29,67,25,92
MERU,MERU NATIONAL PARK,30,11,3,14
MERU,MERU NATIONAL PARK,31,9,3,12
MERU,MERU NATIONAL PARK,32,9,2,11
MERU,MERU NATIONAL PARK,33,5,2,7
MERU,MERU NATIONAL PARK,34,12,3,15
MERU,MERU NATIONAL PARK,30-34,46,13,59
MERU,MERU NATIONAL PARK,35,7,4,11
MERU,MERU NATIONAL PARK,36,14,-,14
MERU,MERU NATIONAL PARK,37,9,-,9
MERU,MERU NATIONAL PARK,38,10,2,12
MERU,MERU NATIONAL PARK,39,7,1,8
MERU,MERU NATIONAL PARK,35-39,47,7,54
MERU,MERU NATIONAL PARK,40,8,1,9
MERU,MERU NATIONAL PARK,41,5,2,7
MERU,MERU NATIONAL PARK,42,8,-,8
MERU,MERU NATIONAL PARK,43,3,2,5
MERU,MERU NATIONAL PARK,44,3,-,3
MERU,MERU NATIONAL PARK,40-44,27,5,32
MERU,MERU NATIONAL PARK,45,3,1,4
MERU,MERU NATIONAL PARK,46,8,1,9
MERU,MERU NATIONAL PARK,47,3,1,4
MERU,MERU NATIONAL PARK,48,4,-,4
MERU,MERU NATIONAL PARK,49,7,-,7
MERU,MERU NATIONAL PARK,45-49,25,3,28
MERU,MERU NATIONAL PARK,50,2,-,2
MERU,MERU NATIONAL PARK,51,3,-,3
MERU,MERU NATIONAL PARK,52,4,-,4
MERU,MERU NATIONAL PARK,53,3,-,3
MERU,MERU NATIONAL PARK,54,-,-,-
MERU,MERU NATIONAL PARK,50-54,12,-,12
MERU,MERU NATIONAL PARK,55,3,-,3
MERU,MERU NATIONAL PARK,56,1,-,1
MERU,MERU NATIONAL PARK,57,1,-,1
MERU,MERU NATIONAL PARK,58,-,-,-
MERU,MERU NATIONAL PARK,59,1,2,3
MERU,MERU NATIONAL PARK,55-59,6,2,8
MERU,MERU NATIONAL PARK,60,1,-,1
MERU,MERU NATIONAL PARK,61,1,-,1
MERU,MERU NATIONAL PARK,62,1,-,1
MERU,MERU NATIONAL PARK,63,-,-,-
MERU,MERU NATIONAL PARK,64,-,-,-
MERU,MERU NATIONAL PARK,60-64,3,-,3
MERU,MERU NATIONAL PARK,65,-,-,-
MERU,MERU NATIONAL PARK,66,-,-,-
MERU,MERU NATIONAL PARK,67,-,-,-
MERU,MERU NATIONAL PARK,68,-,-,-
MERU,MERU NATIONAL PARK,69,1,-,1
MERU,MERU NATIONAL PARK,65-69,1,-,1
MERU,MERU NATIONAL PARK,70,-,-,-
MERU,MERU NATIONAL PARK,71,-,-,-
MERU,MERU NATIONAL PARK,72,-,-,-
MERU,MERU NATIONAL PARK,73,-,-,-
MERU,MERU NATIONAL PARK,74,-,-,-
MERU,MERU NATIONAL PARK,70-74,-,-,-
MERU,MERU NATIONAL PARK,75,-,-,-
MERU,MERU NATIONAL PARK,76,-,-,-
MERU,MERU NATIONAL PARK,77,-,-,-
MERU,MERU NATIONAL PARK,78,-,-,-
MERU,MERU NATIONAL PARK,79,-,-,-
MERU,MERU NATIONAL PARK,75-79,-,-,-
MERU,MERU NATIONAL PARK,80,-,-,-
MERU,MERU NATIONAL PARK,81,-,-,-
MERU,MERU NATIONAL PARK,82,-,-,-
MERU,MERU NATIONAL PARK,83,-,-,-
MERU,MERU NATIONAL PARK,84,-,-,-
MERU,MERU NATIONAL PARK,80-84,-,-,-
MERU,MERU NATIONAL PARK,85,-,-,-
MERU,MERU NATIONAL PARK,86,-,-,-
MERU,MERU NATIONAL PARK,87,-,-,-
MERU,MERU NATIONAL PARK,88,-,-,-
MERU,MERU NATIONAL PARK,89,-,-,-
MERU,MERU NATIONAL PARK,85-89,-,-,-
MERU,MERU NATIONAL PARK,90,-,-,-
MERU,MERU NATIONAL PARK,91,-,-,-
MERU,MERU NATIONAL PARK,92,-,-,-
MERU,MERU NATIONAL PARK,93,-,-,-
MERU,MERU NATIONAL PARK,94,-,-,-
MERU,MERU NATIONAL PARK,90-94,-,-,-
MERU,MERU NATIONAL PARK,95,-,-,-
MERU,MERU NATIONAL PARK,96,-,-,-
MERU,MERU NATIONAL PARK,97,-,-,-
MERU,MERU NATIONAL PARK,98,-,-,-
MERU,MERU NATIONAL PARK,99,-,-,-
MERU,MERU NATIONAL PARK,95-99,-,-,-
MERU,MERU NATIONAL PARK,100+,-,-,-
MERU,MERU NATIONAL PARK,Not Stated,-,-,-
MERU,MT. KENYA FOREST,Total,409,54,463
MERU,MT. KENYA FOREST,0,-,3,3
MERU,MT. KENYA FOREST,1,-,-,-
MERU,MT. KENYA FOREST,2,-,1,1
MERU,MT. KENYA FOREST,3,1,-,1
MERU,MT. KENYA FOREST,4,-,1,1
MERU,MT. KENYA FOREST,0 - 4,1,5,6
MERU,MT. KENYA FOREST,5,-,-,-
MERU,MT. KENYA FOREST,6,1,-,1
MERU,MT. KENYA FOREST,7,-,1,1
MERU,MT. KENYA FOREST,8,-,1,1
MERU,MT. KENYA FOREST,9,-,-,-
MERU,MT. KENYA FOREST,05-Sep,1,2,3
MERU,MT. KENYA FOREST,10,2,-,2
MERU,MT. KENYA FOREST,11,1,-,1
MERU,MT. KENYA FOREST,12,-,-,-
MERU,MT. KENYA FOREST,13,2,-,2
MERU,MT. KENYA FOREST,14,1,-,1
MERU,MT. KENYA FOREST,Oct-14,6,-,6
MERU,MT. KENYA FOREST,15,-,1,1
MERU,MT. KENYA FOREST,16,4,-,4
MERU,MT. KENYA FOREST,17,1,-,1
MERU,MT. KENYA FOREST,18,3,-,3
MERU,MT. KENYA FOREST,19,1,-,1
MERU,MT. KENYA FOREST,15-19,9,1,10
MERU,MT. KENYA FOREST,20,1,-,1
MERU,MT. KENYA FOREST,21,6,1,7
MERU,MT. KENYA FOREST,22,7,-,7
MERU,MT. KENYA FOREST,23,4,-,4
MERU,MT. KENYA FOREST,24,3,3,6
MERU,MT. KENYA FOREST,20-24,21,4,25
MERU,MT. KENYA FOREST,25,15,3,18
MERU,MT. KENYA FOREST,26,7,3,10
MERU,MT. KENYA FOREST,27,10,-,10
MERU,MT. KENYA FOREST,28,13,2,15
MERU,MT. KENYA FOREST,29,14,1,15
MERU,MT. KENYA FOREST,25-29,59,9,68
MERU,MT. KENYA FOREST,30,12,1,13
MERU,MT. KENYA FOREST,31,17,1,18
MERU,MT. KENYA FOREST,32,13,2,15
MERU,MT. KENYA FOREST,33,17,3,20
MERU,MT. KENYA FOREST,34,8,1,9
MERU,MT. KENYA FOREST,30-34,67,8,75
MERU,MT. KENYA FOREST,35,13,4,17
MERU,MT. KENYA FOREST,36,10,1,11
MERU,MT. KENYA FOREST,37,7,-,7
MERU,MT. KENYA FOREST,38,7,1,8
MERU,MT. KENYA FOREST,39,11,2,13
MERU,MT. KENYA FOREST,35-39,48,8,56
MERU,MT. KENYA FOREST,40,18,1,19
MERU,MT. KENYA FOREST,41,8,1,9
MERU,MT. KENYA FOREST,42,11,1,12
MERU,MT. KENYA FOREST,43,11,1,12
MERU,MT. KENYA FOREST,44,6,4,10
MERU,MT. KENYA FOREST,40-44,54,8,62
MERU,MT. KENYA FOREST,45,6,1,7
MERU,MT. KENYA FOREST,46,13,2,15
MERU,MT. KENYA FOREST,47,8,1,9
MERU,MT. KENYA FOREST,48,8,1,9
MERU,MT. KENYA FOREST,49,9,2,11
MERU,MT. KENYA FOREST,45-49,44,7,51
MERU,MT. KENYA FOREST,50,10,-,10
MERU,MT. KENYA FOREST,51,8,-,8
MERU,MT. KENYA FOREST,52,5,-,5
MERU,MT. KENYA FOREST,53,1,-,1
MERU,MT. KENYA FOREST,54,6,-,6
MERU,MT. KENYA FOREST,50-54,30,-,30
MERU,MT. KENYA FOREST,55,1,-,1
MERU,MT. KENYA FOREST,56,5,1,6
MERU,MT. KENYA FOREST,57,6,-,6
MERU,MT. KENYA FOREST,58,2,-,2
MERU,MT. KENYA FOREST,59,5,-,5
MERU,MT. KENYA FOREST,55-59,19,1,20
MERU,MT. KENYA FOREST,60,6,-,6
MERU,MT. KENYA FOREST,61,4,1,5
MERU,MT. KENYA FOREST,62,4,-,4
MERU,MT. KENYA FOREST,63,7,-,7
MERU,MT. KENYA FOREST,64,1,-,1
MERU,MT. KENYA FOREST,60-64,22,1,23
MERU,MT. KENYA FOREST,65,5,-,5
MERU,MT. KENYA FOREST,66,2,-,2
MERU,MT. KENYA FOREST,67,7,-,7
MERU,MT. KENYA FOREST,68,2,-,2
MERU,MT. KENYA FOREST,69,2,-,2
MERU,MT. KENYA FOREST,65-69,18,-,18
MERU,MT. KENYA FOREST,70,2,-,2
MERU,MT. KENYA FOREST,71,1,-,1
MERU,MT. KENYA FOREST,72,3,-,3
MERU,MT. KENYA FOREST,73,-,-,-
MERU,MT. KENYA FOREST,74,-,-,-
MERU,MT. KENYA FOREST,70-74,6,-,6
MERU,MT. KENYA FOREST,75,1,-,1
MERU,MT. KENYA FOREST,76,-,-,-
MERU,MT. KENYA FOREST,77,1,-,1
MERU,MT. KENYA FOREST,78,1,-,1
MERU,MT. KENYA FOREST,79,1,-,1
MERU,MT. KENYA FOREST,75-79,4,-,4
MERU,MT. KENYA FOREST,80,-,-,-
MERU,MT. KENYA FOREST,81,-,-,-
MERU,MT. KENYA FOREST,82,-,-,-
MERU,MT. KENYA FOREST,83,-,-,-
MERU,MT. KENYA FOREST,84,-,-,-
MERU,MT. KENYA FOREST,80-84,-,-,-
MERU,MT. KENYA FOREST,85,-,-,-
MERU,MT. KENYA FOREST,86,-,-,-
MERU,MT. KENYA FOREST,87,-,-,-
MERU,MT. KENYA FOREST,88,-,-,-
MERU,MT. KENYA FOREST,89,-,-,-
MERU,MT. KENYA FOREST,85-89,-,-,-
MERU,MT. KENYA FOREST,90,-,-,-
MERU,MT. KENYA FOREST,91,-,-,-
MERU,MT. KENYA FOREST,92,-,-,-
MERU,MT. KENYA FOREST,93,-,-,-
MERU,MT. KENYA FOREST,94,-,-,-
MERU,MT. KENYA FOREST,90-94,-,-,-
MERU,MT. KENYA FOREST,95,-,-,-
MERU,MT. KENYA FOREST,96,-,-,-
MERU,MT. KENYA FOREST,97,-,-,-
MERU,MT. KENYA FOREST,98,-,-,-
MERU,MT. KENYA FOREST,99,-,-,-
MERU,MT. KENYA FOREST,95-99,-,-,-
MERU,MT. KENYA FOREST,100+,-,-,-
MERU,MT. KENYA FOREST,Not Stated,-,-,-
MIGORI,ALL,Total,536187,580214,1116401
MIGORI,ALL,0,14715,14978,29693
MIGORI,ALL,1,15558,15778,31336
MIGORI,ALL,2,15719,16144,31863
MIGORI,ALL,3,17042,17249,34291
MIGORI,ALL,4,17103,17140,34243
MIGORI,ALL,0 - 4,80137,81289,161426
MIGORI,ALL,5,17591,17613,35204
MIGORI,ALL,6,17559,17792,35351
MIGORI,ALL,7,16364,16378,32742
MIGORI,ALL,8,16265,16760,33025
MIGORI,ALL,9,17702,17698,35400
MIGORI,ALL,05-Sep,85481,86241,171722
MIGORI,ALL,10,19279,19501,38780
MIGORI,ALL,11,16505,17385,33890
MIGORI,ALL,12,19277,18862,38139
MIGORI,ALL,13,17905,18155,36060
MIGORI,ALL,14,16436,16325,32761
MIGORI,ALL,Oct-14,89402,90228,179630
MIGORI,ALL,15,16041,16066,32107
MIGORI,ALL,16,13979,14078,28057
MIGORI,ALL,17,13367,13203,26570
MIGORI,ALL,18,11094,11285,22379
MIGORI,ALL,19,12363,13202,25565
MIGORI,ALL,15-19,66844,67834,134678
MIGORI,ALL,20,10942,13369,24311
MIGORI,ALL,21,8907,11108,20015
MIGORI,ALL,22,8276,10686,18962
MIGORI,ALL,23,8810,10994,19804
MIGORI,ALL,24,8048,9698,17746
MIGORI,ALL,20-24,44983,55855,100838
MIGORI,ALL,25,9683,11211,20894
MIGORI,ALL,26,7327,9181,16508
MIGORI,ALL,27,7731,9303,17034
MIGORI,ALL,28,5705,7200,12905
MIGORI,ALL,29,5515,6981,12496
MIGORI,ALL,25-29,35961,43876,79837
MIGORI,ALL,30,8456,10778,19234
MIGORI,ALL,31,5719,7211,12930
MIGORI,ALL,32,6861,8557,15418
MIGORI,ALL,33,5859,7428,13287
MIGORI,ALL,34,5498,6209,11707
MIGORI,ALL,30-34,32393,40183,72576
MIGORI,ALL,35,7397,7484,14881
MIGORI,ALL,36,5013,4488,9501
MIGORI,ALL,37,4841,4305,9146
MIGORI,ALL,38,3297,3135,6432
MIGORI,ALL,39,3968,3452,7420
MIGORI,ALL,35-39,24516,22864,47380
MIGORI,ALL,40,5258,5267,10525
MIGORI,ALL,41,4348,4271,8619
MIGORI,ALL,42,4050,4219,8269
MIGORI,ALL,43,3713,3802,7515
MIGORI,ALL,44,2832,2926,5758
MIGORI,ALL,40-44,20201,20485,40686
MIGORI,ALL,45,4474,4630,9104
MIGORI,ALL,46,3074,3380,6454
MIGORI,ALL,47,3435,3969,7404
MIGORI,ALL,48,1834,2182,4016
MIGORI,ALL,49,2257,2533,4790
MIGORI,ALL,45-49,15074,16694,31768
MIGORI,ALL,50,2960,3709,6669
MIGORI,ALL,51,2128,2552,4680
MIGORI,ALL,52,1682,2063,3745
MIGORI,ALL,53,1500,1656,3156
MIGORI,ALL,54,1851,2008,3859
MIGORI,ALL,50-54,10121,11988,22109
MIGORI,ALL,55,1973,2397,4370
MIGORI,ALL,56,2055,2566,4621
MIGORI,ALL,57,1962,3071,5033
MIGORI,ALL,58,1317,1594,2911
MIGORI,ALL,59,1511,2066,3577
MIGORI,ALL,55-59,8818,11694,20512
MIGORI,ALL,60,2176,3026,5202
MIGORI,ALL,61,1706,2178,3884
MIGORI,ALL,62,1253,1474,2727
MIGORI,ALL,63,1366,1588,2954
MIGORI,ALL,64,988,1354,2342
MIGORI,ALL,60-64,7489,9620,17109
MIGORI,ALL,65,1384,2000,3384
MIGORI,ALL,66,996,1247,2243
MIGORI,ALL,67,1415,2070,3485
MIGORI,ALL,68,629,780,1409
MIGORI,ALL,69,1004,1432,2436
MIGORI,ALL,65-69,5428,7529,12957
MIGORI,ALL,70,1340,2093,3433
MIGORI,ALL,71,898,1131,2029
MIGORI,ALL,72,757,830,1587
MIGORI,ALL,73,567,696,1263
MIGORI,ALL,74,598,857,1455
MIGORI,ALL,70-74,4160,5607,9767
MIGORI,ALL,75,537,803,1340
MIGORI,ALL,76,429,628,1057
MIGORI,ALL,77,589,854,1443
MIGORI,ALL,78,282,377,659
MIGORI,ALL,79,375,781,1156
MIGORI,ALL,75-79,2212,3443,5655
MIGORI,ALL,80,429,910,1339
MIGORI,ALL,81,324,464,788
MIGORI,ALL,82,299,352,651
MIGORI,ALL,83,280,356,636
MIGORI,ALL,84,232,391,623
MIGORI,ALL,80-84,1564,2473,4037
MIGORI,ALL,85,212,340,552
MIGORI,ALL,86,168,199,367
MIGORI,ALL,87,260,358,618
MIGORI,ALL,88,91,160,251
MIGORI,ALL,89,156,372,528
MIGORI,ALL,85-89,887,1429,2316
MIGORI,ALL,90,108,202,310
MIGORI,ALL,91,76,110,186
MIGORI,ALL,92,51,55,106
MIGORI,ALL,93,38,59,97
MIGORI,ALL,94,30,67,97
MIGORI,ALL,90-94,303,493,796
MIGORI,ALL,95,58,103,161
MIGORI,ALL,96,28,38,66
MIGORI,ALL,97,18,40,58
MIGORI,ALL,98,13,25,38
MIGORI,ALL,99,24,50,74
MIGORI,ALL,95-99,141,256,397
MIGORI,ALL,100+,67,121,188
MIGORI,ALL,Not Stated,5,12,17
MIGORI,AWENDO,Total,56348,60939,117287
MIGORI,AWENDO,0,1559,1617,3176
MIGORI,AWENDO,1,1535,1524,3059
MIGORI,AWENDO,2,1509,1480,2989
MIGORI,AWENDO,3,1604,1642,3246
MIGORI,AWENDO,4,1775,1688,3463
MIGORI,AWENDO,0 - 4,7982,7951,15933
MIGORI,AWENDO,5,1724,1717,3441
MIGORI,AWENDO,6,1793,1804,3597
MIGORI,AWENDO,7,1700,1696,3396
MIGORI,AWENDO,8,1608,1684,3292
MIGORI,AWENDO,9,1877,1875,3752
MIGORI,AWENDO,05-Sep,8702,8776,17478
MIGORI,AWENDO,10,2028,1945,3973
MIGORI,AWENDO,11,1775,1845,3620
MIGORI,AWENDO,12,2079,1997,4076
MIGORI,AWENDO,13,1939,1972,3911
MIGORI,AWENDO,14,1761,1820,3581
MIGORI,AWENDO,Oct-14,9582,9579,19161
MIGORI,AWENDO,15,1622,1723,3345
MIGORI,AWENDO,16,1560,1497,3057
MIGORI,AWENDO,17,1408,1428,2836
MIGORI,AWENDO,18,1146,1199,2345
MIGORI,AWENDO,19,1282,1318,2600
MIGORI,AWENDO,15-19,7018,7165,14183
MIGORI,AWENDO,20,1085,1346,2431
MIGORI,AWENDO,21,966,1188,2154
MIGORI,AWENDO,22,819,1053,1872
MIGORI,AWENDO,23,864,1110,1974
MIGORI,AWENDO,24,792,1009,1801
MIGORI,AWENDO,20-24,4526,5706,10232
MIGORI,AWENDO,25,925,1092,2017
MIGORI,AWENDO,26,791,981,1772
MIGORI,AWENDO,27,819,1063,1882
MIGORI,AWENDO,28,595,705,1300
MIGORI,AWENDO,29,602,824,1426
MIGORI,AWENDO,25-29,3732,4665,8397
MIGORI,AWENDO,30,839,1147,1986
MIGORI,AWENDO,31,671,824,1495
MIGORI,AWENDO,32,803,995,1798
MIGORI,AWENDO,33,627,821,1448
MIGORI,AWENDO,34,614,735,1349
MIGORI,AWENDO,30-34,3554,4522,8076
MIGORI,AWENDO,35,826,756,1582
MIGORI,AWENDO,36,609,510,1119
MIGORI,AWENDO,37,556,462,1018
MIGORI,AWENDO,38,364,340,704
MIGORI,AWENDO,39,494,394,888
MIGORI,AWENDO,35-39,2849,2462,5311
MIGORI,AWENDO,40,501,507,1008
MIGORI,AWENDO,41,491,420,911
MIGORI,AWENDO,42,470,438,908
MIGORI,AWENDO,43,470,414,884
MIGORI,AWENDO,44,385,306,691
MIGORI,AWENDO,40-44,2317,2085,4402
MIGORI,AWENDO,45,439,470,909
MIGORI,AWENDO,46,317,319,636
MIGORI,AWENDO,47,373,474,847
MIGORI,AWENDO,48,208,272,480
MIGORI,AWENDO,49,269,293,562
MIGORI,AWENDO,45-49,1606,1828,3434
MIGORI,AWENDO,50,288,381,669
MIGORI,AWENDO,51,222,238,460
MIGORI,AWENDO,52,183,199,382
MIGORI,AWENDO,53,184,179,363
MIGORI,AWENDO,54,199,200,399
MIGORI,AWENDO,50-54,1076,1197,2273
MIGORI,AWENDO,55,200,250,450
MIGORI,AWENDO,56,230,302,532
MIGORI,AWENDO,57,229,386,615
MIGORI,AWENDO,58,131,183,314
MIGORI,AWENDO,59,194,249,443
MIGORI,AWENDO,55-59,984,1370,2354
MIGORI,AWENDO,60,218,359,577
MIGORI,AWENDO,61,170,274,444
MIGORI,AWENDO,62,157,208,365
MIGORI,AWENDO,63,146,201,347
MIGORI,AWENDO,64,105,159,264
MIGORI,AWENDO,60-64,796,1201,1997
MIGORI,AWENDO,65,161,205,366
MIGORI,AWENDO,66,115,170,285
MIGORI,AWENDO,67,144,266,410
MIGORI,AWENDO,68,63,76,139
MIGORI,AWENDO,69,118,134,252
MIGORI,AWENDO,65-69,601,851,1452
MIGORI,AWENDO,70,154,206,360
MIGORI,AWENDO,71,101,130,231
MIGORI,AWENDO,72,102,84,186
MIGORI,AWENDO,73,60,77,137
MIGORI,AWENDO,74,51,87,138
MIGORI,AWENDO,70-74,468,584,1052
MIGORI,AWENDO,75,61,96,157
MIGORI,AWENDO,76,47,93,140
MIGORI,AWENDO,77,61,119,180
MIGORI,AWENDO,78,31,42,73
MIGORI,AWENDO,79,35,102,137
MIGORI,AWENDO,75-79,235,452,687
MIGORI,AWENDO,80,47,110,157
MIGORI,AWENDO,81,36,51,87
MIGORI,AWENDO,82,27,47,74
MIGORI,AWENDO,83,41,44,85
MIGORI,AWENDO,84,27,44,71
MIGORI,AWENDO,80-84,178,296,474
MIGORI,AWENDO,85,24,42,66
MIGORI,AWENDO,86,20,22,42
MIGORI,AWENDO,87,25,43,68
MIGORI,AWENDO,88,9,25,34
MIGORI,AWENDO,89,12,31,43
MIGORI,AWENDO,85-89,90,163,253
MIGORI,AWENDO,90,14,29,43
MIGORI,AWENDO,91,7,7,14
MIGORI,AWENDO,92,5,7,12
MIGORI,AWENDO,93,2,5,7
MIGORI,AWENDO,94,2,7,9
MIGORI,AWENDO,90-94,30,55,85
MIGORI,AWENDO,95,8,11,19
MIGORI,AWENDO,96,-,3,3
MIGORI,AWENDO,97,1,3,4
MIGORI,AWENDO,98,3,1,4
MIGORI,AWENDO,99,2,4,6
MIGORI,AWENDO,95-99,14,22,36
MIGORI,AWENDO,100+,6,6,12
MIGORI,AWENDO,Not Stated,2,3,5
MIGORI,KURIA EAST,Total,46969,49894,96863
MIGORI,KURIA EAST,0,1205,1295,2500
MIGORI,KURIA EAST,1,1412,1488,2900
MIGORI,KURIA EAST,2,1475,1556,3031
MIGORI,KURIA EAST,3,1672,1633,3305
MIGORI,KURIA EAST,4,1665,1584,3249
MIGORI,KURIA EAST,0 - 4,7429,7556,14985
MIGORI,KURIA EAST,5,1679,1676,3355
MIGORI,KURIA EAST,6,1666,1662,3328
MIGORI,KURIA EAST,7,1462,1501,2963
MIGORI,KURIA EAST,8,1665,1706,3371
MIGORI,KURIA EAST,9,1745,1647,3392
MIGORI,KURIA EAST,05-Sep,8217,8192,16409
MIGORI,KURIA EAST,10,1935,2004,3939
MIGORI,KURIA EAST,11,1500,1566,3066
MIGORI,KURIA EAST,12,1751,1759,3510
MIGORI,KURIA EAST,13,1628,1559,3187
MIGORI,KURIA EAST,14,1517,1538,3055
MIGORI,KURIA EAST,Oct-14,8331,8426,16757
MIGORI,KURIA EAST,15,1479,1452,2931
MIGORI,KURIA EAST,16,1319,1153,2472
MIGORI,KURIA EAST,17,1189,1059,2248
MIGORI,KURIA EAST,18,1072,1023,2095
MIGORI,KURIA EAST,19,1115,1102,2217
MIGORI,KURIA EAST,15-19,6174,5789,11963
MIGORI,KURIA EAST,20,1057,1222,2279
MIGORI,KURIA EAST,21,696,810,1506
MIGORI,KURIA EAST,22,717,846,1563
MIGORI,KURIA EAST,23,731,830,1561
MIGORI,KURIA EAST,24,596,754,1350
MIGORI,KURIA EAST,20-24,3797,4462,8259
MIGORI,KURIA EAST,25,818,944,1762
MIGORI,KURIA EAST,26,580,669,1249
MIGORI,KURIA EAST,27,475,629,1104
MIGORI,KURIA EAST,28,472,663,1135
MIGORI,KURIA EAST,29,380,468,848
MIGORI,KURIA EAST,25-29,2725,3373,6098
MIGORI,KURIA EAST,30,735,928,1663
MIGORI,KURIA EAST,31,367,486,853
MIGORI,KURIA EAST,32,460,604,1064
MIGORI,KURIA EAST,33,351,520,871
MIGORI,KURIA EAST,34,304,373,677
MIGORI,KURIA EAST,30-34,2217,2911,5128
MIGORI,KURIA EAST,35,595,688,1283
MIGORI,KURIA EAST,36,370,313,683
MIGORI,KURIA EAST,37,290,262,552
MIGORI,KURIA EAST,38,245,290,535
MIGORI,KURIA EAST,39,246,240,486
MIGORI,KURIA EAST,35-39,1746,1793,3539
MIGORI,KURIA EAST,40,542,548,1090
MIGORI,KURIA EAST,41,263,297,560
MIGORI,KURIA EAST,42,286,320,606
MIGORI,KURIA EAST,43,267,281,548
MIGORI,KURIA EAST,44,189,230,419
MIGORI,KURIA EAST,40-44,1547,1676,3223
MIGORI,KURIA EAST,45,403,482,885
MIGORI,KURIA EAST,46,267,302,569
MIGORI,KURIA EAST,47,271,267,538
MIGORI,KURIA EAST,48,158,185,343
MIGORI,KURIA EAST,49,157,171,328
MIGORI,KURIA EAST,45-49,1256,1407,2663
MIGORI,KURIA EAST,50,271,411,682
MIGORI,KURIA EAST,51,143,196,339
MIGORI,KURIA EAST,52,117,143,260
MIGORI,KURIA EAST,53,91,106,197
MIGORI,KURIA EAST,54,185,187,372
MIGORI,KURIA EAST,50-54,807,1043,1850
MIGORI,KURIA EAST,55,146,221,367
MIGORI,KURIA EAST,56,196,225,421
MIGORI,KURIA EAST,57,135,151,286
MIGORI,KURIA EAST,58,124,120,244
MIGORI,KURIA EAST,59,136,187,323
MIGORI,KURIA EAST,55-59,737,904,1641
MIGORI,KURIA EAST,60,244,317,561
MIGORI,KURIA EAST,61,153,168,321
MIGORI,KURIA EAST,62,97,105,202
MIGORI,KURIA EAST,63,110,120,230
MIGORI,KURIA EAST,64,67,85,152
MIGORI,KURIA EAST,60-64,671,795,1466
MIGORI,KURIA EAST,65,141,156,297
MIGORI,KURIA EAST,66,59,62,121
MIGORI,KURIA EAST,67,106,76,182
MIGORI,KURIA EAST,68,59,81,140
MIGORI,KURIA EAST,69,88,103,191
MIGORI,KURIA EAST,65-69,453,478,931
MIGORI,KURIA EAST,70,132,205,337
MIGORI,KURIA EAST,71,69,76,145
MIGORI,KURIA EAST,72,52,55,107
MIGORI,KURIA EAST,73,42,42,84
MIGORI,KURIA EAST,74,52,49,101
MIGORI,KURIA EAST,70-74,347,427,774
MIGORI,KURIA EAST,75,69,69,138
MIGORI,KURIA EAST,76,35,35,70
MIGORI,KURIA EAST,77,45,53,98
MIGORI,KURIA EAST,78,30,40,70
MIGORI,KURIA EAST,79,24,41,65
MIGORI,KURIA EAST,75-79,203,238,441
MIGORI,KURIA EAST,80,49,78,127
MIGORI,KURIA EAST,81,18,25,43
MIGORI,KURIA EAST,82,22,25,47
MIGORI,KURIA EAST,83,19,24,43
MIGORI,KURIA EAST,84,22,25,47
MIGORI,KURIA EAST,80-84,130,177,307
MIGORI,KURIA EAST,85,35,22,57
MIGORI,KURIA EAST,86,22,13,35
MIGORI,KURIA EAST,87,22,32,54
MIGORI,KURIA EAST,88,12,6,18
MIGORI,KURIA EAST,89,17,34,51
MIGORI,KURIA EAST,85-89,108,107,215
MIGORI,KURIA EAST,90,15,28,43
MIGORI,KURIA EAST,91,9,20,29
MIGORI,KURIA EAST,92,5,7,12
MIGORI,KURIA EAST,93,3,10,13
MIGORI,KURIA EAST,94,5,8,13
MIGORI,KURIA EAST,90-94,37,73,110
MIGORI,KURIA EAST,95,12,17,29
MIGORI,KURIA EAST,96,3,3,6
MIGORI,KURIA EAST,97,2,6,8
MIGORI,KURIA EAST,98,-,2,2
MIGORI,KURIA EAST,99,4,12,16
MIGORI,KURIA EAST,95-99,21,40,61
MIGORI,KURIA EAST,100+,16,25,41
MIGORI,KURIA EAST,Not Stated,-,2,2
MIGORI,KURIA WEST,Total,101090,107417,208507
MIGORI,KURIA WEST,0,2733,2775,5508
MIGORI,KURIA WEST,1,2825,3022,5847
MIGORI,KURIA WEST,2,3037,3230,6267
MIGORI,KURIA WEST,3,3333,3316,6649
MIGORI,KURIA WEST,4,3275,3314,6589
MIGORI,KURIA WEST,0 - 4,15203,15657,30860
MIGORI,KURIA WEST,5,3352,3385,6737
MIGORI,KURIA WEST,6,3386,3472,6858
MIGORI,KURIA WEST,7,3242,3123,6365
MIGORI,KURIA WEST,8,3187,3365,6552
MIGORI,KURIA WEST,9,3494,3514,7008
MIGORI,KURIA WEST,05-Sep,16661,16859,33520
MIGORI,KURIA WEST,10,3768,3929,7697
MIGORI,KURIA WEST,11,3001,3325,6326
MIGORI,KURIA WEST,12,3541,3487,7028
MIGORI,KURIA WEST,13,3297,3324,6621
MIGORI,KURIA WEST,14,3195,2974,6169
MIGORI,KURIA WEST,Oct-14,16802,17039,33841
MIGORI,KURIA WEST,15,3062,2946,6008
MIGORI,KURIA WEST,16,2673,2602,5275
MIGORI,KURIA WEST,17,2517,2390,4907
MIGORI,KURIA WEST,18,2262,2268,4530
MIGORI,KURIA WEST,19,2340,2485,4825
MIGORI,KURIA WEST,15-19,12854,12691,25545
MIGORI,KURIA WEST,20,2266,2736,5002
MIGORI,KURIA WEST,21,1710,2085,3795
MIGORI,KURIA WEST,22,1659,2173,3832
MIGORI,KURIA WEST,23,1700,2034,3734
MIGORI,KURIA WEST,24,1600,1787,3387
MIGORI,KURIA WEST,20-24,8935,10815,19750
MIGORI,KURIA WEST,25,1997,2272,4269
MIGORI,KURIA WEST,26,1438,1645,3083
MIGORI,KURIA WEST,27,1339,1526,2865
MIGORI,KURIA WEST,28,1177,1475,2652
MIGORI,KURIA WEST,29,999,1190,2189
MIGORI,KURIA WEST,25-29,6950,8108,15058
MIGORI,KURIA WEST,30,1772,2048,3820
MIGORI,KURIA WEST,31,1045,1279,2324
MIGORI,KURIA WEST,32,1233,1520,2753
MIGORI,KURIA WEST,33,1070,1305,2375
MIGORI,KURIA WEST,34,983,1092,2075
MIGORI,KURIA WEST,30-34,6103,7244,13347
MIGORI,KURIA WEST,35,1456,1541,2997
MIGORI,KURIA WEST,36,839,779,1618
MIGORI,KURIA WEST,37,738,726,1464
MIGORI,KURIA WEST,38,631,628,1259
MIGORI,KURIA WEST,39,682,626,1308
MIGORI,KURIA WEST,35-39,4346,4300,8646
MIGORI,KURIA WEST,40,1159,1026,2185
MIGORI,KURIA WEST,41,738,706,1444
MIGORI,KURIA WEST,42,672,706,1378
MIGORI,KURIA WEST,43,623,631,1254
MIGORI,KURIA WEST,44,482,481,963
MIGORI,KURIA WEST,40-44,3674,3550,7224
MIGORI,KURIA WEST,45,974,979,1953
MIGORI,KURIA WEST,46,561,646,1207
MIGORI,KURIA WEST,47,567,641,1208
MIGORI,KURIA WEST,48,322,397,719
MIGORI,KURIA WEST,49,423,447,870
MIGORI,KURIA WEST,45-49,2847,3110,5957
MIGORI,KURIA WEST,50,648,701,1349
MIGORI,KURIA WEST,51,396,437,833
MIGORI,KURIA WEST,52,291,316,607
MIGORI,KURIA WEST,53,237,282,519
MIGORI,KURIA WEST,54,375,375,750
MIGORI,KURIA WEST,50-54,1947,2111,4058
MIGORI,KURIA WEST,55,392,382,774
MIGORI,KURIA WEST,56,364,361,725
MIGORI,KURIA WEST,57,343,396,739
MIGORI,KURIA WEST,58,276,305,581
MIGORI,KURIA WEST,59,213,306,519
MIGORI,KURIA WEST,55-59,1588,1750,3338
MIGORI,KURIA WEST,60,393,488,881
MIGORI,KURIA WEST,61,207,240,447
MIGORI,KURIA WEST,62,160,168,328
MIGORI,KURIA WEST,63,163,200,363
MIGORI,KURIA WEST,64,132,159,291
MIGORI,KURIA WEST,60-64,1055,1255,2310
MIGORI,KURIA WEST,65,201,315,516
MIGORI,KURIA WEST,66,136,134,270
MIGORI,KURIA WEST,67,143,226,369
MIGORI,KURIA WEST,68,113,150,263
MIGORI,KURIA WEST,69,149,207,356
MIGORI,KURIA WEST,65-69,742,1032,1774
MIGORI,KURIA WEST,70,238,317,555
MIGORI,KURIA WEST,71,103,114,217
MIGORI,KURIA WEST,72,101,116,217
MIGORI,KURIA WEST,73,66,104,170
MIGORI,KURIA WEST,74,100,114,214
MIGORI,KURIA WEST,70-74,608,765,1373
MIGORI,KURIA WEST,75,81,136,217
MIGORI,KURIA WEST,76,52,57,109
MIGORI,KURIA WEST,77,81,62,143
MIGORI,KURIA WEST,78,55,57,112
MIGORI,KURIA WEST,79,62,86,148
MIGORI,KURIA WEST,75-79,331,398,729
MIGORI,KURIA WEST,80,77,167,244
MIGORI,KURIA WEST,81,42,68,110
MIGORI,KURIA WEST,82,40,48,88
MIGORI,KURIA WEST,83,37,40,77
MIGORI,KURIA WEST,84,29,55,84
MIGORI,KURIA WEST,80-84,225,378,603
MIGORI,KURIA WEST,85,27,51,78
MIGORI,KURIA WEST,86,25,32,57
MIGORI,KURIA WEST,87,35,32,67
MIGORI,KURIA WEST,88,15,20,35
MIGORI,KURIA WEST,89,22,52,74
MIGORI,KURIA WEST,85-89,124,187,311
MIGORI,KURIA WEST,90,22,44,66
MIGORI,KURIA WEST,91,11,20,31
MIGORI,KURIA WEST,92,7,3,10
MIGORI,KURIA WEST,93,10,8,18
MIGORI,KURIA WEST,94,3,6,9
MIGORI,KURIA WEST,90-94,53,81,134
MIGORI,KURIA WEST,95,14,36,50
MIGORI,KURIA WEST,96,5,6,11
MIGORI,KURIA WEST,97,5,7,12
MIGORI,KURIA WEST,98,3,3,6
MIGORI,KURIA WEST,99,7,7,14
MIGORI,KURIA WEST,95-99,34,59,93
MIGORI,KURIA WEST,100+,6,26,32
MIGORI,KURIA WEST,Not Stated,2,2,4
MIGORI,NYATIKE,Total,83989,92164,176153
MIGORI,NYATIKE,0,2473,2588,5061
MIGORI,NYATIKE,1,2578,2488,5066
MIGORI,NYATIKE,2,2603,2599,5202
MIGORI,NYATIKE,3,2790,2885,5675
MIGORI,NYATIKE,4,2686,2745,5431
MIGORI,NYATIKE,0 - 4,13130,13305,26435
MIGORI,NYATIKE,5,2892,2782,5674
MIGORI,NYATIKE,6,2718,2785,5503
MIGORI,NYATIKE,7,2456,2648,5104
MIGORI,NYATIKE,8,2427,2463,4890
MIGORI,NYATIKE,9,2706,2697,5403
MIGORI,NYATIKE,05-Sep,13199,13375,26574
MIGORI,NYATIKE,10,2883,2913,5796
MIGORI,NYATIKE,11,2615,2682,5297
MIGORI,NYATIKE,12,3027,2989,6016
MIGORI,NYATIKE,13,2771,2759,5530
MIGORI,NYATIKE,14,2611,2466,5077
MIGORI,NYATIKE,Oct-14,13907,13809,27716
MIGORI,NYATIKE,15,2491,2505,4996
MIGORI,NYATIKE,16,2145,2216,4361
MIGORI,NYATIKE,17,2032,2086,4118
MIGORI,NYATIKE,18,1606,1693,3299
MIGORI,NYATIKE,19,1880,2067,3947
MIGORI,NYATIKE,15-19,10154,10567,20721
MIGORI,NYATIKE,20,1681,2065,3746
MIGORI,NYATIKE,21,1375,1667,3042
MIGORI,NYATIKE,22,1243,1579,2822
MIGORI,NYATIKE,23,1447,1729,3176
MIGORI,NYATIKE,24,1249,1507,2756
MIGORI,NYATIKE,20-24,6995,8547,15542
MIGORI,NYATIKE,25,1492,1613,3105
MIGORI,NYATIKE,26,1154,1431,2585
MIGORI,NYATIKE,27,1179,1538,2717
MIGORI,NYATIKE,28,805,1049,1854
MIGORI,NYATIKE,29,866,1069,1935
MIGORI,NYATIKE,25-29,5496,6700,12196
MIGORI,NYATIKE,30,1300,1575,2875
MIGORI,NYATIKE,31,906,1170,2076
MIGORI,NYATIKE,32,1080,1383,2463
MIGORI,NYATIKE,33,995,1306,2301
MIGORI,NYATIKE,34,924,1078,2002
MIGORI,NYATIKE,30-34,5205,6512,11717
MIGORI,NYATIKE,35,1155,1242,2397
MIGORI,NYATIKE,36,829,817,1646
MIGORI,NYATIKE,37,835,757,1592
MIGORI,NYATIKE,38,487,445,932
MIGORI,NYATIKE,39,627,571,1198
MIGORI,NYATIKE,35-39,3933,3832,7765
MIGORI,NYATIKE,40,788,850,1638
MIGORI,NYATIKE,41,675,755,1430
MIGORI,NYATIKE,42,605,715,1320
MIGORI,NYATIKE,43,583,721,1304
MIGORI,NYATIKE,44,504,538,1042
MIGORI,NYATIKE,40-44,3155,3579,6734
MIGORI,NYATIKE,45,742,778,1520
MIGORI,NYATIKE,46,485,531,1016
MIGORI,NYATIKE,47,554,696,1250
MIGORI,NYATIKE,48,253,344,597
MIGORI,NYATIKE,49,347,422,769
MIGORI,NYATIKE,45-49,2381,2771,5152
MIGORI,NYATIKE,50,454,538,992
MIGORI,NYATIKE,51,380,417,797
MIGORI,NYATIKE,52,275,305,580
MIGORI,NYATIKE,53,224,230,454
MIGORI,NYATIKE,54,258,290,548
MIGORI,NYATIKE,50-54,1591,1780,3371
MIGORI,NYATIKE,55,268,359,627
MIGORI,NYATIKE,56,268,417,685
MIGORI,NYATIKE,57,336,532,868
MIGORI,NYATIKE,58,180,213,393
MIGORI,NYATIKE,59,227,292,519
MIGORI,NYATIKE,55-59,1279,1813,3092
MIGORI,NYATIKE,60,331,481,812
MIGORI,NYATIKE,61,298,376,674
MIGORI,NYATIKE,62,205,233,438
MIGORI,NYATIKE,63,221,219,440
MIGORI,NYATIKE,64,159,231,390
MIGORI,NYATIKE,60-64,1214,1540,2754
MIGORI,NYATIKE,65,215,329,544
MIGORI,NYATIKE,66,149,232,381
MIGORI,NYATIKE,67,249,416,665
MIGORI,NYATIKE,68,71,96,167
MIGORI,NYATIKE,69,160,266,426
MIGORI,NYATIKE,65-69,844,1339,2183
MIGORI,NYATIKE,70,184,386,570
MIGORI,NYATIKE,71,185,234,419
MIGORI,NYATIKE,72,125,161,286
MIGORI,NYATIKE,73,87,138,225
MIGORI,NYATIKE,74,99,188,287
MIGORI,NYATIKE,70-74,680,1107,1787
MIGORI,NYATIKE,75,58,140,198
MIGORI,NYATIKE,76,62,108,170
MIGORI,NYATIKE,77,109,199,308
MIGORI,NYATIKE,78,47,61,108
MIGORI,NYATIKE,79,64,163,227
MIGORI,NYATIKE,75-79,340,671,1011
MIGORI,NYATIKE,80,58,154,212
MIGORI,NYATIKE,81,66,103,169
MIGORI,NYATIKE,82,63,70,133
MIGORI,NYATIKE,83,46,68,114
MIGORI,NYATIKE,84,44,90,134
MIGORI,NYATIKE,80-84,277,485,762
MIGORI,NYATIKE,85,39,76,115
MIGORI,NYATIKE,86,26,34,60
MIGORI,NYATIKE,87,38,68,106
MIGORI,NYATIKE,88,11,32,43
MIGORI,NYATIKE,89,27,67,94
MIGORI,NYATIKE,85-89,141,277,418
MIGORI,NYATIKE,90,17,39,56
MIGORI,NYATIKE,91,12,13,25
MIGORI,NYATIKE,92,7,13,20
MIGORI,NYATIKE,93,6,10,16
MIGORI,NYATIKE,94,5,16,21
MIGORI,NYATIKE,90-94,47,91,138
MIGORI,NYATIKE,95,4,7,11
MIGORI,NYATIKE,96,6,12,18
MIGORI,NYATIKE,97,3,7,10
MIGORI,NYATIKE,98,-,4,4
MIGORI,NYATIKE,99,2,13,15
MIGORI,NYATIKE,95-99,15,43,58
MIGORI,NYATIKE,100+,6,20,26
MIGORI,NYATIKE,Not Stated,-,1,1
MIGORI,RONGO,Total,59257,65329,124586
MIGORI,RONGO,0,1588,1536,3124
MIGORI,RONGO,1,1601,1653,3254
MIGORI,RONGO,2,1595,1655,3250
MIGORI,RONGO,3,1758,1713,3471
MIGORI,RONGO,4,1781,1829,3610
MIGORI,RONGO,0 - 4,8323,8386,16709
MIGORI,RONGO,5,1812,1808,3620
MIGORI,RONGO,6,1832,1793,3625
MIGORI,RONGO,7,1757,1752,3509
MIGORI,RONGO,8,1766,1774,3540
MIGORI,RONGO,9,1808,1932,3740
MIGORI,RONGO,05-Sep,8975,9059,18034
MIGORI,RONGO,10,2100,2037,4137
MIGORI,RONGO,11,1817,1856,3673
MIGORI,RONGO,12,2028,2056,4084
MIGORI,RONGO,13,2012,2141,4153
MIGORI,RONGO,14,1809,1848,3657
MIGORI,RONGO,Oct-14,9766,9938,19704
MIGORI,RONGO,15,1745,1765,3510
MIGORI,RONGO,16,1521,1609,3130
MIGORI,RONGO,17,1556,1479,3035
MIGORI,RONGO,18,1271,1327,2598
MIGORI,RONGO,19,1522,1614,3136
MIGORI,RONGO,15-19,7615,7794,15409
MIGORI,RONGO,20,1267,1420,2687
MIGORI,RONGO,21,1089,1327,2416
MIGORI,RONGO,22,938,1268,2206
MIGORI,RONGO,23,1002,1388,2390
MIGORI,RONGO,24,951,1194,2145
MIGORI,RONGO,20-24,5247,6597,11844
MIGORI,RONGO,25,1067,1332,2399
MIGORI,RONGO,26,873,1081,1954
MIGORI,RONGO,27,961,1062,2023
MIGORI,RONGO,28,682,804,1486
MIGORI,RONGO,29,662,905,1567
MIGORI,RONGO,25-29,4245,5184,9429
MIGORI,RONGO,30,950,1443,2393
MIGORI,RONGO,31,704,943,1647
MIGORI,RONGO,32,798,1112,1910
MIGORI,RONGO,33,657,868,1525
MIGORI,RONGO,34,640,764,1404
MIGORI,RONGO,30-34,3749,5130,8879
MIGORI,RONGO,35,830,812,1642
MIGORI,RONGO,36,632,516,1148
MIGORI,RONGO,37,627,468,1095
MIGORI,RONGO,38,409,372,781
MIGORI,RONGO,39,486,408,894
MIGORI,RONGO,35-39,2984,2576,5560
MIGORI,RONGO,40,493,599,1092
MIGORI,RONGO,41,532,432,964
MIGORI,RONGO,42,420,432,852
MIGORI,RONGO,43,422,409,831
MIGORI,RONGO,44,291,350,641
MIGORI,RONGO,40-44,2158,2222,4380
MIGORI,RONGO,45,466,502,968
MIGORI,RONGO,46,309,368,677
MIGORI,RONGO,47,345,422,767
MIGORI,RONGO,48,211,259,470
MIGORI,RONGO,49,220,264,484
MIGORI,RONGO,45-49,1551,1815,3366
MIGORI,RONGO,50,332,450,782
MIGORI,RONGO,51,219,277,496
MIGORI,RONGO,52,187,289,476
MIGORI,RONGO,53,160,215,375
MIGORI,RONGO,54,183,224,407
MIGORI,RONGO,50-54,1081,1455,2536
MIGORI,RONGO,55,206,314,520
MIGORI,RONGO,56,239,310,549
MIGORI,RONGO,57,214,405,619
MIGORI,RONGO,58,131,191,322
MIGORI,RONGO,59,152,265,417
MIGORI,RONGO,55-59,942,1485,2427
MIGORI,RONGO,60,248,357,605
MIGORI,RONGO,61,179,284,463
MIGORI,RONGO,62,159,178,337
MIGORI,RONGO,63,169,202,371
MIGORI,RONGO,64,131,160,291
MIGORI,RONGO,60-64,886,1181,2067
MIGORI,RONGO,65,162,251,413
MIGORI,RONGO,66,139,144,283
MIGORI,RONGO,67,182,238,420
MIGORI,RONGO,68,76,95,171
MIGORI,RONGO,69,114,171,285
MIGORI,RONGO,65-69,673,899,1572
MIGORI,RONGO,70,155,266,421
MIGORI,RONGO,71,87,143,230
MIGORI,RONGO,72,84,94,178
MIGORI,RONGO,73,78,73,151
MIGORI,RONGO,74,72,101,173
MIGORI,RONGO,70-74,476,677,1153
MIGORI,RONGO,75,58,99,157
MIGORI,RONGO,76,53,75,128
MIGORI,RONGO,77,68,83,151
MIGORI,RONGO,78,28,53,81
MIGORI,RONGO,79,39,85,124
MIGORI,RONGO,75-79,246,395,641
MIGORI,RONGO,80,49,100,149
MIGORI,RONGO,81,37,54,91
MIGORI,RONGO,82,30,35,65
MIGORI,RONGO,83,35,52,87
MIGORI,RONGO,84,25,56,81
MIGORI,RONGO,80-84,176,297,473
MIGORI,RONGO,85,28,35,63
MIGORI,RONGO,86,16,22,38
MIGORI,RONGO,87,40,37,77
MIGORI,RONGO,88,10,18,28
MIGORI,RONGO,89,19,42,61
MIGORI,RONGO,85-89,113,154,267
MIGORI,RONGO,90,11,12,23
MIGORI,RONGO,91,10,15,25
MIGORI,RONGO,92,6,11,17
MIGORI,RONGO,93,2,4,6
MIGORI,RONGO,94,3,4,7
MIGORI,RONGO,90-94,32,46,78
MIGORI,RONGO,95,7,6,13
MIGORI,RONGO,96,3,5,8
MIGORI,RONGO,97,-,5,5
MIGORI,RONGO,98,2,4,6
MIGORI,RONGO,99,2,6,8
MIGORI,RONGO,95-99,14,26,40
MIGORI,RONGO,100+,5,12,17
MIGORI,RONGO,Not Stated,-,1,1
MIGORI,SUNA EAST,Total,58977,63694,122671
MIGORI,SUNA EAST,0,1327,1343,2670
MIGORI,SUNA EAST,1,1795,1886,3681
MIGORI,SUNA EAST,2,1647,1640,3287
MIGORI,SUNA EAST,3,1827,1833,3660
MIGORI,SUNA EAST,4,1827,1808,3635
MIGORI,SUNA EAST,0 - 4,8423,8510,16933
MIGORI,SUNA EAST,5,1806,1885,3691
MIGORI,SUNA EAST,6,1834,1934,3768
MIGORI,SUNA EAST,7,1722,1732,3454
MIGORI,SUNA EAST,8,1746,1752,3498
MIGORI,SUNA EAST,9,1885,1845,3730
MIGORI,SUNA EAST,05-Sep,8993,9148,18141
MIGORI,SUNA EAST,10,1924,2030,3954
MIGORI,SUNA EAST,11,1742,1929,3671
MIGORI,SUNA EAST,12,2030,1992,4022
MIGORI,SUNA EAST,13,1853,1959,3812
MIGORI,SUNA EAST,14,1762,1792,3554
MIGORI,SUNA EAST,Oct-14,9311,9702,19013
MIGORI,SUNA EAST,15,1787,1801,3588
MIGORI,SUNA EAST,16,1510,1548,3058
MIGORI,SUNA EAST,17,1447,1529,2976
MIGORI,SUNA EAST,18,1215,1164,2379
MIGORI,SUNA EAST,19,1334,1474,2808
MIGORI,SUNA EAST,15-19,7293,7516,14809
MIGORI,SUNA EAST,20,1086,1411,2497
MIGORI,SUNA EAST,21,955,1295,2250
MIGORI,SUNA EAST,22,930,1177,2107
MIGORI,SUNA EAST,23,998,1275,2273
MIGORI,SUNA EAST,24,911,1127,2038
MIGORI,SUNA EAST,20-24,4880,6285,11165
MIGORI,SUNA EAST,25,1113,1257,2370
MIGORI,SUNA EAST,26,826,1116,1942
MIGORI,SUNA EAST,27,945,1102,2047
MIGORI,SUNA EAST,28,692,804,1496
MIGORI,SUNA EAST,29,645,794,1439
MIGORI,SUNA EAST,25-29,4221,5073,9294
MIGORI,SUNA EAST,30,979,1157,2136
MIGORI,SUNA EAST,31,644,805,1449
MIGORI,SUNA EAST,32,836,958,1794
MIGORI,SUNA EAST,33,677,783,1460
MIGORI,SUNA EAST,34,665,699,1364
MIGORI,SUNA EAST,30-34,3801,4402,8203
MIGORI,SUNA EAST,35,812,802,1614
MIGORI,SUNA EAST,36,564,473,1037
MIGORI,SUNA EAST,37,552,483,1035
MIGORI,SUNA EAST,38,403,337,740
MIGORI,SUNA EAST,39,482,375,857
MIGORI,SUNA EAST,35-39,2813,2470,5283
MIGORI,SUNA EAST,40,541,548,1089
MIGORI,SUNA EAST,41,558,570,1128
MIGORI,SUNA EAST,42,502,477,979
MIGORI,SUNA EAST,43,423,396,819
MIGORI,SUNA EAST,44,303,282,585
MIGORI,SUNA EAST,40-44,2327,2273,4600
MIGORI,SUNA EAST,45,477,438,915
MIGORI,SUNA EAST,46,385,380,765
MIGORI,SUNA EAST,47,429,492,921
MIGORI,SUNA EAST,48,219,226,445
MIGORI,SUNA EAST,49,264,290,554
MIGORI,SUNA EAST,45-49,1774,1826,3600
MIGORI,SUNA EAST,50,324,372,696
MIGORI,SUNA EAST,51,250,312,562
MIGORI,SUNA EAST,52,220,271,491
MIGORI,SUNA EAST,53,181,199,380
MIGORI,SUNA EAST,54,223,228,451
MIGORI,SUNA EAST,50-54,1198,1382,2580
MIGORI,SUNA EAST,55,259,292,551
MIGORI,SUNA EAST,56,272,328,600
MIGORI,SUNA EAST,57,218,368,586
MIGORI,SUNA EAST,58,166,165,331
MIGORI,SUNA EAST,59,203,253,456
MIGORI,SUNA EAST,55-59,1118,1406,2524
MIGORI,SUNA EAST,60,257,353,610
MIGORI,SUNA EAST,61,235,265,500
MIGORI,SUNA EAST,62,160,169,329
MIGORI,SUNA EAST,63,194,226,420
MIGORI,SUNA EAST,64,131,200,331
MIGORI,SUNA EAST,60-64,977,1213,2190
MIGORI,SUNA EAST,65,188,249,437
MIGORI,SUNA EAST,66,115,173,288
MIGORI,SUNA EAST,67,194,262,456
MIGORI,SUNA EAST,68,84,94,178
MIGORI,SUNA EAST,69,139,190,329
MIGORI,SUNA EAST,65-69,720,968,1688
MIGORI,SUNA EAST,70,164,228,392
MIGORI,SUNA EAST,71,111,126,237
MIGORI,SUNA EAST,72,89,112,201
MIGORI,SUNA EAST,73,79,84,163
MIGORI,SUNA EAST,74,74,92,166
MIGORI,SUNA EAST,70-74,517,642,1159
MIGORI,SUNA EAST,75,74,92,166
MIGORI,SUNA EAST,76,53,71,124
MIGORI,SUNA EAST,77,61,99,160
MIGORI,SUNA EAST,78,35,36,71
MIGORI,SUNA EAST,79,47,83,130
MIGORI,SUNA EAST,75-79,270,381,651
MIGORI,SUNA EAST,80,56,101,157
MIGORI,SUNA EAST,81,39,38,77
MIGORI,SUNA EAST,82,42,34,76
MIGORI,SUNA EAST,83,29,35,64
MIGORI,SUNA EAST,84,23,40,63
MIGORI,SUNA EAST,80-84,189,248,437
MIGORI,SUNA EAST,85,23,46,69
MIGORI,SUNA EAST,86,20,26,46
MIGORI,SUNA EAST,87,32,44,76
MIGORI,SUNA EAST,88,8,19,27
MIGORI,SUNA EAST,89,14,35,49
MIGORI,SUNA EAST,85-89,97,170,267
MIGORI,SUNA EAST,90,5,13,18
MIGORI,SUNA EAST,91,11,12,23
MIGORI,SUNA EAST,92,7,6,13
MIGORI,SUNA EAST,93,3,10,13
MIGORI,SUNA EAST,94,3,8,11
MIGORI,SUNA EAST,90-94,29,49,78
MIGORI,SUNA EAST,95,5,8,13
MIGORI,SUNA EAST,96,3,3,6
MIGORI,SUNA EAST,97,2,3,5
MIGORI,SUNA EAST,98,2,2,4
MIGORI,SUNA EAST,99,2,3,5
MIGORI,SUNA EAST,95-99,14,19,33
MIGORI,SUNA EAST,100+,12,10,22
MIGORI,SUNA EAST,Not Stated,-,1,1
MIGORI,SUNA WEST,Total,61430,67459,128889
MIGORI,SUNA WEST,0,1905,1872,3777
MIGORI,SUNA WEST,1,1860,1885,3745
MIGORI,SUNA WEST,2,1958,1966,3924
MIGORI,SUNA WEST,3,2030,2057,4087
MIGORI,SUNA WEST,4,1992,2002,3994
MIGORI,SUNA WEST,0 - 4,9745,9782,19527
MIGORI,SUNA WEST,5,2024,2026,4050
MIGORI,SUNA WEST,6,1973,2050,4023
MIGORI,SUNA WEST,7,1792,1824,3616
MIGORI,SUNA WEST,8,1760,1813,3573
MIGORI,SUNA WEST,9,1903,1926,3829
MIGORI,SUNA WEST,05-Sep,9452,9639,19091
MIGORI,SUNA WEST,10,2127,2159,4286
MIGORI,SUNA WEST,11,1855,1873,3728
MIGORI,SUNA WEST,12,2203,2178,4381
MIGORI,SUNA WEST,13,1991,2024,4015
MIGORI,SUNA WEST,14,1687,1790,3477
MIGORI,SUNA WEST,Oct-14,9863,10024,19887
MIGORI,SUNA WEST,15,1739,1841,3580
MIGORI,SUNA WEST,16,1441,1660,3101
MIGORI,SUNA WEST,17,1445,1592,3037
MIGORI,SUNA WEST,18,1155,1295,2450
MIGORI,SUNA WEST,19,1326,1501,2827
MIGORI,SUNA WEST,15-19,7106,7889,14995
MIGORI,SUNA WEST,20,1224,1619,2843
MIGORI,SUNA WEST,21,991,1419,2410
MIGORI,SUNA WEST,22,981,1413,2394
MIGORI,SUNA WEST,23,1074,1412,2486
MIGORI,SUNA WEST,24,1068,1326,2394
MIGORI,SUNA WEST,20-24,5338,7189,12527
MIGORI,SUNA WEST,25,1204,1455,2659
MIGORI,SUNA WEST,26,917,1173,2090
MIGORI,SUNA WEST,27,1062,1258,2320
MIGORI,SUNA WEST,28,738,901,1639
MIGORI,SUNA WEST,29,726,872,1598
MIGORI,SUNA WEST,25-29,4647,5659,10306
MIGORI,SUNA WEST,30,1013,1260,2273
MIGORI,SUNA WEST,31,699,773,1472
MIGORI,SUNA WEST,32,870,937,1807
MIGORI,SUNA WEST,33,752,892,1644
MIGORI,SUNA WEST,34,682,713,1395
MIGORI,SUNA WEST,30-34,4016,4575,8591
MIGORI,SUNA WEST,35,818,798,1616
MIGORI,SUNA WEST,36,518,505,1023
MIGORI,SUNA WEST,37,650,546,1196
MIGORI,SUNA WEST,38,351,359,710
MIGORI,SUNA WEST,39,440,445,885
MIGORI,SUNA WEST,35-39,2777,2653,5430
MIGORI,SUNA WEST,40,606,599,1205
MIGORI,SUNA WEST,41,501,487,988
MIGORI,SUNA WEST,42,533,532,1065
MIGORI,SUNA WEST,43,462,421,883
MIGORI,SUNA WEST,44,316,319,635
MIGORI,SUNA WEST,40-44,2418,2358,4776
MIGORI,SUNA WEST,45,488,455,943
MIGORI,SUNA WEST,46,337,356,693
MIGORI,SUNA WEST,47,384,436,820
MIGORI,SUNA WEST,48,205,223,428
MIGORI,SUNA WEST,49,295,301,596
MIGORI,SUNA WEST,45-49,1709,1771,3480
MIGORI,SUNA WEST,50,282,379,661
MIGORI,SUNA WEST,51,248,319,567
MIGORI,SUNA WEST,52,183,223,406
MIGORI,SUNA WEST,53,206,188,394
MIGORI,SUNA WEST,54,210,227,437
MIGORI,SUNA WEST,50-54,1129,1336,2465
MIGORI,SUNA WEST,55,250,280,530
MIGORI,SUNA WEST,56,230,285,515
MIGORI,SUNA WEST,57,216,364,580
MIGORI,SUNA WEST,58,128,180,308
MIGORI,SUNA WEST,59,158,216,374
MIGORI,SUNA WEST,55-59,982,1325,2307
MIGORI,SUNA WEST,60,219,283,502
MIGORI,SUNA WEST,61,182,238,420
MIGORI,SUNA WEST,62,133,157,290
MIGORI,SUNA WEST,63,125,171,296
MIGORI,SUNA WEST,64,98,157,255
MIGORI,SUNA WEST,60-64,757,1006,1763
MIGORI,SUNA WEST,65,125,199,324
MIGORI,SUNA WEST,66,106,124,230
MIGORI,SUNA WEST,67,152,237,389
MIGORI,SUNA WEST,68,72,77,149
MIGORI,SUNA WEST,69,83,148,231
MIGORI,SUNA WEST,65-69,538,785,1323
MIGORI,SUNA WEST,70,126,190,316
MIGORI,SUNA WEST,71,91,129,220
MIGORI,SUNA WEST,72,94,81,175
MIGORI,SUNA WEST,73,54,78,132
MIGORI,SUNA WEST,74,59,105,164
MIGORI,SUNA WEST,70-74,424,583,1007
MIGORI,SUNA WEST,75,55,66,121
MIGORI,SUNA WEST,76,42,65,107
MIGORI,SUNA WEST,77,79,118,197
MIGORI,SUNA WEST,78,18,35,53
MIGORI,SUNA WEST,79,46,93,139
MIGORI,SUNA WEST,75-79,240,377,617
MIGORI,SUNA WEST,80,41,106,147
MIGORI,SUNA WEST,81,29,59,88
MIGORI,SUNA WEST,82,31,42,73
MIGORI,SUNA WEST,83,29,31,60
MIGORI,SUNA WEST,84,31,38,69
MIGORI,SUNA WEST,80-84,161,276,437
MIGORI,SUNA WEST,85,9,22,31
MIGORI,SUNA WEST,86,11,21,32
MIGORI,SUNA WEST,87,29,42,71
MIGORI,SUNA WEST,88,10,17,27
MIGORI,SUNA WEST,89,21,52,73
MIGORI,SUNA WEST,85-89,80,154,234
MIGORI,SUNA WEST,90,7,17,24
MIGORI,SUNA WEST,91,5,9,14
MIGORI,SUNA WEST,92,8,2,10
MIGORI,SUNA WEST,93,7,7,14
MIGORI,SUNA WEST,94,6,10,16
MIGORI,SUNA WEST,90-94,33,45,78
MIGORI,SUNA WEST,95,2,9,11
MIGORI,SUNA WEST,96,3,4,7
MIGORI,SUNA WEST,97,2,3,5
MIGORI,SUNA WEST,98,1,4,5
MIGORI,SUNA WEST,99,-,1,1
MIGORI,SUNA WEST,95-99,8,21,29
MIGORI,SUNA WEST,100+,6,12,18
MIGORI,SUNA WEST,Not Stated,1,-,1
MIGORI,URIRI,Total,68127,73318,141445
MIGORI,URIRI,0,1925,1952,3877
MIGORI,URIRI,1,1952,1832,3784
MIGORI,URIRI,2,1895,2018,3913
MIGORI,URIRI,3,2028,2170,4198
MIGORI,URIRI,4,2102,2170,4272
MIGORI,URIRI,0 - 4,9902,10142,20044
MIGORI,URIRI,5,2302,2334,4636
MIGORI,URIRI,6,2357,2292,4649
MIGORI,URIRI,7,2233,2102,4335
MIGORI,URIRI,8,2106,2203,4309
MIGORI,URIRI,9,2284,2262,4546
MIGORI,URIRI,05-Sep,11282,11193,22475
MIGORI,URIRI,10,2514,2484,4998
MIGORI,URIRI,11,2200,2309,4509
MIGORI,URIRI,12,2618,2404,5022
MIGORI,URIRI,13,2414,2417,4831
MIGORI,URIRI,14,2094,2097,4191
MIGORI,URIRI,Oct-14,11840,11711,23551
MIGORI,URIRI,15,2116,2033,4149
MIGORI,URIRI,16,1810,1793,3603
MIGORI,URIRI,17,1773,1640,3413
MIGORI,URIRI,18,1367,1316,2683
MIGORI,URIRI,19,1564,1641,3205
MIGORI,URIRI,15-19,8630,8423,17053
MIGORI,URIRI,20,1276,1550,2826
MIGORI,URIRI,21,1125,1317,2442
MIGORI,URIRI,22,989,1177,2166
MIGORI,URIRI,23,994,1216,2210
MIGORI,URIRI,24,881,994,1875
MIGORI,URIRI,20-24,5265,6254,11519
MIGORI,URIRI,25,1067,1246,2313
MIGORI,URIRI,26,748,1085,1833
MIGORI,URIRI,27,951,1125,2076
MIGORI,URIRI,28,544,799,1343
MIGORI,URIRI,29,635,859,1494
MIGORI,URIRI,25-29,3945,5114,9059
MIGORI,URIRI,30,868,1220,2088
MIGORI,URIRI,31,683,931,1614
MIGORI,URIRI,32,781,1048,1829
MIGORI,URIRI,33,730,933,1663
MIGORI,URIRI,34,686,755,1441
MIGORI,URIRI,30-34,3748,4887,8635
MIGORI,URIRI,35,905,845,1750
MIGORI,URIRI,36,652,575,1227
MIGORI,URIRI,37,593,601,1194
MIGORI,URIRI,38,407,364,771
MIGORI,URIRI,39,511,393,904
MIGORI,URIRI,35-39,3068,2778,5846
MIGORI,URIRI,40,628,590,1218
MIGORI,URIRI,41,590,604,1194
MIGORI,URIRI,42,562,599,1161
MIGORI,URIRI,43,463,529,992
MIGORI,URIRI,44,362,420,782
MIGORI,URIRI,40-44,2605,2742,5347
MIGORI,URIRI,45,485,526,1011
MIGORI,URIRI,46,413,478,891
MIGORI,URIRI,47,512,541,1053
MIGORI,URIRI,48,258,276,534
MIGORI,URIRI,49,282,345,627
MIGORI,URIRI,45-49,1950,2166,4116
MIGORI,URIRI,50,361,477,838
MIGORI,URIRI,51,270,356,626
MIGORI,URIRI,52,226,317,543
MIGORI,URIRI,53,217,257,474
MIGORI,URIRI,54,218,277,495
MIGORI,URIRI,50-54,1292,1684,2976
MIGORI,URIRI,55,252,299,551
MIGORI,URIRI,56,256,338,594
MIGORI,URIRI,57,271,469,740
MIGORI,URIRI,58,181,237,418
MIGORI,URIRI,59,228,298,526
MIGORI,URIRI,55-59,1188,1641,2829
MIGORI,URIRI,60,266,388,654
MIGORI,URIRI,61,282,333,615
MIGORI,URIRI,62,182,256,438
MIGORI,URIRI,63,238,249,487
MIGORI,URIRI,64,165,203,368
MIGORI,URIRI,60-64,1133,1429,2562
MIGORI,URIRI,65,191,296,487
MIGORI,URIRI,66,177,208,385
MIGORI,URIRI,67,245,349,594
MIGORI,URIRI,68,91,111,202
MIGORI,URIRI,69,153,213,366
MIGORI,URIRI,65-69,857,1177,2034
MIGORI,URIRI,70,187,295,482
MIGORI,URIRI,71,151,179,330
MIGORI,URIRI,72,110,127,237
MIGORI,URIRI,73,101,100,201
MIGORI,URIRI,74,91,121,212
MIGORI,URIRI,70-74,640,822,1462
MIGORI,URIRI,75,81,105,186
MIGORI,URIRI,76,85,124,209
MIGORI,URIRI,77,85,121,206
MIGORI,URIRI,78,38,53,91
MIGORI,URIRI,79,58,128,186
MIGORI,URIRI,75-79,347,531,878
MIGORI,URIRI,80,52,94,146
MIGORI,URIRI,81,57,66,123
MIGORI,URIRI,82,44,51,95
MIGORI,URIRI,83,44,62,106
MIGORI,URIRI,84,31,43,74
MIGORI,URIRI,80-84,228,316,544
MIGORI,URIRI,85,27,46,73
MIGORI,URIRI,86,28,29,57
MIGORI,URIRI,87,39,60,99
MIGORI,URIRI,88,16,23,39
MIGORI,URIRI,89,24,59,83
MIGORI,URIRI,85-89,134,217,351
MIGORI,URIRI,90,17,20,37
MIGORI,URIRI,91,11,14,25
MIGORI,URIRI,92,6,6,12
MIGORI,URIRI,93,5,5,10
MIGORI,URIRI,94,3,8,11
MIGORI,URIRI,90-94,42,53,95
MIGORI,URIRI,95,6,9,15
MIGORI,URIRI,96,5,2,7
MIGORI,URIRI,97,3,6,9
MIGORI,URIRI,98,2,5,7
MIGORI,URIRI,99,5,4,9
MIGORI,URIRI,95-99,21,26,47
MIGORI,URIRI,100+,10,10,20
MIGORI,URIRI,Not Stated,-,2,2
MOMBASA,ALL,Total,610257,598046,1208303
MOMBASA,ALL,0,15111,15009,30120
MOMBASA,ALL,1,15805,15308,31113
MOMBASA,ALL,2,15088,14837,29925
MOMBASA,ALL,3,14660,14031,28691
MOMBASA,ALL,4,14061,13993,28054
MOMBASA,ALL,0 - 4,74725,73178,147903
MOMBASA,ALL,5,13851,14023,27874
MOMBASA,ALL,6,12889,13216,26105
MOMBASA,ALL,7,13268,13203,26471
MOMBASA,ALL,8,11996,12423,24419
MOMBASA,ALL,9,12523,12594,25117
MOMBASA,ALL,05-Sep,64527,65459,129986
MOMBASA,ALL,10,12349,12343,24692
MOMBASA,ALL,11,11115,11497,22612
MOMBASA,ALL,12,11661,11630,23291
MOMBASA,ALL,13,11631,12081,23712
MOMBASA,ALL,14,10388,10729,21117
MOMBASA,ALL,Oct-14,57144,58280,115424
MOMBASA,ALL,15,9199,9724,18923
MOMBASA,ALL,16,8922,9863,18785
MOMBASA,ALL,17,9863,10487,20350
MOMBASA,ALL,18,8964,10217,19181
MOMBASA,ALL,19,10596,12898,23494
MOMBASA,ALL,15-19,47544,53189,100733
MOMBASA,ALL,20,11186,14416,25602
MOMBASA,ALL,21,11527,13706,25233
MOMBASA,ALL,22,12833,15192,28025
MOMBASA,ALL,23,14195,16513,30708
MOMBASA,ALL,24,14081,16084,30165
MOMBASA,ALL,20-24,63822,75911,139733
MOMBASA,ALL,25,16231,16675,32906
MOMBASA,ALL,26,14231,15107,29338
MOMBASA,ALL,27,14111,14768,28879
MOMBASA,ALL,28,12333,13049,25382
MOMBASA,ALL,29,12921,13202,26123
MOMBASA,ALL,25-29,69827,72801,142628
MOMBASA,ALL,30,15982,16319,32301
MOMBASA,ALL,31,10866,10548,21414
MOMBASA,ALL,32,13578,13379,26957
MOMBASA,ALL,33,10592,10562,21154
MOMBASA,ALL,34,10335,10056,20391
MOMBASA,ALL,30-34,61353,60864,122217
MOMBASA,ALL,35,12644,11396,24040
MOMBASA,ALL,36,9495,8491,17986
MOMBASA,ALL,37,9167,8165,17332
MOMBASA,ALL,38,7666,6978,14644
MOMBASA,ALL,39,8106,7005,15111
MOMBASA,ALL,35-39,47078,42035,89113
MOMBASA,ALL,40,10190,8555,18745
MOMBASA,ALL,41,8490,6541,15031
MOMBASA,ALL,42,8405,6505,14910
MOMBASA,ALL,43,6979,5521,12500
MOMBASA,ALL,44,6034,4598,10632
MOMBASA,ALL,40-44,40098,31720,71818
MOMBASA,ALL,45,8759,6234,14993
MOMBASA,ALL,46,5852,4342,10194
MOMBASA,ALL,47,6402,4282,10684
MOMBASA,ALL,48,4607,3406,8013
MOMBASA,ALL,49,5045,3338,8383
MOMBASA,ALL,45-49,30665,21602,52267
MOMBASA,ALL,50,6027,4430,10457
MOMBASA,ALL,51,4139,2577,6716
MOMBASA,ALL,52,3674,2567,6241
MOMBASA,ALL,53,2788,1911,4699
MOMBASA,ALL,54,3227,2117,5344
MOMBASA,ALL,50-54,19855,13602,33457
MOMBASA,ALL,55,3158,2059,5217
MOMBASA,ALL,56,3259,2366,5625
MOMBASA,ALL,57,2881,2099,4980
MOMBASA,ALL,58,2170,1769,3939
MOMBASA,ALL,59,2403,1908,4311
MOMBASA,ALL,55-59,13871,10201,24072
MOMBASA,ALL,60,2538,2356,4894
MOMBASA,ALL,61,1794,1444,3238
MOMBASA,ALL,62,1617,1274,2891
MOMBASA,ALL,63,1462,1273,2735
MOMBASA,ALL,64,1238,1038,2276
MOMBASA,ALL,60-64,8649,7385,16034
MOMBASA,ALL,65,1555,1434,2989
MOMBASA,ALL,66,1007,856,1863
MOMBASA,ALL,67,1229,994,2223
MOMBASA,ALL,68,721,682,1403
MOMBASA,ALL,69,879,886,1765
MOMBASA,ALL,65-69,5391,4852,10243
MOMBASA,ALL,70,1027,1265,2292
MOMBASA,ALL,71,624,618,1242
MOMBASA,ALL,72,574,518,1092
MOMBASA,ALL,73,464,446,910
MOMBASA,ALL,74,387,472,859
MOMBASA,ALL,70-74,3076,3319,6395
MOMBASA,ALL,75,430,500,930
MOMBASA,ALL,76,280,315,595
MOMBASA,ALL,77,263,263,526
MOMBASA,ALL,78,222,221,443
MOMBASA,ALL,79,241,310,551
MOMBASA,ALL,75-79,1436,1609,3045
MOMBASA,ALL,80,234,493,727
MOMBASA,ALL,81,130,178,308
MOMBASA,ALL,82,138,156,294
MOMBASA,ALL,83,128,144,272
MOMBASA,ALL,84,92,165,257
MOMBASA,ALL,80-84,722,1136,1858
MOMBASA,ALL,85,88,171,259
MOMBASA,ALL,86,65,82,147
MOMBASA,ALL,87,59,70,129
MOMBASA,ALL,88,30,57,87
MOMBASA,ALL,89,52,129,181
MOMBASA,ALL,85-89,294,509,803
MOMBASA,ALL,90,39,107,146
MOMBASA,ALL,91,17,38,55
MOMBASA,ALL,92,19,26,45
MOMBASA,ALL,93,12,24,36
MOMBASA,ALL,94,11,30,41
MOMBASA,ALL,90-94,98,225,323
MOMBASA,ALL,95,11,41,52
MOMBASA,ALL,96,13,17,30
MOMBASA,ALL,97,9,12,21
MOMBASA,ALL,98,8,7,15
MOMBASA,ALL,99,13,21,34
MOMBASA,ALL,95-99,54,98,152
MOMBASA,ALL,100+,14,59,73
MOMBASA,ALL,Not Stated,14,12,26
MOMBASA,CHANGAMWE,Total,68761,63121,131882
MOMBASA,CHANGAMWE,0,1584,1595,3179
MOMBASA,CHANGAMWE,1,1510,1447,2957
MOMBASA,CHANGAMWE,2,1557,1539,3096
MOMBASA,CHANGAMWE,3,1482,1416,2898
MOMBASA,CHANGAMWE,4,1355,1290,2645
MOMBASA,CHANGAMWE,0 - 4,7488,7287,14775
MOMBASA,CHANGAMWE,5,1369,1419,2788
MOMBASA,CHANGAMWE,6,1363,1390,2753
MOMBASA,CHANGAMWE,7,1341,1342,2683
MOMBASA,CHANGAMWE,8,1240,1202,2442
MOMBASA,CHANGAMWE,9,1288,1364,2652
MOMBASA,CHANGAMWE,05-Sep,6601,6717,13318
MOMBASA,CHANGAMWE,10,1265,1265,2530
MOMBASA,CHANGAMWE,11,1155,1227,2382
MOMBASA,CHANGAMWE,12,1210,1204,2414
MOMBASA,CHANGAMWE,13,1211,1298,2509
MOMBASA,CHANGAMWE,14,1069,1039,2108
MOMBASA,CHANGAMWE,Oct-14,5910,6033,11943
MOMBASA,CHANGAMWE,15,914,997,1911
MOMBASA,CHANGAMWE,16,885,971,1856
MOMBASA,CHANGAMWE,17,906,1100,2006
MOMBASA,CHANGAMWE,18,880,974,1854
MOMBASA,CHANGAMWE,19,1044,1168,2212
MOMBASA,CHANGAMWE,15-19,4629,5210,9839
MOMBASA,CHANGAMWE,20,1123,1455,2578
MOMBASA,CHANGAMWE,21,1287,1440,2727
MOMBASA,CHANGAMWE,22,1389,1547,2936
MOMBASA,CHANGAMWE,23,1606,1745,3351
MOMBASA,CHANGAMWE,24,1621,1716,3337
MOMBASA,CHANGAMWE,20-24,7026,7903,14929
MOMBASA,CHANGAMWE,25,1822,1861,3683
MOMBASA,CHANGAMWE,26,1592,1694,3286
MOMBASA,CHANGAMWE,27,1783,1574,3357
MOMBASA,CHANGAMWE,28,1399,1511,2910
MOMBASA,CHANGAMWE,29,1532,1581,3113
MOMBASA,CHANGAMWE,25-29,8128,8221,16349
MOMBASA,CHANGAMWE,30,1932,1844,3776
MOMBASA,CHANGAMWE,31,1357,1192,2549
MOMBASA,CHANGAMWE,32,1694,1627,3321
MOMBASA,CHANGAMWE,33,1311,1192,2503
MOMBASA,CHANGAMWE,34,1308,1185,2493
MOMBASA,CHANGAMWE,30-34,7602,7040,14642
MOMBASA,CHANGAMWE,35,1606,1385,2991
MOMBASA,CHANGAMWE,36,1206,1025,2231
MOMBASA,CHANGAMWE,37,1109,999,2108
MOMBASA,CHANGAMWE,38,981,863,1844
MOMBASA,CHANGAMWE,39,1137,843,1980
MOMBASA,CHANGAMWE,35-39,6039,5115,11154
MOMBASA,CHANGAMWE,40,1319,1007,2326
MOMBASA,CHANGAMWE,41,1137,735,1872
MOMBASA,CHANGAMWE,42,1110,721,1831
MOMBASA,CHANGAMWE,43,886,645,1531
MOMBASA,CHANGAMWE,44,768,515,1283
MOMBASA,CHANGAMWE,40-44,5220,3623,8843
MOMBASA,CHANGAMWE,45,1180,687,1867
MOMBASA,CHANGAMWE,46,766,444,1210
MOMBASA,CHANGAMWE,47,810,438,1248
MOMBASA,CHANGAMWE,48,613,369,982
MOMBASA,CHANGAMWE,49,649,357,1006
MOMBASA,CHANGAMWE,45-49,4018,2295,6313
MOMBASA,CHANGAMWE,50,722,458,1180
MOMBASA,CHANGAMWE,51,478,264,742
MOMBASA,CHANGAMWE,52,429,264,693
MOMBASA,CHANGAMWE,53,346,196,542
MOMBASA,CHANGAMWE,54,424,211,635
MOMBASA,CHANGAMWE,50-54,2399,1393,3792
MOMBASA,CHANGAMWE,55,403,208,611
MOMBASA,CHANGAMWE,56,387,197,584
MOMBASA,CHANGAMWE,57,354,176,530
MOMBASA,CHANGAMWE,58,272,145,417
MOMBASA,CHANGAMWE,59,284,147,431
MOMBASA,CHANGAMWE,55-59,1700,873,2573
MOMBASA,CHANGAMWE,60,304,180,484
MOMBASA,CHANGAMWE,61,205,131,336
MOMBASA,CHANGAMWE,62,179,99,278
MOMBASA,CHANGAMWE,63,144,95,239
MOMBASA,CHANGAMWE,64,135,74,209
MOMBASA,CHANGAMWE,60-64,967,579,1546
MOMBASA,CHANGAMWE,65,189,97,286
MOMBASA,CHANGAMWE,66,98,63,161
MOMBASA,CHANGAMWE,67,121,83,204
MOMBASA,CHANGAMWE,68,78,60,138
MOMBASA,CHANGAMWE,69,96,71,167
MOMBASA,CHANGAMWE,65-69,582,374,956
MOMBASA,CHANGAMWE,70,87,88,175
MOMBASA,CHANGAMWE,71,51,40,91
MOMBASA,CHANGAMWE,72,65,32,97
MOMBASA,CHANGAMWE,73,34,31,65
MOMBASA,CHANGAMWE,74,32,34,66
MOMBASA,CHANGAMWE,70-74,269,225,494
MOMBASA,CHANGAMWE,75,33,34,67
MOMBASA,CHANGAMWE,76,16,19,35
MOMBASA,CHANGAMWE,77,20,15,35
MOMBASA,CHANGAMWE,78,13,5,18
MOMBASA,CHANGAMWE,79,11,22,33
MOMBASA,CHANGAMWE,75-79,93,95,188
MOMBASA,CHANGAMWE,80,19,31,50
MOMBASA,CHANGAMWE,81,9,11,20
MOMBASA,CHANGAMWE,82,6,10,16
MOMBASA,CHANGAMWE,83,15,10,25
MOMBASA,CHANGAMWE,84,7,14,21
MOMBASA,CHANGAMWE,80-84,56,76,132
MOMBASA,CHANGAMWE,85,3,7,10
MOMBASA,CHANGAMWE,86,3,3,6
MOMBASA,CHANGAMWE,87,5,1,6
MOMBASA,CHANGAMWE,88,1,7,8
MOMBASA,CHANGAMWE,89,8,6,14
MOMBASA,CHANGAMWE,85-89,20,24,44
MOMBASA,CHANGAMWE,90,2,12,14
MOMBASA,CHANGAMWE,91,4,3,7
MOMBASA,CHANGAMWE,92,1,2,3
MOMBASA,CHANGAMWE,93,2,1,3
MOMBASA,CHANGAMWE,94,1,2,3
MOMBASA,CHANGAMWE,90-94,10,20,30
MOMBASA,CHANGAMWE,95,1,5,6
MOMBASA,CHANGAMWE,96,-,2,2
MOMBASA,CHANGAMWE,97,1,1,2
MOMBASA,CHANGAMWE,98,-,2,2
MOMBASA,CHANGAMWE,99,-,2,2
MOMBASA,CHANGAMWE,95-99,2,12,14
MOMBASA,CHANGAMWE,100+,2,5,7
MOMBASA,CHANGAMWE,Not Stated,-,1,1
MOMBASA,JOMVU,Total,83002,80410,163412
MOMBASA,JOMVU,0,2285,2176,4461
MOMBASA,JOMVU,1,2294,2136,4430
MOMBASA,JOMVU,2,2100,2077,4177
MOMBASA,JOMVU,3,2063,2055,4118
MOMBASA,JOMVU,4,2026,1944,3970
MOMBASA,JOMVU,0 - 4,10768,10388,21156
MOMBASA,JOMVU,5,1968,2028,3996
MOMBASA,JOMVU,6,1804,1898,3702
MOMBASA,JOMVU,7,1912,1945,3857
MOMBASA,JOMVU,8,1737,1881,3618
MOMBASA,JOMVU,9,1934,1850,3784
MOMBASA,JOMVU,05-Sep,9355,9602,18957
MOMBASA,JOMVU,10,1820,1838,3658
MOMBASA,JOMVU,11,1627,1765,3392
MOMBASA,JOMVU,12,1712,1667,3379
MOMBASA,JOMVU,13,1689,1697,3386
MOMBASA,JOMVU,14,1412,1501,2913
MOMBASA,JOMVU,Oct-14,8260,8468,16728
MOMBASA,JOMVU,15,1300,1313,2613
MOMBASA,JOMVU,16,1150,1276,2426
MOMBASA,JOMVU,17,1229,1296,2525
MOMBASA,JOMVU,18,1143,1316,2459
MOMBASA,JOMVU,19,1326,1666,2992
MOMBASA,JOMVU,15-19,6148,6867,13015
MOMBASA,JOMVU,20,1400,1767,3167
MOMBASA,JOMVU,21,1397,1707,3104
MOMBASA,JOMVU,22,1609,1912,3521
MOMBASA,JOMVU,23,1769,2041,3810
MOMBASA,JOMVU,24,1800,2045,3845
MOMBASA,JOMVU,20-24,7975,9472,17447
MOMBASA,JOMVU,25,2110,2152,4262
MOMBASA,JOMVU,26,1901,2001,3902
MOMBASA,JOMVU,27,1822,2027,3849
MOMBASA,JOMVU,28,1603,1706,3309
MOMBASA,JOMVU,29,1739,1801,3540
MOMBASA,JOMVU,25-29,9175,9687,18862
MOMBASA,JOMVU,30,2140,2255,4395
MOMBASA,JOMVU,31,1560,1496,3056
MOMBASA,JOMVU,32,1876,1886,3762
MOMBASA,JOMVU,33,1511,1514,3025
MOMBASA,JOMVU,34,1455,1517,2972
MOMBASA,JOMVU,30-34,8542,8668,17210
MOMBASA,JOMVU,35,1793,1577,3370
MOMBASA,JOMVU,36,1355,1275,2630
MOMBASA,JOMVU,37,1381,1252,2633
MOMBASA,JOMVU,38,1101,981,2082
MOMBASA,JOMVU,39,1079,972,2051
MOMBASA,JOMVU,35-39,6709,6057,12766
MOMBASA,JOMVU,40,1408,1142,2550
MOMBASA,JOMVU,41,1224,917,2141
MOMBASA,JOMVU,42,1212,872,2084
MOMBASA,JOMVU,43,1006,722,1728
MOMBASA,JOMVU,44,903,599,1502
MOMBASA,JOMVU,40-44,5753,4252,10005
MOMBASA,JOMVU,45,1182,827,2009
MOMBASA,JOMVU,46,833,536,1369
MOMBASA,JOMVU,47,912,536,1448
MOMBASA,JOMVU,48,654,378,1032
MOMBASA,JOMVU,49,646,355,1001
MOMBASA,JOMVU,45-49,4227,2632,6859
MOMBASA,JOMVU,50,761,488,1249
MOMBASA,JOMVU,51,557,273,830
MOMBASA,JOMVU,52,436,235,671
MOMBASA,JOMVU,53,348,182,530
MOMBASA,JOMVU,54,356,195,551
MOMBASA,JOMVU,50-54,2458,1373,3831
MOMBASA,JOMVU,55,368,211,579
MOMBASA,JOMVU,56,391,263,654
MOMBASA,JOMVU,57,313,222,535
MOMBASA,JOMVU,58,252,163,415
MOMBASA,JOMVU,59,294,166,460
MOMBASA,JOMVU,55-59,1618,1025,2643
MOMBASA,JOMVU,60,269,291,560
MOMBASA,JOMVU,61,212,134,346
MOMBASA,JOMVU,62,174,125,299
MOMBASA,JOMVU,63,155,139,294
MOMBASA,JOMVU,64,137,113,250
MOMBASA,JOMVU,60-64,947,802,1749
MOMBASA,JOMVU,65,173,145,318
MOMBASA,JOMVU,66,121,84,205
MOMBASA,JOMVU,67,145,96,241
MOMBASA,JOMVU,68,68,64,132
MOMBASA,JOMVU,69,92,93,185
MOMBASA,JOMVU,65-69,599,482,1081
MOMBASA,JOMVU,70,94,122,216
MOMBASA,JOMVU,71,57,67,124
MOMBASA,JOMVU,72,56,45,101
MOMBASA,JOMVU,73,50,38,88
MOMBASA,JOMVU,74,23,45,68
MOMBASA,JOMVU,70-74,280,317,597
MOMBASA,JOMVU,75,35,47,82
MOMBASA,JOMVU,76,26,21,47
MOMBASA,JOMVU,77,25,18,43
MOMBASA,JOMVU,78,13,12,25
MOMBASA,JOMVU,79,18,31,49
MOMBASA,JOMVU,75-79,117,129,246
MOMBASA,JOMVU,80,14,36,50
MOMBASA,JOMVU,81,7,21,28
MOMBASA,JOMVU,82,10,11,21
MOMBASA,JOMVU,83,5,10,15
MOMBASA,JOMVU,84,2,9,11
MOMBASA,JOMVU,80-84,38,87,125
MOMBASA,JOMVU,85,4,15,19
MOMBASA,JOMVU,86,3,5,8
MOMBASA,JOMVU,87,6,7,13
MOMBASA,JOMVU,88,1,6,7
MOMBASA,JOMVU,89,2,19,21
MOMBASA,JOMVU,85-89,16,52,68
MOMBASA,JOMVU,90,2,12,14
MOMBASA,JOMVU,91,1,4,5
MOMBASA,JOMVU,92,2,4,6
MOMBASA,JOMVU,93,1,8,9
MOMBASA,JOMVU,94,2,3,5
MOMBASA,JOMVU,90-94,8,31,39
MOMBASA,JOMVU,95,1,6,7
MOMBASA,JOMVU,96,-,1,1
MOMBASA,JOMVU,97,-,1,1
MOMBASA,JOMVU,98,2,1,3
MOMBASA,JOMVU,99,1,2,3
MOMBASA,JOMVU,95-99,4,11,15
MOMBASA,JOMVU,100+,3,6,9
MOMBASA,JOMVU,Not Stated,2,2,4
MOMBASA,KISAUNI,Total,146748,145176,291924
MOMBASA,KISAUNI,0,3826,3805,7631
MOMBASA,KISAUNI,1,4098,3986,8084
MOMBASA,KISAUNI,2,3941,3790,7731
MOMBASA,KISAUNI,3,3709,3623,7332
MOMBASA,KISAUNI,4,3622,3572,7194
MOMBASA,KISAUNI,0 - 4,19196,18776,37972
MOMBASA,KISAUNI,5,3522,3548,7070
MOMBASA,KISAUNI,6,3287,3301,6588
MOMBASA,KISAUNI,7,3418,3326,6744
MOMBASA,KISAUNI,8,3080,3129,6209
MOMBASA,KISAUNI,9,3196,3201,6397
MOMBASA,KISAUNI,05-Sep,16503,16505,33008
MOMBASA,KISAUNI,10,3130,3085,6215
MOMBASA,KISAUNI,11,2893,2973,5866
MOMBASA,KISAUNI,12,2931,2995,5926
MOMBASA,KISAUNI,13,2985,3047,6032
MOMBASA,KISAUNI,14,2602,2702,5304
MOMBASA,KISAUNI,Oct-14,14541,14802,29343
MOMBASA,KISAUNI,15,2309,2460,4769
MOMBASA,KISAUNI,16,2273,2429,4702
MOMBASA,KISAUNI,17,2592,2547,5139
MOMBASA,KISAUNI,18,2273,2431,4704
MOMBASA,KISAUNI,19,2606,3084,5690
MOMBASA,KISAUNI,15-19,12053,12951,25004
MOMBASA,KISAUNI,20,2609,3474,6083
MOMBASA,KISAUNI,21,2648,3266,5914
MOMBASA,KISAUNI,22,3001,3614,6615
MOMBASA,KISAUNI,23,3213,3993,7206
MOMBASA,KISAUNI,24,3218,3810,7028
MOMBASA,KISAUNI,20-24,14689,18157,32846
MOMBASA,KISAUNI,25,3822,4055,7877
MOMBASA,KISAUNI,26,3402,3634,7036
MOMBASA,KISAUNI,27,3367,3534,6901
MOMBASA,KISAUNI,28,2831,3176,6007
MOMBASA,KISAUNI,29,3106,3304,6410
MOMBASA,KISAUNI,25-29,16528,17703,34231
MOMBASA,KISAUNI,30,3789,3847,7636
MOMBASA,KISAUNI,31,2602,2607,5209
MOMBASA,KISAUNI,32,3232,3158,6390
MOMBASA,KISAUNI,33,2523,2521,5044
MOMBASA,KISAUNI,34,2443,2495,4938
MOMBASA,KISAUNI,30-34,14589,14628,29217
MOMBASA,KISAUNI,35,2952,2759,5711
MOMBASA,KISAUNI,36,2285,2009,4294
MOMBASA,KISAUNI,37,2207,1843,4050
MOMBASA,KISAUNI,38,1783,1577,3360
MOMBASA,KISAUNI,39,1957,1626,3583
MOMBASA,KISAUNI,35-39,11184,9814,20998
MOMBASA,KISAUNI,40,2333,2008,4341
MOMBASA,KISAUNI,41,2052,1541,3593
MOMBASA,KISAUNI,42,1951,1518,3469
MOMBASA,KISAUNI,43,1592,1282,2874
MOMBASA,KISAUNI,44,1384,1065,2449
MOMBASA,KISAUNI,40-44,9312,7414,16726
MOMBASA,KISAUNI,45,1922,1466,3388
MOMBASA,KISAUNI,46,1308,1069,2377
MOMBASA,KISAUNI,47,1499,1001,2500
MOMBASA,KISAUNI,48,1003,781,1784
MOMBASA,KISAUNI,49,1179,791,1970
MOMBASA,KISAUNI,45-49,6911,5108,12019
MOMBASA,KISAUNI,50,1383,1021,2404
MOMBASA,KISAUNI,51,956,594,1550
MOMBASA,KISAUNI,52,841,591,1432
MOMBASA,KISAUNI,53,581,425,1006
MOMBASA,KISAUNI,54,709,445,1154
MOMBASA,KISAUNI,50-54,4470,3076,7546
MOMBASA,KISAUNI,55,701,401,1102
MOMBASA,KISAUNI,56,669,514,1183
MOMBASA,KISAUNI,57,653,460,1113
MOMBASA,KISAUNI,58,401,381,782
MOMBASA,KISAUNI,59,458,431,889
MOMBASA,KISAUNI,55-59,2882,2187,5069
MOMBASA,KISAUNI,60,514,509,1023
MOMBASA,KISAUNI,61,364,322,686
MOMBASA,KISAUNI,62,321,278,599
MOMBASA,KISAUNI,63,289,306,595
MOMBASA,KISAUNI,64,237,221,458
MOMBASA,KISAUNI,60-64,1725,1636,3361
MOMBASA,KISAUNI,65,315,318,633
MOMBASA,KISAUNI,66,216,167,383
MOMBASA,KISAUNI,67,255,216,471
MOMBASA,KISAUNI,68,143,121,264
MOMBASA,KISAUNI,69,186,193,379
MOMBASA,KISAUNI,65-69,1115,1015,2130
MOMBASA,KISAUNI,70,208,269,477
MOMBASA,KISAUNI,71,135,115,250
MOMBASA,KISAUNI,72,90,92,182
MOMBASA,KISAUNI,73,88,82,170
MOMBASA,KISAUNI,74,74,80,154
MOMBASA,KISAUNI,70-74,595,638,1233
MOMBASA,KISAUNI,75,89,95,184
MOMBASA,KISAUNI,76,44,67,111
MOMBASA,KISAUNI,77,40,57,97
MOMBASA,KISAUNI,78,38,38,76
MOMBASA,KISAUNI,79,39,75,114
MOMBASA,KISAUNI,75-79,250,332,582
MOMBASA,KISAUNI,80,40,110,150
MOMBASA,KISAUNI,81,21,29,50
MOMBASA,KISAUNI,82,17,20,37
MOMBASA,KISAUNI,83,15,28,43
MOMBASA,KISAUNI,84,18,37,55
MOMBASA,KISAUNI,80-84,111,224,335
MOMBASA,KISAUNI,85,19,44,63
MOMBASA,KISAUNI,86,16,16,32
MOMBASA,KISAUNI,87,7,14,21
MOMBASA,KISAUNI,88,8,9,17
MOMBASA,KISAUNI,89,9,32,41
MOMBASA,KISAUNI,85-89,59,115,174
MOMBASA,KISAUNI,90,6,27,33
MOMBASA,KISAUNI,91,3,8,11
MOMBASA,KISAUNI,92,2,4,6
MOMBASA,KISAUNI,93,-,5,5
MOMBASA,KISAUNI,94,2,8,10
MOMBASA,KISAUNI,90-94,13,52,65
MOMBASA,KISAUNI,95,4,13,17
MOMBASA,KISAUNI,96,4,2,6
MOMBASA,KISAUNI,97,2,2,4
MOMBASA,KISAUNI,98,1,1,2
MOMBASA,KISAUNI,99,6,5,11
MOMBASA,KISAUNI,95-99,17,23,40
MOMBASA,KISAUNI,100+,4,18,22
MOMBASA,KISAUNI,Not Stated,1,2,3
MOMBASA,LIKONI,Total,126962,123392,250354
MOMBASA,LIKONI,0,3529,3510,7039
MOMBASA,LIKONI,1,3519,3511,7030
MOMBASA,LIKONI,2,3350,3375,6725
MOMBASA,LIKONI,3,3295,3098,6393
MOMBASA,LIKONI,4,3183,3263,6446
MOMBASA,LIKONI,0 - 4,16876,16757,33633
MOMBASA,LIKONI,5,3141,3163,6304
MOMBASA,LIKONI,6,2816,2894,5710
MOMBASA,LIKONI,7,2829,2902,5731
MOMBASA,LIKONI,8,2533,2614,5147
MOMBASA,LIKONI,9,2592,2718,5310
MOMBASA,LIKONI,05-Sep,13911,14291,28202
MOMBASA,LIKONI,10,2546,2632,5178
MOMBASA,LIKONI,11,2142,2286,4428
MOMBASA,LIKONI,12,2427,2404,4831
MOMBASA,LIKONI,13,2312,2595,4907
MOMBASA,LIKONI,14,2185,2353,4538
MOMBASA,LIKONI,Oct-14,11612,12270,23882
MOMBASA,LIKONI,15,1900,2005,3905
MOMBASA,LIKONI,16,1812,2070,3882
MOMBASA,LIKONI,17,2039,2161,4200
MOMBASA,LIKONI,18,1781,2225,4006
MOMBASA,LIKONI,19,2224,2861,5085
MOMBASA,LIKONI,15-19,9756,11322,21078
MOMBASA,LIKONI,20,2406,3254,5660
MOMBASA,LIKONI,21,2464,2909,5373
MOMBASA,LIKONI,22,2822,3517,6339
MOMBASA,LIKONI,23,3173,3813,6986
MOMBASA,LIKONI,24,3302,3736,7038
MOMBASA,LIKONI,20-24,14167,17229,31396
MOMBASA,LIKONI,25,3785,3780,7565
MOMBASA,LIKONI,26,3303,3350,6653
MOMBASA,LIKONI,27,3207,3238,6445
MOMBASA,LIKONI,28,2742,2797,5539
MOMBASA,LIKONI,29,2859,2699,5558
MOMBASA,LIKONI,25-29,15896,15864,31760
MOMBASA,LIKONI,30,3712,3644,7356
MOMBASA,LIKONI,31,2264,2055,4319
MOMBASA,LIKONI,32,2889,2752,5641
MOMBASA,LIKONI,33,2222,2095,4317
MOMBASA,LIKONI,34,2173,1866,4039
MOMBASA,LIKONI,30-34,13260,12412,25672
MOMBASA,LIKONI,35,2704,2185,4889
MOMBASA,LIKONI,36,1882,1502,3384
MOMBASA,LIKONI,37,1811,1511,3322
MOMBASA,LIKONI,38,1518,1208,2726
MOMBASA,LIKONI,39,1501,1244,2745
MOMBASA,LIKONI,35-39,9416,7650,17066
MOMBASA,LIKONI,40,2165,1670,3835
MOMBASA,LIKONI,41,1580,1188,2768
MOMBASA,LIKONI,42,1582,1163,2745
MOMBASA,LIKONI,43,1360,917,2277
MOMBASA,LIKONI,44,1100,787,1887
MOMBASA,LIKONI,40-44,7787,5725,13512
MOMBASA,LIKONI,45,1738,1036,2774
MOMBASA,LIKONI,46,1016,678,1694
MOMBASA,LIKONI,47,1096,707,1803
MOMBASA,LIKONI,48,770,534,1304
MOMBASA,LIKONI,49,858,508,1366
MOMBASA,LIKONI,45-49,5478,3463,8941
MOMBASA,LIKONI,50,1133,821,1954
MOMBASA,LIKONI,51,736,414,1150
MOMBASA,LIKONI,52,645,385,1030
MOMBASA,LIKONI,53,407,240,647
MOMBASA,LIKONI,54,524,275,799
MOMBASA,LIKONI,50-54,3445,2135,5580
MOMBASA,LIKONI,55,557,286,843
MOMBASA,LIKONI,56,543,378,921
MOMBASA,LIKONI,57,458,315,773
MOMBASA,LIKONI,58,372,267,639
MOMBASA,LIKONI,59,356,318,674
MOMBASA,LIKONI,55-59,2286,1564,3850
MOMBASA,LIKONI,60,454,406,860
MOMBASA,LIKONI,61,282,210,492
MOMBASA,LIKONI,62,256,196,452
MOMBASA,LIKONI,63,231,175,406
MOMBASA,LIKONI,64,208,151,359
MOMBASA,LIKONI,60-64,1431,1138,2569
MOMBASA,LIKONI,65,259,225,484
MOMBASA,LIKONI,66,157,106,263
MOMBASA,LIKONI,67,199,159,358
MOMBASA,LIKONI,68,102,77,179
MOMBASA,LIKONI,69,134,142,276
MOMBASA,LIKONI,65-69,851,709,1560
MOMBASA,LIKONI,70,167,215,382
MOMBASA,LIKONI,71,93,63,156
MOMBASA,LIKONI,72,77,50,127
MOMBASA,LIKONI,73,56,43,99
MOMBASA,LIKONI,74,52,37,89
MOMBASA,LIKONI,70-74,445,408,853
MOMBASA,LIKONI,75,57,76,133
MOMBASA,LIKONI,76,31,37,68
MOMBASA,LIKONI,77,37,32,69
MOMBASA,LIKONI,78,22,31,53
MOMBASA,LIKONI,79,42,31,73
MOMBASA,LIKONI,75-79,189,207,396
MOMBASA,LIKONI,80,28,89,117
MOMBASA,LIKONI,81,22,15,37
MOMBASA,LIKONI,82,20,12,32
MOMBASA,LIKONI,83,11,10,21
MOMBASA,LIKONI,84,15,17,32
MOMBASA,LIKONI,80-84,96,143,239
MOMBASA,LIKONI,85,13,13,26
MOMBASA,LIKONI,86,7,7,14
MOMBASA,LIKONI,87,7,11,18
MOMBASA,LIKONI,88,3,7,10
MOMBASA,LIKONI,89,5,26,31
MOMBASA,LIKONI,85-89,35,64,99
MOMBASA,LIKONI,90,5,11,16
MOMBASA,LIKONI,91,-,2,2
MOMBASA,LIKONI,92,2,2,4
MOMBASA,LIKONI,93,3,1,4
MOMBASA,LIKONI,94,1,5,6
MOMBASA,LIKONI,90-94,11,21,32
MOMBASA,LIKONI,95,2,5,7
MOMBASA,LIKONI,96,3,-,3
MOMBASA,LIKONI,97,1,3,4
MOMBASA,LIKONI,98,1,-,1
MOMBASA,LIKONI,99,1,2,3
MOMBASA,LIKONI,95-99,8,10,18
MOMBASA,LIKONI,100+,3,8,11
MOMBASA,LIKONI,Not Stated,3,2,5
MOMBASA,MVITA,Total,75565,78601,154166
MOMBASA,MVITA,0,1535,1468,3003
MOMBASA,MVITA,1,1582,1482,3064
MOMBASA,MVITA,2,1599,1540,3139
MOMBASA,MVITA,3,1636,1510,3146
MOMBASA,MVITA,4,1584,1566,3150
MOMBASA,MVITA,0 - 4,7936,7566,15502
MOMBASA,MVITA,5,1531,1528,3059
MOMBASA,MVITA,6,1410,1519,2929
MOMBASA,MVITA,7,1497,1463,2960
MOMBASA,MVITA,8,1392,1485,2877
MOMBASA,MVITA,9,1490,1404,2894
MOMBASA,MVITA,05-Sep,7320,7399,14719
MOMBASA,MVITA,10,1491,1478,2969
MOMBASA,MVITA,11,1405,1349,2754
MOMBASA,MVITA,12,1403,1443,2846
MOMBASA,MVITA,13,1486,1439,2925
MOMBASA,MVITA,14,1401,1368,2769
MOMBASA,MVITA,Oct-14,7186,7077,14263
MOMBASA,MVITA,15,1274,1283,2557
MOMBASA,MVITA,16,1360,1420,2780
MOMBASA,MVITA,17,1456,1562,3018
MOMBASA,MVITA,18,1372,1514,2886
MOMBASA,MVITA,19,1527,1856,3383
MOMBASA,MVITA,15-19,6989,7635,14624
MOMBASA,MVITA,20,1631,1895,3526
MOMBASA,MVITA,21,1624,1773,3397
MOMBASA,MVITA,22,1692,1874,3566
MOMBASA,MVITA,23,1777,1876,3653
MOMBASA,MVITA,24,1609,1768,3377
MOMBASA,MVITA,20-24,8333,9186,17519
MOMBASA,MVITA,25,1691,1740,3431
MOMBASA,MVITA,26,1435,1538,2973
MOMBASA,MVITA,27,1334,1518,2852
MOMBASA,MVITA,28,1391,1369,2760
MOMBASA,MVITA,29,1304,1334,2638
MOMBASA,MVITA,25-29,7155,7499,14654
MOMBASA,MVITA,30,1456,1665,3121
MOMBASA,MVITA,31,1048,1173,2221
MOMBASA,MVITA,32,1307,1431,2738
MOMBASA,MVITA,33,1085,1217,2302
MOMBASA,MVITA,34,998,1150,2148
MOMBASA,MVITA,30-34,5894,6636,12530
MOMBASA,MVITA,35,1198,1297,2495
MOMBASA,MVITA,36,1007,1136,2143
MOMBASA,MVITA,37,958,1047,2005
MOMBASA,MVITA,38,900,1035,1935
MOMBASA,MVITA,39,934,960,1894
MOMBASA,MVITA,35-39,4997,5475,10472
MOMBASA,MVITA,40,1088,1161,2249
MOMBASA,MVITA,41,924,909,1833
MOMBASA,MVITA,42,1029,1035,2064
MOMBASA,MVITA,43,833,941,1774
MOMBASA,MVITA,44,768,769,1537
MOMBASA,MVITA,40-44,4642,4815,9457
MOMBASA,MVITA,45,1098,1018,2116
MOMBASA,MVITA,46,773,766,1539
MOMBASA,MVITA,47,881,771,1652
MOMBASA,MVITA,48,704,684,1388
MOMBASA,MVITA,49,722,694,1416
MOMBASA,MVITA,45-49,4178,3933,8111
MOMBASA,MVITA,50,874,850,1724
MOMBASA,MVITA,51,634,532,1166
MOMBASA,MVITA,52,636,586,1222
MOMBASA,MVITA,53,522,505,1027
MOMBASA,MVITA,54,593,577,1170
MOMBASA,MVITA,50-54,3259,3050,6309
MOMBASA,MVITA,55,531,535,1066
MOMBASA,MVITA,56,651,562,1213
MOMBASA,MVITA,57,527,515,1042
MOMBASA,MVITA,58,460,495,955
MOMBASA,MVITA,59,518,487,1005
MOMBASA,MVITA,55-59,2687,2594,5281
MOMBASA,MVITA,60,530,555,1085
MOMBASA,MVITA,61,366,373,739
MOMBASA,MVITA,62,381,345,726
MOMBASA,MVITA,63,340,347,687
MOMBASA,MVITA,64,300,294,594
MOMBASA,MVITA,60-64,1917,1914,3831
MOMBASA,MVITA,65,343,399,742
MOMBASA,MVITA,66,253,280,533
MOMBASA,MVITA,67,277,285,562
MOMBASA,MVITA,68,211,226,437
MOMBASA,MVITA,69,205,250,455
MOMBASA,MVITA,65-69,1289,1440,2729
MOMBASA,MVITA,70,264,336,600
MOMBASA,MVITA,71,156,212,368
MOMBASA,MVITA,72,186,208,394
MOMBASA,MVITA,73,144,168,312
MOMBASA,MVITA,74,128,177,305
MOMBASA,MVITA,70-74,878,1101,1979
MOMBASA,MVITA,75,118,180,298
MOMBASA,MVITA,76,106,114,220
MOMBASA,MVITA,77,84,100,184
MOMBASA,MVITA,78,84,96,180
MOMBASA,MVITA,79,80,90,170
MOMBASA,MVITA,75-79,472,580,1052
MOMBASA,MVITA,80,84,143,227
MOMBASA,MVITA,81,43,73,116
MOMBASA,MVITA,82,58,77,135
MOMBASA,MVITA,83,57,63,120
MOMBASA,MVITA,84,33,66,99
MOMBASA,MVITA,80-84,275,422,697
MOMBASA,MVITA,85,29,70,99
MOMBASA,MVITA,86,20,30,50
MOMBASA,MVITA,87,25,22,47
MOMBASA,MVITA,88,10,20,30
MOMBASA,MVITA,89,17,26,43
MOMBASA,MVITA,85-89,101,168,269
MOMBASA,MVITA,90,18,31,49
MOMBASA,MVITA,91,5,13,18
MOMBASA,MVITA,92,6,10,16
MOMBASA,MVITA,93,4,6,10
MOMBASA,MVITA,94,2,7,9
MOMBASA,MVITA,90-94,35,67,102
MOMBASA,MVITA,95,-,8,8
MOMBASA,MVITA,96,4,8,12
MOMBASA,MVITA,97,4,3,7
MOMBASA,MVITA,98,4,3,7
MOMBASA,MVITA,99,4,6,10
MOMBASA,MVITA,95-99,16,28,44
MOMBASA,MVITA,100+,1,13,14
MOMBASA,MVITA,Not Stated,5,3,8
MOMBASA,NYALI,Total,109219,107346,216565
MOMBASA,NYALI,0,2352,2455,4807
MOMBASA,NYALI,1,2802,2746,5548
MOMBASA,NYALI,2,2541,2516,5057
MOMBASA,NYALI,3,2475,2329,4804
MOMBASA,NYALI,4,2291,2358,4649
MOMBASA,NYALI,0 - 4,12461,12404,24865
MOMBASA,NYALI,5,2320,2337,4657
MOMBASA,NYALI,6,2209,2214,4423
MOMBASA,NYALI,7,2271,2225,4496
MOMBASA,NYALI,8,2014,2112,4126
MOMBASA,NYALI,9,2023,2057,4080
MOMBASA,NYALI,05-Sep,10837,10945,21782
MOMBASA,NYALI,10,2097,2045,4142
MOMBASA,NYALI,11,1893,1897,3790
MOMBASA,NYALI,12,1978,1917,3895
MOMBASA,NYALI,13,1948,2005,3953
MOMBASA,NYALI,14,1719,1766,3485
MOMBASA,NYALI,Oct-14,9635,9630,19265
MOMBASA,NYALI,15,1502,1666,3168
MOMBASA,NYALI,16,1442,1697,3139
MOMBASA,NYALI,17,1641,1821,3462
MOMBASA,NYALI,18,1515,1757,3272
MOMBASA,NYALI,19,1869,2263,4132
MOMBASA,NYALI,15-19,7969,9204,17173
MOMBASA,NYALI,20,2017,2571,4588
MOMBASA,NYALI,21,2107,2611,4718
MOMBASA,NYALI,22,2320,2728,5048
MOMBASA,NYALI,23,2657,3045,5702
MOMBASA,NYALI,24,2531,3009,5540
MOMBASA,NYALI,20-24,11632,13964,25596
MOMBASA,NYALI,25,3001,3087,6088
MOMBASA,NYALI,26,2598,2890,5488
MOMBASA,NYALI,27,2598,2877,5475
MOMBASA,NYALI,28,2367,2490,4857
MOMBASA,NYALI,29,2381,2483,4864
MOMBASA,NYALI,25-29,12945,13827,26772
MOMBASA,NYALI,30,2953,3064,6017
MOMBASA,NYALI,31,2035,2025,4060
MOMBASA,NYALI,32,2580,2525,5105
MOMBASA,NYALI,33,1940,2023,3963
MOMBASA,NYALI,34,1958,1843,3801
MOMBASA,NYALI,30-34,11466,11480,22946
MOMBASA,NYALI,35,2391,2193,4584
MOMBASA,NYALI,36,1760,1544,3304
MOMBASA,NYALI,37,1701,1513,3214
MOMBASA,NYALI,38,1383,1314,2697
MOMBASA,NYALI,39,1498,1360,2858
MOMBASA,NYALI,35-39,8733,7924,16657
MOMBASA,NYALI,40,1877,1567,3444
MOMBASA,NYALI,41,1573,1251,2824
MOMBASA,NYALI,42,1521,1196,2717
MOMBASA,NYALI,43,1302,1014,2316
MOMBASA,NYALI,44,1111,863,1974
MOMBASA,NYALI,40-44,7384,5891,13275
MOMBASA,NYALI,45,1639,1200,2839
MOMBASA,NYALI,46,1156,849,2005
MOMBASA,NYALI,47,1204,829,2033
MOMBASA,NYALI,48,863,660,1523
MOMBASA,NYALI,49,991,633,1624
MOMBASA,NYALI,45-49,5853,4171,10024
MOMBASA,NYALI,50,1154,792,1946
MOMBASA,NYALI,51,778,500,1278
MOMBASA,NYALI,52,687,506,1193
MOMBASA,NYALI,53,584,363,947
MOMBASA,NYALI,54,621,414,1035
MOMBASA,NYALI,50-54,3824,2575,6399
MOMBASA,NYALI,55,598,418,1016
MOMBASA,NYALI,56,618,452,1070
MOMBASA,NYALI,57,576,411,987
MOMBASA,NYALI,58,413,318,731
MOMBASA,NYALI,59,493,359,852
MOMBASA,NYALI,55-59,2698,1958,4656
MOMBASA,NYALI,60,467,415,882
MOMBASA,NYALI,61,365,274,639
MOMBASA,NYALI,62,306,231,537
MOMBASA,NYALI,63,303,211,514
MOMBASA,NYALI,64,221,185,406
MOMBASA,NYALI,60-64,1662,1316,2978
MOMBASA,NYALI,65,276,250,526
MOMBASA,NYALI,66,162,156,318
MOMBASA,NYALI,67,232,155,387
MOMBASA,NYALI,68,119,134,253
MOMBASA,NYALI,69,166,137,303
MOMBASA,NYALI,65-69,955,832,1787
MOMBASA,NYALI,70,207,235,442
MOMBASA,NYALI,71,132,121,253
MOMBASA,NYALI,72,100,91,191
MOMBASA,NYALI,73,92,84,176
MOMBASA,NYALI,74,78,99,177
MOMBASA,NYALI,70-74,609,630,1239
MOMBASA,NYALI,75,98,68,166
MOMBASA,NYALI,76,57,57,114
MOMBASA,NYALI,77,57,41,98
MOMBASA,NYALI,78,52,39,91
MOMBASA,NYALI,79,51,61,112
MOMBASA,NYALI,75-79,315,266,581
MOMBASA,NYALI,80,49,84,133
MOMBASA,NYALI,81,28,29,57
MOMBASA,NYALI,82,27,26,53
MOMBASA,NYALI,83,25,23,48
MOMBASA,NYALI,84,17,22,39
MOMBASA,NYALI,80-84,146,184,330
MOMBASA,NYALI,85,20,22,42
MOMBASA,NYALI,86,16,21,37
MOMBASA,NYALI,87,9,15,24
MOMBASA,NYALI,88,7,8,15
MOMBASA,NYALI,89,11,20,31
MOMBASA,NYALI,85-89,63,86,149
MOMBASA,NYALI,90,6,14,20
MOMBASA,NYALI,91,4,8,12
MOMBASA,NYALI,92,6,4,10
MOMBASA,NYALI,93,2,3,5
MOMBASA,NYALI,94,3,5,8
MOMBASA,NYALI,90-94,21,34,55
MOMBASA,NYALI,95,3,4,7
MOMBASA,NYALI,96,2,4,6
MOMBASA,NYALI,97,1,2,3
MOMBASA,NYALI,98,-,-,-
MOMBASA,NYALI,99,1,4,5
MOMBASA,NYALI,95-99,7,14,21
MOMBASA,NYALI,100+,1,9,10
MOMBASA,NYALI,Not Stated,3,2,5
MURANG'A,ALL,Total,523940,532669,1056609
MURANG'A,ALL,0,10902,10549,21451
MURANG'A,ALL,1,10891,10729,21620
MURANG'A,ALL,2,11127,10804,21931
MURANG'A,ALL,3,11144,11394,22538
MURANG'A,ALL,4,11631,11343,22974
MURANG'A,ALL,0 - 4,55695,54819,110514
MURANG'A,ALL,5,11199,10834,22033
MURANG'A,ALL,6,11096,11133,22229
MURANG'A,ALL,7,11630,11365,22995
MURANG'A,ALL,8,11248,11064,22312
MURANG'A,ALL,9,12391,12291,24682
MURANG'A,ALL,05-Sep,57564,56687,114251
MURANG'A,ALL,10,11966,11576,23542
MURANG'A,ALL,11,11092,11152,22244
MURANG'A,ALL,12,12314,11746,24060
MURANG'A,ALL,13,12435,12084,24519
MURANG'A,ALL,14,12144,11249,23393
MURANG'A,ALL,Oct-14,59951,57807,117758
MURANG'A,ALL,15,11909,11201,23110
MURANG'A,ALL,16,11612,11057,22669
MURANG'A,ALL,17,12101,10760,22861
MURANG'A,ALL,18,9979,8672,18651
MURANG'A,ALL,19,9706,8470,18176
MURANG'A,ALL,15-19,55307,50160,105467
MURANG'A,ALL,20,8514,8011,16525
MURANG'A,ALL,21,7773,7400,15173
MURANG'A,ALL,22,7564,7321,14885
MURANG'A,ALL,23,7549,7624,15173
MURANG'A,ALL,24,6814,6856,13670
MURANG'A,ALL,20-24,38214,37212,75426
MURANG'A,ALL,25,6880,6930,13810
MURANG'A,ALL,26,6024,6334,12358
MURANG'A,ALL,27,6503,6532,13035
MURANG'A,ALL,28,5907,6280,12187
MURANG'A,ALL,29,6509,6899,13408
MURANG'A,ALL,25-29,31823,32975,64798
MURANG'A,ALL,30,8096,8278,16374
MURANG'A,ALL,31,6215,6210,12425
MURANG'A,ALL,32,7692,8002,15694
MURANG'A,ALL,33,6805,7153,13958
MURANG'A,ALL,34,6572,6711,13283
MURANG'A,ALL,30-34,35380,36354,71734
MURANG'A,ALL,35,8501,8567,17068
MURANG'A,ALL,36,6500,6685,13185
MURANG'A,ALL,37,6781,6459,13240
MURANG'A,ALL,38,5947,6265,12212
MURANG'A,ALL,39,6645,6547,13192
MURANG'A,ALL,35-39,34374,34523,68897
MURANG'A,ALL,40,7947,7763,15710
MURANG'A,ALL,41,6609,6271,12880
MURANG'A,ALL,42,6516,6274,12790
MURANG'A,ALL,43,5633,5588,11221
MURANG'A,ALL,44,5246,5125,10371
MURANG'A,ALL,40-44,31951,31021,62972
MURANG'A,ALL,45,7259,7082,14341
MURANG'A,ALL,46,5737,5607,11344
MURANG'A,ALL,47,6006,5913,11919
MURANG'A,ALL,48,4742,4697,9439
MURANG'A,ALL,49,4804,4956,9760
MURANG'A,ALL,45-49,28548,28255,56803
MURANG'A,ALL,50,5424,5856,11280
MURANG'A,ALL,51,4317,4339,8656
MURANG'A,ALL,52,4758,5068,9826
MURANG'A,ALL,53,3572,3900,7472
MURANG'A,ALL,54,4117,4365,8482
MURANG'A,ALL,50-54,22188,23528,45716
MURANG'A,ALL,55,4556,4602,9158
MURANG'A,ALL,56,4852,4989,9841
MURANG'A,ALL,57,3877,4650,8527
MURANG'A,ALL,58,3174,3709,6883
MURANG'A,ALL,59,3728,4085,7813
MURANG'A,ALL,55-59,20187,22035,42222
MURANG'A,ALL,60,4116,4566,8682
MURANG'A,ALL,61,3231,3640,6871
MURANG'A,ALL,62,2903,2945,5848
MURANG'A,ALL,63,2423,2625,5048
MURANG'A,ALL,64,1951,2047,3998
MURANG'A,ALL,60-64,14624,15823,30447
MURANG'A,ALL,65,2954,3358,6312
MURANG'A,ALL,66,2150,2461,4611
MURANG'A,ALL,67,3838,4197,8035
MURANG'A,ALL,68,1786,1917,3703
MURANG'A,ALL,69,2628,2923,5551
MURANG'A,ALL,65-69,13356,14856,28212
MURANG'A,ALL,70,3293,4417,7710
MURANG'A,ALL,71,2335,2677,5012
MURANG'A,ALL,72,2322,2161,4483
MURANG'A,ALL,73,1926,1879,3805
MURANG'A,ALL,74,1658,1989,3647
MURANG'A,ALL,70-74,11534,13123,24657
MURANG'A,ALL,75,1388,1977,3365
MURANG'A,ALL,76,1527,2968,4495
MURANG'A,ALL,77,1109,1577,2686
MURANG'A,ALL,78,787,961,1748
MURANG'A,ALL,79,982,1677,2659
MURANG'A,ALL,75-79,5793,9160,14953
MURANG'A,ALL,80,1172,2177,3349
MURANG'A,ALL,81,617,1128,1745
MURANG'A,ALL,82,633,810,1443
MURANG'A,ALL,83,752,1010,1762
MURANG'A,ALL,84,637,1187,1824
MURANG'A,ALL,80-84,3811,6312,10123
MURANG'A,ALL,85,587,1010,1597
MURANG'A,ALL,86,437,726,1163
MURANG'A,ALL,87,487,754,1241
MURANG'A,ALL,88,242,378,620
MURANG'A,ALL,89,410,1133,1543
MURANG'A,ALL,85-89,2163,4001,6164
MURANG'A,ALL,90,254,696,950
MURANG'A,ALL,91,254,498,752
MURANG'A,ALL,92,147,300,447
MURANG'A,ALL,93,121,287,408
MURANG'A,ALL,94,90,331,421
MURANG'A,ALL,90-94,866,2112,2978
MURANG'A,ALL,95,139,346,485
MURANG'A,ALL,96,81,192,273
MURANG'A,ALL,97,93,215,308
MURANG'A,ALL,98,64,142,206
MURANG'A,ALL,99,74,310,384
MURANG'A,ALL,95-99,451,1205,1656
MURANG'A,ALL,100+,152,695,847
MURANG'A,ALL,Not Stated,8,6,14
MURANG'A,MURANG'A EAST,Total,54665,55645,110310
MURANG'A,MURANG'A EAST,0,1276,1184,2460
MURANG'A,MURANG'A EAST,1,1201,1130,2331
MURANG'A,MURANG'A EAST,2,1187,1162,2349
MURANG'A,MURANG'A EAST,3,1145,1153,2298
MURANG'A,MURANG'A EAST,4,1224,1180,2404
MURANG'A,MURANG'A EAST,0 - 4,6033,5809,11842
MURANG'A,MURANG'A EAST,5,1110,1053,2163
MURANG'A,MURANG'A EAST,6,1048,1099,2147
MURANG'A,MURANG'A EAST,7,1163,1102,2265
MURANG'A,MURANG'A EAST,8,1043,1129,2172
MURANG'A,MURANG'A EAST,9,1149,1257,2406
MURANG'A,MURANG'A EAST,05-Sep,5513,5640,11153
MURANG'A,MURANG'A EAST,10,1164,1110,2274
MURANG'A,MURANG'A EAST,11,1097,1040,2137
MURANG'A,MURANG'A EAST,12,1153,1140,2293
MURANG'A,MURANG'A EAST,13,1193,1135,2328
MURANG'A,MURANG'A EAST,14,1113,1027,2140
MURANG'A,MURANG'A EAST,Oct-14,5720,5452,11172
MURANG'A,MURANG'A EAST,15,1137,1083,2220
MURANG'A,MURANG'A EAST,16,1111,1134,2245
MURANG'A,MURANG'A EAST,17,1182,1108,2290
MURANG'A,MURANG'A EAST,18,941,902,1843
MURANG'A,MURANG'A EAST,19,985,965,1950
MURANG'A,MURANG'A EAST,15-19,5356,5192,10548
MURANG'A,MURANG'A EAST,20,897,922,1819
MURANG'A,MURANG'A EAST,21,883,967,1850
MURANG'A,MURANG'A EAST,22,884,985,1869
MURANG'A,MURANG'A EAST,23,922,994,1916
MURANG'A,MURANG'A EAST,24,899,887,1786
MURANG'A,MURANG'A EAST,20-24,4485,4755,9240
MURANG'A,MURANG'A EAST,25,814,862,1676
MURANG'A,MURANG'A EAST,26,787,808,1595
MURANG'A,MURANG'A EAST,27,804,784,1588
MURANG'A,MURANG'A EAST,28,716,773,1489
MURANG'A,MURANG'A EAST,29,786,923,1709
MURANG'A,MURANG'A EAST,25-29,3907,4150,8057
MURANG'A,MURANG'A EAST,30,1021,984,2005
MURANG'A,MURANG'A EAST,31,733,732,1465
MURANG'A,MURANG'A EAST,32,940,887,1827
MURANG'A,MURANG'A EAST,33,762,779,1541
MURANG'A,MURANG'A EAST,34,756,706,1462
MURANG'A,MURANG'A EAST,30-34,4212,4088,8300
MURANG'A,MURANG'A EAST,35,983,941,1924
MURANG'A,MURANG'A EAST,36,741,734,1475
MURANG'A,MURANG'A EAST,37,752,701,1453
MURANG'A,MURANG'A EAST,38,685,677,1362
MURANG'A,MURANG'A EAST,39,720,773,1493
MURANG'A,MURANG'A EAST,35-39,3881,3826,7707
MURANG'A,MURANG'A EAST,40,890,821,1711
MURANG'A,MURANG'A EAST,41,701,638,1339
MURANG'A,MURANG'A EAST,42,729,658,1387
MURANG'A,MURANG'A EAST,43,542,533,1075
MURANG'A,MURANG'A EAST,44,566,512,1078
MURANG'A,MURANG'A EAST,40-44,3428,3162,6590
MURANG'A,MURANG'A EAST,45,756,674,1430
MURANG'A,MURANG'A EAST,46,568,560,1128
MURANG'A,MURANG'A EAST,47,623,537,1160
MURANG'A,MURANG'A EAST,48,462,483,945
MURANG'A,MURANG'A EAST,49,556,490,1046
MURANG'A,MURANG'A EAST,45-49,2965,2744,5709
MURANG'A,MURANG'A EAST,50,569,613,1182
MURANG'A,MURANG'A EAST,51,458,430,888
MURANG'A,MURANG'A EAST,52,479,491,970
MURANG'A,MURANG'A EAST,53,356,380,736
MURANG'A,MURANG'A EAST,54,445,416,861
MURANG'A,MURANG'A EAST,50-54,2307,2330,4637
MURANG'A,MURANG'A EAST,55,475,457,932
MURANG'A,MURANG'A EAST,56,498,481,979
MURANG'A,MURANG'A EAST,57,373,470,843
MURANG'A,MURANG'A EAST,58,311,357,668
MURANG'A,MURANG'A EAST,59,369,400,769
MURANG'A,MURANG'A EAST,55-59,2026,2165,4191
MURANG'A,MURANG'A EAST,60,430,446,876
MURANG'A,MURANG'A EAST,61,340,358,698
MURANG'A,MURANG'A EAST,62,261,313,574
MURANG'A,MURANG'A EAST,63,218,253,471
MURANG'A,MURANG'A EAST,64,183,201,384
MURANG'A,MURANG'A EAST,60-64,1432,1571,3003
MURANG'A,MURANG'A EAST,65,258,275,533
MURANG'A,MURANG'A EAST,66,213,249,462
MURANG'A,MURANG'A EAST,67,345,402,747
MURANG'A,MURANG'A EAST,68,175,182,357
MURANG'A,MURANG'A EAST,69,262,274,536
MURANG'A,MURANG'A EAST,65-69,1253,1382,2635
MURANG'A,MURANG'A EAST,70,303,389,692
MURANG'A,MURANG'A EAST,71,181,288,469
MURANG'A,MURANG'A EAST,72,209,202,411
MURANG'A,MURANG'A EAST,73,171,184,355
MURANG'A,MURANG'A EAST,74,157,168,325
MURANG'A,MURANG'A EAST,70-74,1021,1231,2252
MURANG'A,MURANG'A EAST,75,138,174,312
MURANG'A,MURANG'A EAST,76,99,194,293
MURANG'A,MURANG'A EAST,77,106,146,252
MURANG'A,MURANG'A EAST,78,68,91,159
MURANG'A,MURANG'A EAST,79,66,168,234
MURANG'A,MURANG'A EAST,75-79,477,773,1250
MURANG'A,MURANG'A EAST,80,82,216,298
MURANG'A,MURANG'A EAST,81,49,149,198
MURANG'A,MURANG'A EAST,82,59,82,141
MURANG'A,MURANG'A EAST,83,85,94,179
MURANG'A,MURANG'A EAST,84,49,106,155
MURANG'A,MURANG'A EAST,80-84,324,647,971
MURANG'A,MURANG'A EAST,85,41,96,137
MURANG'A,MURANG'A EAST,86,43,56,99
MURANG'A,MURANG'A EAST,87,46,58,104
MURANG'A,MURANG'A EAST,88,25,21,46
MURANG'A,MURANG'A EAST,89,25,100,125
MURANG'A,MURANG'A EAST,85-89,180,331,511
MURANG'A,MURANG'A EAST,90,27,67,94
MURANG'A,MURANG'A EAST,91,16,68,84
MURANG'A,MURANG'A EAST,92,17,22,39
MURANG'A,MURANG'A EAST,93,10,30,40
MURANG'A,MURANG'A EAST,94,5,28,33
MURANG'A,MURANG'A EAST,90-94,75,215,290
MURANG'A,MURANG'A EAST,95,22,38,60
MURANG'A,MURANG'A EAST,96,11,19,30
MURANG'A,MURANG'A EAST,97,11,22,33
MURANG'A,MURANG'A EAST,98,3,9,12
MURANG'A,MURANG'A EAST,99,5,23,28
MURANG'A,MURANG'A EAST,95-99,52,111,163
MURANG'A,MURANG'A EAST,100+,18,69,87
MURANG'A,MURANG'A EAST,Not Stated,-,2,2
MURANG'A,KANGEMA,Total,39582,40862,80444
MURANG'A,KANGEMA,0,736,759,1495
MURANG'A,KANGEMA,1,725,750,1475
MURANG'A,KANGEMA,2,800,759,1559
MURANG'A,KANGEMA,3,776,770,1546
MURANG'A,KANGEMA,4,863,802,1665
MURANG'A,KANGEMA,0 - 4,3900,3840,7740
MURANG'A,KANGEMA,5,788,770,1558
MURANG'A,KANGEMA,6,780,841,1621
MURANG'A,KANGEMA,7,849,836,1685
MURANG'A,KANGEMA,8,747,766,1513
MURANG'A,KANGEMA,9,950,832,1782
MURANG'A,KANGEMA,05-Sep,4114,4045,8159
MURANG'A,KANGEMA,10,860,831,1691
MURANG'A,KANGEMA,11,807,789,1596
MURANG'A,KANGEMA,12,882,815,1697
MURANG'A,KANGEMA,13,908,859,1767
MURANG'A,KANGEMA,14,855,802,1657
MURANG'A,KANGEMA,Oct-14,4312,4096,8408
MURANG'A,KANGEMA,15,940,802,1742
MURANG'A,KANGEMA,16,838,837,1675
MURANG'A,KANGEMA,17,966,814,1780
MURANG'A,KANGEMA,18,725,626,1351
MURANG'A,KANGEMA,19,693,593,1286
MURANG'A,KANGEMA,15-19,4162,3672,7834
MURANG'A,KANGEMA,20,588,539,1127
MURANG'A,KANGEMA,21,542,515,1057
MURANG'A,KANGEMA,22,524,488,1012
MURANG'A,KANGEMA,23,559,511,1070
MURANG'A,KANGEMA,24,439,460,899
MURANG'A,KANGEMA,20-24,2652,2513,5165
MURANG'A,KANGEMA,25,408,432,840
MURANG'A,KANGEMA,26,397,402,799
MURANG'A,KANGEMA,27,449,433,882
MURANG'A,KANGEMA,28,381,416,797
MURANG'A,KANGEMA,29,437,480,917
MURANG'A,KANGEMA,25-29,2072,2163,4235
MURANG'A,KANGEMA,30,527,560,1087
MURANG'A,KANGEMA,31,455,422,877
MURANG'A,KANGEMA,32,558,593,1151
MURANG'A,KANGEMA,33,525,516,1041
MURANG'A,KANGEMA,34,495,551,1046
MURANG'A,KANGEMA,30-34,2560,2642,5202
MURANG'A,KANGEMA,35,584,658,1242
MURANG'A,KANGEMA,36,501,562,1063
MURANG'A,KANGEMA,37,506,500,1006
MURANG'A,KANGEMA,38,442,513,955
MURANG'A,KANGEMA,39,495,546,1041
MURANG'A,KANGEMA,35-39,2528,2779,5307
MURANG'A,KANGEMA,40,664,595,1259
MURANG'A,KANGEMA,41,528,533,1061
MURANG'A,KANGEMA,42,498,488,986
MURANG'A,KANGEMA,43,487,424,911
MURANG'A,KANGEMA,44,386,442,828
MURANG'A,KANGEMA,40-44,2563,2482,5045
MURANG'A,KANGEMA,45,598,589,1187
MURANG'A,KANGEMA,46,443,492,935
MURANG'A,KANGEMA,47,468,517,985
MURANG'A,KANGEMA,48,383,439,822
MURANG'A,KANGEMA,49,418,443,861
MURANG'A,KANGEMA,45-49,2310,2480,4790
MURANG'A,KANGEMA,50,433,517,950
MURANG'A,KANGEMA,51,377,377,754
MURANG'A,KANGEMA,52,379,425,804
MURANG'A,KANGEMA,53,294,354,648
MURANG'A,KANGEMA,54,367,378,745
MURANG'A,KANGEMA,50-54,1850,2051,3901
MURANG'A,KANGEMA,55,437,404,841
MURANG'A,KANGEMA,56,378,440,818
MURANG'A,KANGEMA,57,310,427,737
MURANG'A,KANGEMA,58,268,278,546
MURANG'A,KANGEMA,59,355,391,746
MURANG'A,KANGEMA,55-59,1748,1940,3688
MURANG'A,KANGEMA,60,353,421,774
MURANG'A,KANGEMA,61,277,334,611
MURANG'A,KANGEMA,62,276,289,565
MURANG'A,KANGEMA,63,213,228,441
MURANG'A,KANGEMA,64,132,147,279
MURANG'A,KANGEMA,60-64,1251,1419,2670
MURANG'A,KANGEMA,65,269,319,588
MURANG'A,KANGEMA,66,209,236,445
MURANG'A,KANGEMA,67,344,354,698
MURANG'A,KANGEMA,68,160,182,342
MURANG'A,KANGEMA,69,224,274,498
MURANG'A,KANGEMA,65-69,1206,1365,2571
MURANG'A,KANGEMA,70,288,394,682
MURANG'A,KANGEMA,71,217,276,493
MURANG'A,KANGEMA,72,207,196,403
MURANG'A,KANGEMA,73,218,186,404
MURANG'A,KANGEMA,74,171,197,368
MURANG'A,KANGEMA,70-74,1101,1249,2350
MURANG'A,KANGEMA,75,142,177,319
MURANG'A,KANGEMA,76,156,230,386
MURANG'A,KANGEMA,77,114,160,274
MURANG'A,KANGEMA,78,69,92,161
MURANG'A,KANGEMA,79,87,164,251
MURANG'A,KANGEMA,75-79,568,823,1391
MURANG'A,KANGEMA,80,106,186,292
MURANG'A,KANGEMA,81,70,113,183
MURANG'A,KANGEMA,82,58,89,147
MURANG'A,KANGEMA,83,77,89,166
MURANG'A,KANGEMA,84,58,134,192
MURANG'A,KANGEMA,80-84,369,611,980
MURANG'A,KANGEMA,85,48,87,135
MURANG'A,KANGEMA,86,39,68,107
MURANG'A,KANGEMA,87,28,83,111
MURANG'A,KANGEMA,88,23,36,59
MURANG'A,KANGEMA,89,39,104,143
MURANG'A,KANGEMA,85-89,177,378,555
MURANG'A,KANGEMA,90,18,41,59
MURANG'A,KANGEMA,91,28,59,87
MURANG'A,KANGEMA,92,15,31,46
MURANG'A,KANGEMA,93,14,15,29
MURANG'A,KANGEMA,94,7,36,43
MURANG'A,KANGEMA,90-94,82,182,264
MURANG'A,KANGEMA,95,10,22,32
MURANG'A,KANGEMA,96,3,18,21
MURANG'A,KANGEMA,97,8,11,19
MURANG'A,KANGEMA,98,5,9,14
MURANG'A,KANGEMA,99,9,28,37
MURANG'A,KANGEMA,95-99,35,88,123
MURANG'A,KANGEMA,100+,22,44,66
MURANG'A,KANGEMA,Not Stated,-,-,-
MURANG'A,MATHIOYA,Total,45454,47359,92813
MURANG'A,MATHIOYA,0,871,818,1689
MURANG'A,MATHIOYA,1,845,857,1702
MURANG'A,MATHIOYA,2,918,915,1833
MURANG'A,MATHIOYA,3,977,990,1967
MURANG'A,MATHIOYA,4,1029,1008,2037
MURANG'A,MATHIOYA,0 - 4,4640,4588,9228
MURANG'A,MATHIOYA,5,991,948,1939
MURANG'A,MATHIOYA,6,914,974,1888
MURANG'A,MATHIOYA,7,1005,1005,2010
MURANG'A,MATHIOYA,8,962,944,1906
MURANG'A,MATHIOYA,9,1045,1081,2126
MURANG'A,MATHIOYA,05-Sep,4917,4952,9869
MURANG'A,MATHIOYA,10,1008,1019,2027
MURANG'A,MATHIOYA,11,1023,974,1997
MURANG'A,MATHIOYA,12,1091,1016,2107
MURANG'A,MATHIOYA,13,1041,1016,2057
MURANG'A,MATHIOYA,14,1043,992,2035
MURANG'A,MATHIOYA,Oct-14,5206,5017,10223
MURANG'A,MATHIOYA,15,997,970,1967
MURANG'A,MATHIOYA,16,1007,907,1914
MURANG'A,MATHIOYA,17,1056,948,2004
MURANG'A,MATHIOYA,18,886,766,1652
MURANG'A,MATHIOYA,19,809,650,1459
MURANG'A,MATHIOYA,15-19,4755,4241,8996
MURANG'A,MATHIOYA,20,725,636,1361
MURANG'A,MATHIOYA,21,583,563,1146
MURANG'A,MATHIOYA,22,578,511,1089
MURANG'A,MATHIOYA,23,544,564,1108
MURANG'A,MATHIOYA,24,480,525,1005
MURANG'A,MATHIOYA,20-24,2910,2799,5709
MURANG'A,MATHIOYA,25,497,540,1037
MURANG'A,MATHIOYA,26,410,504,914
MURANG'A,MATHIOYA,27,464,548,1012
MURANG'A,MATHIOYA,28,461,496,957
MURANG'A,MATHIOYA,29,473,559,1032
MURANG'A,MATHIOYA,25-29,2305,2647,4952
MURANG'A,MATHIOYA,30,673,692,1365
MURANG'A,MATHIOYA,31,494,527,1021
MURANG'A,MATHIOYA,32,635,653,1288
MURANG'A,MATHIOYA,33,573,660,1233
MURANG'A,MATHIOYA,34,574,569,1143
MURANG'A,MATHIOYA,30-34,2949,3101,6050
MURANG'A,MATHIOYA,35,756,760,1516
MURANG'A,MATHIOYA,36,584,563,1147
MURANG'A,MATHIOYA,37,604,531,1135
MURANG'A,MATHIOYA,38,503,520,1023
MURANG'A,MATHIOYA,39,579,572,1151
MURANG'A,MATHIOYA,35-39,3026,2946,5972
MURANG'A,MATHIOYA,40,678,666,1344
MURANG'A,MATHIOYA,41,554,570,1124
MURANG'A,MATHIOYA,42,545,587,1132
MURANG'A,MATHIOYA,43,466,522,988
MURANG'A,MATHIOYA,44,494,466,960
MURANG'A,MATHIOYA,40-44,2737,2811,5548
MURANG'A,MATHIOYA,45,688,636,1324
MURANG'A,MATHIOYA,46,515,503,1018
MURANG'A,MATHIOYA,47,565,493,1058
MURANG'A,MATHIOYA,48,408,448,856
MURANG'A,MATHIOYA,49,384,482,866
MURANG'A,MATHIOYA,45-49,2560,2562,5122
MURANG'A,MATHIOYA,50,519,570,1089
MURANG'A,MATHIOYA,51,412,417,829
MURANG'A,MATHIOYA,52,440,553,993
MURANG'A,MATHIOYA,53,351,407,758
MURANG'A,MATHIOYA,54,395,430,825
MURANG'A,MATHIOYA,50-54,2117,2377,4494
MURANG'A,MATHIOYA,55,482,448,930
MURANG'A,MATHIOYA,56,483,545,1028
MURANG'A,MATHIOYA,57,360,421,781
MURANG'A,MATHIOYA,58,305,408,713
MURANG'A,MATHIOYA,59,344,402,746
MURANG'A,MATHIOYA,55-59,1974,2224,4198
MURANG'A,MATHIOYA,60,359,484,843
MURANG'A,MATHIOYA,61,320,360,680
MURANG'A,MATHIOYA,62,292,294,586
MURANG'A,MATHIOYA,63,218,223,441
MURANG'A,MATHIOYA,64,172,173,345
MURANG'A,MATHIOYA,60-64,1361,1534,2895
MURANG'A,MATHIOYA,65,307,379,686
MURANG'A,MATHIOYA,66,238,253,491
MURANG'A,MATHIOYA,67,377,464,841
MURANG'A,MATHIOYA,68,169,197,366
MURANG'A,MATHIOYA,69,285,322,607
MURANG'A,MATHIOYA,65-69,1376,1615,2991
MURANG'A,MATHIOYA,70,353,535,888
MURANG'A,MATHIOYA,71,231,293,524
MURANG'A,MATHIOYA,72,232,223,455
MURANG'A,MATHIOYA,73,217,201,418
MURANG'A,MATHIOYA,74,180,219,399
MURANG'A,MATHIOYA,70-74,1213,1471,2684
MURANG'A,MATHIOYA,75,159,199,358
MURANG'A,MATHIOYA,76,150,283,433
MURANG'A,MATHIOYA,77,117,174,291
MURANG'A,MATHIOYA,78,84,111,195
MURANG'A,MATHIOYA,79,114,203,317
MURANG'A,MATHIOYA,75-79,624,970,1594
MURANG'A,MATHIOYA,80,128,259,387
MURANG'A,MATHIOYA,81,64,115,179
MURANG'A,MATHIOYA,82,68,73,141
MURANG'A,MATHIOYA,83,74,89,163
MURANG'A,MATHIOYA,84,67,114,181
MURANG'A,MATHIOYA,80-84,401,650,1051
MURANG'A,MATHIOYA,85,60,128,188
MURANG'A,MATHIOYA,86,44,61,105
MURANG'A,MATHIOYA,87,67,80,147
MURANG'A,MATHIOYA,88,21,41,62
MURANG'A,MATHIOYA,89,47,140,187
MURANG'A,MATHIOYA,85-89,239,450,689
MURANG'A,MATHIOYA,90,21,100,121
MURANG'A,MATHIOYA,91,28,51,79
MURANG'A,MATHIOYA,92,12,30,42
MURANG'A,MATHIOYA,93,11,21,32
MURANG'A,MATHIOYA,94,5,33,38
MURANG'A,MATHIOYA,90-94,77,235,312
MURANG'A,MATHIOYA,95,14,37,51
MURANG'A,MATHIOYA,96,14,15,29
MURANG'A,MATHIOYA,97,9,18,27
MURANG'A,MATHIOYA,98,9,14,23
MURANG'A,MATHIOYA,99,8,33,41
MURANG'A,MATHIOYA,95-99,54,117,171
MURANG'A,MATHIOYA,100+,12,52,64
MURANG'A,MATHIOYA,Not Stated,1,-,1
MURANG'A,KAHURO,Total,43352,44834,88186
MURANG'A,KAHURO,0,793,740,1533
MURANG'A,KAHURO,1,794,772,1566
MURANG'A,KAHURO,2,822,807,1629
MURANG'A,KAHURO,3,874,808,1682
MURANG'A,KAHURO,4,864,874,1738
MURANG'A,KAHURO,0 - 4,4147,4001,8148
MURANG'A,KAHURO,5,871,835,1706
MURANG'A,KAHURO,6,882,875,1757
MURANG'A,KAHURO,7,890,895,1785
MURANG'A,KAHURO,8,925,916,1841
MURANG'A,KAHURO,9,988,996,1984
MURANG'A,KAHURO,05-Sep,4556,4517,9073
MURANG'A,KAHURO,10,996,924,1920
MURANG'A,KAHURO,11,922,968,1890
MURANG'A,KAHURO,12,1016,903,1919
MURANG'A,KAHURO,13,1052,962,2014
MURANG'A,KAHURO,14,1021,888,1909
MURANG'A,KAHURO,Oct-14,5007,4645,9652
MURANG'A,KAHURO,15,1015,944,1959
MURANG'A,KAHURO,16,996,897,1893
MURANG'A,KAHURO,17,1001,875,1876
MURANG'A,KAHURO,18,914,732,1646
MURANG'A,KAHURO,19,805,635,1440
MURANG'A,KAHURO,15-19,4731,4083,8814
MURANG'A,KAHURO,20,644,626,1270
MURANG'A,KAHURO,21,571,530,1101
MURANG'A,KAHURO,22,550,492,1042
MURANG'A,KAHURO,23,490,499,989
MURANG'A,KAHURO,24,424,433,857
MURANG'A,KAHURO,20-24,2679,2580,5259
MURANG'A,KAHURO,25,425,426,851
MURANG'A,KAHURO,26,354,399,753
MURANG'A,KAHURO,27,385,392,777
MURANG'A,KAHURO,28,388,385,773
MURANG'A,KAHURO,29,423,452,875
MURANG'A,KAHURO,25-29,1975,2054,4029
MURANG'A,KAHURO,30,516,564,1080
MURANG'A,KAHURO,31,432,478,910
MURANG'A,KAHURO,32,575,625,1200
MURANG'A,KAHURO,33,476,538,1014
MURANG'A,KAHURO,34,512,510,1022
MURANG'A,KAHURO,30-34,2511,2715,5226
MURANG'A,KAHURO,35,641,667,1308
MURANG'A,KAHURO,36,513,536,1049
MURANG'A,KAHURO,37,584,555,1139
MURANG'A,KAHURO,38,505,527,1032
MURANG'A,KAHURO,39,498,534,1032
MURANG'A,KAHURO,35-39,2741,2819,5560
MURANG'A,KAHURO,40,683,692,1375
MURANG'A,KAHURO,41,549,541,1090
MURANG'A,KAHURO,42,534,557,1091
MURANG'A,KAHURO,43,437,499,936
MURANG'A,KAHURO,44,431,411,842
MURANG'A,KAHURO,40-44,2634,2700,5334
MURANG'A,KAHURO,45,607,653,1260
MURANG'A,KAHURO,46,486,464,950
MURANG'A,KAHURO,47,515,570,1085
MURANG'A,KAHURO,48,415,406,821
MURANG'A,KAHURO,49,456,462,918
MURANG'A,KAHURO,45-49,2479,2555,5034
MURANG'A,KAHURO,50,494,568,1062
MURANG'A,KAHURO,51,366,402,768
MURANG'A,KAHURO,52,440,444,884
MURANG'A,KAHURO,53,364,392,756
MURANG'A,KAHURO,54,383,412,795
MURANG'A,KAHURO,50-54,2047,2218,4265
MURANG'A,KAHURO,55,420,481,901
MURANG'A,KAHURO,56,475,519,994
MURANG'A,KAHURO,57,384,468,852
MURANG'A,KAHURO,58,308,446,754
MURANG'A,KAHURO,59,337,448,785
MURANG'A,KAHURO,55-59,1924,2362,4286
MURANG'A,KAHURO,60,409,471,880
MURANG'A,KAHURO,61,319,397,716
MURANG'A,KAHURO,62,335,335,670
MURANG'A,KAHURO,63,278,269,547
MURANG'A,KAHURO,64,215,233,448
MURANG'A,KAHURO,60-64,1556,1705,3261
MURANG'A,KAHURO,65,324,366,690
MURANG'A,KAHURO,66,250,284,534
MURANG'A,KAHURO,67,449,471,920
MURANG'A,KAHURO,68,210,217,427
MURANG'A,KAHURO,69,297,311,608
MURANG'A,KAHURO,65-69,1530,1649,3179
MURANG'A,KAHURO,70,388,544,932
MURANG'A,KAHURO,71,258,289,547
MURANG'A,KAHURO,72,236,268,504
MURANG'A,KAHURO,73,213,191,404
MURANG'A,KAHURO,74,202,261,463
MURANG'A,KAHURO,70-74,1297,1553,2850
MURANG'A,KAHURO,75,191,224,415
MURANG'A,KAHURO,76,163,305,468
MURANG'A,KAHURO,77,125,200,325
MURANG'A,KAHURO,78,99,106,205
MURANG'A,KAHURO,79,95,200,295
MURANG'A,KAHURO,75-79,673,1035,1708
MURANG'A,KAHURO,80,145,268,413
MURANG'A,KAHURO,81,75,122,197
MURANG'A,KAHURO,82,56,103,159
MURANG'A,KAHURO,83,69,124,193
MURANG'A,KAHURO,84,70,112,182
MURANG'A,KAHURO,80-84,415,729,1144
MURANG'A,KAHURO,85,75,135,210
MURANG'A,KAHURO,86,55,91,146
MURANG'A,KAHURO,87,62,93,155
MURANG'A,KAHURO,88,25,40,65
MURANG'A,KAHURO,89,50,123,173
MURANG'A,KAHURO,85-89,267,482,749
MURANG'A,KAHURO,90,31,84,115
MURANG'A,KAHURO,91,35,58,93
MURANG'A,KAHURO,92,17,36,53
MURANG'A,KAHURO,93,17,32,49
MURANG'A,KAHURO,94,12,38,50
MURANG'A,KAHURO,90-94,112,248,360
MURANG'A,KAHURO,95,16,33,49
MURANG'A,KAHURO,96,10,20,30
MURANG'A,KAHURO,97,9,18,27
MURANG'A,KAHURO,98,7,13,20
MURANG'A,KAHURO,99,9,28,37
MURANG'A,KAHURO,95-99,51,112,163
MURANG'A,KAHURO,100+,20,72,92
MURANG'A,KAHURO,Not Stated,-,-,-
MURANG'A,MURANG'A SOUTH,Total,91732,93087,184819
MURANG'A,MURANG'A SOUTH,0,2059,2033,4092
MURANG'A,MURANG'A SOUTH,1,1972,2023,3995
MURANG'A,MURANG'A SOUTH,2,2022,1964,3986
MURANG'A,MURANG'A SOUTH,3,1987,2119,4106
MURANG'A,MURANG'A SOUTH,4,2063,2071,4134
MURANG'A,MURANG'A SOUTH,0 - 4,10103,10210,20313
MURANG'A,MURANG'A SOUTH,5,2022,1911,3933
MURANG'A,MURANG'A SOUTH,6,2065,1991,4056
MURANG'A,MURANG'A SOUTH,7,2058,2068,4126
MURANG'A,MURANG'A SOUTH,8,2053,1926,3979
MURANG'A,MURANG'A SOUTH,9,2326,2216,4542
MURANG'A,MURANG'A SOUTH,05-Sep,10524,10112,20636
MURANG'A,MURANG'A SOUTH,10,2196,2119,4315
MURANG'A,MURANG'A SOUTH,11,1943,2072,4015
MURANG'A,MURANG'A SOUTH,12,2185,2132,4317
MURANG'A,MURANG'A SOUTH,13,2260,2279,4539
MURANG'A,MURANG'A SOUTH,14,2188,2110,4298
MURANG'A,MURANG'A SOUTH,Oct-14,10772,10712,21484
MURANG'A,MURANG'A SOUTH,15,2201,2054,4255
MURANG'A,MURANG'A SOUTH,16,2090,1960,4050
MURANG'A,MURANG'A SOUTH,17,2125,1855,3980
MURANG'A,MURANG'A SOUTH,18,1770,1560,3330
MURANG'A,MURANG'A SOUTH,19,1720,1603,3323
MURANG'A,MURANG'A SOUTH,15-19,9906,9032,18938
MURANG'A,MURANG'A SOUTH,20,1571,1531,3102
MURANG'A,MURANG'A SOUTH,21,1401,1407,2808
MURANG'A,MURANG'A SOUTH,22,1384,1392,2776
MURANG'A,MURANG'A SOUTH,23,1395,1475,2870
MURANG'A,MURANG'A SOUTH,24,1280,1363,2643
MURANG'A,MURANG'A SOUTH,20-24,7031,7168,14199
MURANG'A,MURANG'A SOUTH,25,1359,1356,2715
MURANG'A,MURANG'A SOUTH,26,1195,1267,2462
MURANG'A,MURANG'A SOUTH,27,1281,1241,2522
MURANG'A,MURANG'A SOUTH,28,1179,1197,2376
MURANG'A,MURANG'A SOUTH,29,1223,1296,2519
MURANG'A,MURANG'A SOUTH,25-29,6237,6357,12594
MURANG'A,MURANG'A SOUTH,30,1510,1533,3043
MURANG'A,MURANG'A SOUTH,31,1117,1112,2229
MURANG'A,MURANG'A SOUTH,32,1386,1423,2809
MURANG'A,MURANG'A SOUTH,33,1230,1296,2526
MURANG'A,MURANG'A SOUTH,34,1153,1165,2318
MURANG'A,MURANG'A SOUTH,30-34,6396,6529,12925
MURANG'A,MURANG'A SOUTH,35,1498,1516,3014
MURANG'A,MURANG'A SOUTH,36,1083,1174,2257
MURANG'A,MURANG'A SOUTH,37,1150,1122,2272
MURANG'A,MURANG'A SOUTH,38,1013,1057,2070
MURANG'A,MURANG'A SOUTH,39,1136,1061,2197
MURANG'A,MURANG'A SOUTH,35-39,5880,5930,11810
MURANG'A,MURANG'A SOUTH,40,1277,1383,2660
MURANG'A,MURANG'A SOUTH,41,1082,1093,2175
MURANG'A,MURANG'A SOUTH,42,1128,1076,2204
MURANG'A,MURANG'A SOUTH,43,948,917,1865
MURANG'A,MURANG'A SOUTH,44,849,862,1711
MURANG'A,MURANG'A SOUTH,40-44,5284,5331,10615
MURANG'A,MURANG'A SOUTH,45,1268,1223,2491
MURANG'A,MURANG'A SOUTH,46,967,932,1899
MURANG'A,MURANG'A SOUTH,47,1017,1031,2048
MURANG'A,MURANG'A SOUTH,48,819,784,1603
MURANG'A,MURANG'A SOUTH,49,776,768,1544
MURANG'A,MURANG'A SOUTH,45-49,4847,4738,9585
MURANG'A,MURANG'A SOUTH,50,894,929,1823
MURANG'A,MURANG'A SOUTH,51,715,716,1431
MURANG'A,MURANG'A SOUTH,52,811,791,1602
MURANG'A,MURANG'A SOUTH,53,562,593,1155
MURANG'A,MURANG'A SOUTH,54,657,739,1396
MURANG'A,MURANG'A SOUTH,50-54,3639,3768,7407
MURANG'A,MURANG'A SOUTH,55,781,782,1563
MURANG'A,MURANG'A SOUTH,56,863,836,1699
MURANG'A,MURANG'A SOUTH,57,602,711,1313
MURANG'A,MURANG'A SOUTH,58,489,560,1049
MURANG'A,MURANG'A SOUTH,59,597,641,1238
MURANG'A,MURANG'A SOUTH,55-59,3332,3530,6862
MURANG'A,MURANG'A SOUTH,60,674,677,1351
MURANG'A,MURANG'A SOUTH,61,532,546,1078
MURANG'A,MURANG'A SOUTH,62,454,432,886
MURANG'A,MURANG'A SOUTH,63,387,428,815
MURANG'A,MURANG'A SOUTH,64,333,347,680
MURANG'A,MURANG'A SOUTH,60-64,2380,2430,4810
MURANG'A,MURANG'A SOUTH,65,472,533,1005
MURANG'A,MURANG'A SOUTH,66,307,385,692
MURANG'A,MURANG'A SOUTH,67,598,617,1215
MURANG'A,MURANG'A SOUTH,68,279,269,548
MURANG'A,MURANG'A SOUTH,69,373,432,805
MURANG'A,MURANG'A SOUTH,65-69,2029,2236,4265
MURANG'A,MURANG'A SOUTH,70,482,670,1152
MURANG'A,MURANG'A SOUTH,71,306,361,667
MURANG'A,MURANG'A SOUTH,72,350,292,642
MURANG'A,MURANG'A SOUTH,73,242,232,474
MURANG'A,MURANG'A SOUTH,74,219,235,454
MURANG'A,MURANG'A SOUTH,70-74,1599,1790,3389
MURANG'A,MURANG'A SOUTH,75,175,268,443
MURANG'A,MURANG'A SOUTH,76,174,376,550
MURANG'A,MURANG'A SOUTH,77,129,215,344
MURANG'A,MURANG'A SOUTH,78,108,137,245
MURANG'A,MURANG'A SOUTH,79,129,213,342
MURANG'A,MURANG'A SOUTH,75-79,715,1209,1924
MURANG'A,MURANG'A SOUTH,80,180,324,504
MURANG'A,MURANG'A SOUTH,81,64,143,207
MURANG'A,MURANG'A SOUTH,82,100,102,202
MURANG'A,MURANG'A SOUTH,83,128,140,268
MURANG'A,MURANG'A SOUTH,84,96,160,256
MURANG'A,MURANG'A SOUTH,80-84,568,869,1437
MURANG'A,MURANG'A SOUTH,85,78,121,199
MURANG'A,MURANG'A SOUTH,86,52,97,149
MURANG'A,MURANG'A SOUTH,87,73,88,161
MURANG'A,MURANG'A SOUTH,88,40,58,98
MURANG'A,MURANG'A SOUTH,89,58,160,218
MURANG'A,MURANG'A SOUTH,85-89,301,524,825
MURANG'A,MURANG'A SOUTH,90,31,108,139
MURANG'A,MURANG'A SOUTH,91,25,52,77
MURANG'A,MURANG'A SOUTH,92,17,43,60
MURANG'A,MURANG'A SOUTH,93,22,49,71
MURANG'A,MURANG'A SOUTH,94,11,47,58
MURANG'A,MURANG'A SOUTH,90-94,106,299,405
MURANG'A,MURANG'A SOUTH,95,16,56,72
MURANG'A,MURANG'A SOUTH,96,12,30,42
MURANG'A,MURANG'A SOUTH,97,10,28,38
MURANG'A,MURANG'A SOUTH,98,10,17,27
MURANG'A,MURANG'A SOUTH,99,10,41,51
MURANG'A,MURANG'A SOUTH,95-99,58,172,230
MURANG'A,MURANG'A SOUTH,100+,21,138,159
MURANG'A,MURANG'A SOUTH,Not Stated,4,3,7
MURANG'A,GATANGA,Total,94437,93548,187985
MURANG'A,GATANGA,0,1998,1914,3912
MURANG'A,GATANGA,1,2057,1959,4016
MURANG'A,GATANGA,2,2044,1944,3988
MURANG'A,GATANGA,3,2062,2135,4197
MURANG'A,GATANGA,4,2109,2070,4179
MURANG'A,GATANGA,0 - 4,10270,10022,20292
MURANG'A,GATANGA,5,2063,2033,4096
MURANG'A,GATANGA,6,2066,2041,4107
MURANG'A,GATANGA,7,2082,2044,4126
MURANG'A,GATANGA,8,2027,2062,4089
MURANG'A,GATANGA,9,2221,2224,4445
MURANG'A,GATANGA,05-Sep,10459,10404,20863
MURANG'A,GATANGA,10,2200,2156,4356
MURANG'A,GATANGA,11,2036,2035,4071
MURANG'A,GATANGA,12,2254,2204,4458
MURANG'A,GATANGA,13,2235,2208,4443
MURANG'A,GATANGA,14,2361,2129,4490
MURANG'A,GATANGA,Oct-14,11086,10732,21818
MURANG'A,GATANGA,15,2225,1986,4211
MURANG'A,GATANGA,16,2180,2039,4219
MURANG'A,GATANGA,17,2181,2010,4191
MURANG'A,GATANGA,18,1812,1527,3339
MURANG'A,GATANGA,19,1800,1455,3255
MURANG'A,GATANGA,15-19,10198,9017,19215
MURANG'A,GATANGA,20,1634,1484,3118
MURANG'A,GATANGA,21,1511,1364,2875
MURANG'A,GATANGA,22,1394,1376,2770
MURANG'A,GATANGA,23,1497,1459,2956
MURANG'A,GATANGA,24,1361,1248,2609
MURANG'A,GATANGA,20-24,7397,6931,14328
MURANG'A,GATANGA,25,1379,1312,2691
MURANG'A,GATANGA,26,1194,1151,2345
MURANG'A,GATANGA,27,1329,1221,2550
MURANG'A,GATANGA,28,1091,1175,2266
MURANG'A,GATANGA,29,1273,1238,2511
MURANG'A,GATANGA,25-29,6266,6097,12363
MURANG'A,GATANGA,30,1515,1461,2976
MURANG'A,GATANGA,31,1186,1141,2327
MURANG'A,GATANGA,32,1362,1443,2805
MURANG'A,GATANGA,33,1252,1302,2554
MURANG'A,GATANGA,34,1177,1226,2403
MURANG'A,GATANGA,30-34,6492,6573,13065
MURANG'A,GATANGA,35,1509,1476,2985
MURANG'A,GATANGA,36,1152,1236,2388
MURANG'A,GATANGA,37,1198,1151,2349
MURANG'A,GATANGA,38,1004,1115,2119
MURANG'A,GATANGA,39,1231,1192,2423
MURANG'A,GATANGA,35-39,6094,6170,12264
MURANG'A,GATANGA,40,1416,1329,2745
MURANG'A,GATANGA,41,1249,1168,2417
MURANG'A,GATANGA,42,1185,1104,2289
MURANG'A,GATANGA,43,1100,994,2094
MURANG'A,GATANGA,44,992,954,1946
MURANG'A,GATANGA,40-44,5942,5549,11491
MURANG'A,GATANGA,45,1289,1199,2488
MURANG'A,GATANGA,46,1057,1011,2068
MURANG'A,GATANGA,47,1089,1033,2122
MURANG'A,GATANGA,48,846,778,1624
MURANG'A,GATANGA,49,820,857,1677
MURANG'A,GATANGA,45-49,5101,4878,9979
MURANG'A,GATANGA,50,907,925,1832
MURANG'A,GATANGA,51,775,756,1531
MURANG'A,GATANGA,52,845,912,1757
MURANG'A,GATANGA,53,598,653,1251
MURANG'A,GATANGA,54,741,675,1416
MURANG'A,GATANGA,50-54,3866,3921,7787
MURANG'A,GATANGA,55,723,665,1388
MURANG'A,GATANGA,56,794,732,1526
MURANG'A,GATANGA,57,652,772,1424
MURANG'A,GATANGA,58,531,583,1114
MURANG'A,GATANGA,59,606,614,1220
MURANG'A,GATANGA,55-59,3306,3366,6672
MURANG'A,GATANGA,60,629,664,1293
MURANG'A,GATANGA,61,487,543,1030
MURANG'A,GATANGA,62,459,462,921
MURANG'A,GATANGA,63,382,457,839
MURANG'A,GATANGA,64,310,337,647
MURANG'A,GATANGA,60-64,2267,2463,4730
MURANG'A,GATANGA,65,452,477,929
MURANG'A,GATANGA,66,327,364,691
MURANG'A,GATANGA,67,593,622,1215
MURANG'A,GATANGA,68,280,301,581
MURANG'A,GATANGA,69,409,472,881
MURANG'A,GATANGA,65-69,2061,2236,4297
MURANG'A,GATANGA,70,437,554,991
MURANG'A,GATANGA,71,370,352,722
MURANG'A,GATANGA,72,362,322,684
MURANG'A,GATANGA,73,267,274,541
MURANG'A,GATANGA,74,250,286,536
MURANG'A,GATANGA,70-74,1686,1788,3474
MURANG'A,GATANGA,75,174,279,453
MURANG'A,GATANGA,76,243,484,727
MURANG'A,GATANGA,77,176,225,401
MURANG'A,GATANGA,78,121,130,251
MURANG'A,GATANGA,79,147,229,376
MURANG'A,GATANGA,75-79,861,1347,2208
MURANG'A,GATANGA,80,155,277,432
MURANG'A,GATANGA,81,106,157,263
MURANG'A,GATANGA,82,105,131,236
MURANG'A,GATANGA,83,96,151,247
MURANG'A,GATANGA,84,84,166,250
MURANG'A,GATANGA,80-84,546,882,1428
MURANG'A,GATANGA,85,85,152,237
MURANG'A,GATANGA,86,64,119,183
MURANG'A,GATANGA,87,70,102,172
MURANG'A,GATANGA,88,37,69,106
MURANG'A,GATANGA,89,54,159,213
MURANG'A,GATANGA,85-89,310,601,911
MURANG'A,GATANGA,90,38,93,131
MURANG'A,GATANGA,91,45,63,108
MURANG'A,GATANGA,92,19,48,67
MURANG'A,GATANGA,93,17,50,67
MURANG'A,GATANGA,94,21,46,67
MURANG'A,GATANGA,90-94,140,300,440
MURANG'A,GATANGA,95,20,42,62
MURANG'A,GATANGA,96,14,29,43
MURANG'A,GATANGA,97,15,35,50
MURANG'A,GATANGA,98,10,16,26
MURANG'A,GATANGA,99,7,43,50
MURANG'A,GATANGA,95-99,66,165,231
MURANG'A,GATANGA,100+,22,106,128
MURANG'A,GATANGA,Not Stated,1,-,1
MURANG'A,KIGUMO,Total,67989,68929,136918
MURANG'A,KIGUMO,0,1359,1301,2660
MURANG'A,KIGUMO,1,1432,1461,2893
MURANG'A,KIGUMO,2,1429,1369,2798
MURANG'A,KIGUMO,3,1449,1466,2915
MURANG'A,KIGUMO,4,1550,1451,3001
MURANG'A,KIGUMO,0 - 4,7219,7048,14267
MURANG'A,KIGUMO,5,1514,1496,3010
MURANG'A,KIGUMO,6,1521,1470,2991
MURANG'A,KIGUMO,7,1581,1485,3066
MURANG'A,KIGUMO,8,1549,1454,3003
MURANG'A,KIGUMO,9,1681,1624,3305
MURANG'A,KIGUMO,05-Sep,7846,7529,15375
MURANG'A,KIGUMO,10,1596,1501,3097
MURANG'A,KIGUMO,11,1467,1442,2909
MURANG'A,KIGUMO,12,1652,1566,3218
MURANG'A,KIGUMO,13,1659,1589,3248
MURANG'A,KIGUMO,14,1574,1451,3025
MURANG'A,KIGUMO,Oct-14,7948,7549,15497
MURANG'A,KIGUMO,15,1463,1449,2912
MURANG'A,KIGUMO,16,1490,1414,2904
MURANG'A,KIGUMO,17,1488,1393,2881
MURANG'A,KIGUMO,18,1256,1081,2337
MURANG'A,KIGUMO,19,1248,1095,2343
MURANG'A,KIGUMO,15-19,6945,6432,13377
MURANG'A,KIGUMO,20,1103,948,2051
MURANG'A,KIGUMO,21,956,916,1872
MURANG'A,KIGUMO,22,965,889,1854
MURANG'A,KIGUMO,23,886,901,1787
MURANG'A,KIGUMO,24,838,841,1679
MURANG'A,KIGUMO,20-24,4748,4495,9243
MURANG'A,KIGUMO,25,878,892,1770
MURANG'A,KIGUMO,26,743,783,1526
MURANG'A,KIGUMO,27,750,805,1555
MURANG'A,KIGUMO,28,737,834,1571
MURANG'A,KIGUMO,29,838,885,1723
MURANG'A,KIGUMO,25-29,3946,4199,8145
MURANG'A,KIGUMO,30,1038,1076,2114
MURANG'A,KIGUMO,31,785,775,1560
MURANG'A,KIGUMO,32,1011,1063,2074
MURANG'A,KIGUMO,33,896,921,1817
MURANG'A,KIGUMO,34,904,881,1785
MURANG'A,KIGUMO,30-34,4634,4716,9350
MURANG'A,KIGUMO,35,1139,1127,2266
MURANG'A,KIGUMO,36,824,818,1642
MURANG'A,KIGUMO,37,876,906,1782
MURANG'A,KIGUMO,38,772,815,1587
MURANG'A,KIGUMO,39,845,806,1651
MURANG'A,KIGUMO,35-39,4456,4472,8928
MURANG'A,KIGUMO,40,1053,1016,2069
MURANG'A,KIGUMO,41,900,780,1680
MURANG'A,KIGUMO,42,819,811,1630
MURANG'A,KIGUMO,43,732,765,1497
MURANG'A,KIGUMO,44,663,713,1376
MURANG'A,KIGUMO,40-44,4167,4085,8252
MURANG'A,KIGUMO,45,915,931,1846
MURANG'A,KIGUMO,46,761,716,1477
MURANG'A,KIGUMO,47,768,780,1548
MURANG'A,KIGUMO,48,615,601,1216
MURANG'A,KIGUMO,49,644,680,1324
MURANG'A,KIGUMO,45-49,3703,3708,7411
MURANG'A,KIGUMO,50,703,776,1479
MURANG'A,KIGUMO,51,511,574,1085
MURANG'A,KIGUMO,52,611,653,1264
MURANG'A,KIGUMO,53,484,488,972
MURANG'A,KIGUMO,54,503,611,1114
MURANG'A,KIGUMO,50-54,2812,3102,5914
MURANG'A,KIGUMO,55,542,614,1156
MURANG'A,KIGUMO,56,624,631,1255
MURANG'A,KIGUMO,57,483,577,1060
MURANG'A,KIGUMO,58,419,436,855
MURANG'A,KIGUMO,59,481,519,1000
MURANG'A,KIGUMO,55-59,2549,2777,5326
MURANG'A,KIGUMO,60,530,628,1158
MURANG'A,KIGUMO,61,400,451,851
MURANG'A,KIGUMO,62,367,324,691
MURANG'A,KIGUMO,63,314,326,640
MURANG'A,KIGUMO,64,274,271,545
MURANG'A,KIGUMO,60-64,1885,2000,3885
MURANG'A,KIGUMO,65,376,444,820
MURANG'A,KIGUMO,66,294,298,592
MURANG'A,KIGUMO,67,469,577,1046
MURANG'A,KIGUMO,68,201,255,456
MURANG'A,KIGUMO,69,311,365,676
MURANG'A,KIGUMO,65-69,1651,1939,3590
MURANG'A,KIGUMO,70,461,559,1020
MURANG'A,KIGUMO,71,338,367,705
MURANG'A,KIGUMO,72,312,269,581
MURANG'A,KIGUMO,73,281,297,578
MURANG'A,KIGUMO,74,223,281,504
MURANG'A,KIGUMO,70-74,1615,1773,3388
MURANG'A,KIGUMO,75,187,288,475
MURANG'A,KIGUMO,76,255,451,706
MURANG'A,KIGUMO,77,175,205,380
MURANG'A,KIGUMO,78,96,127,223
MURANG'A,KIGUMO,79,152,223,375
MURANG'A,KIGUMO,75-79,865,1294,2159
MURANG'A,KIGUMO,80,172,253,425
MURANG'A,KIGUMO,81,95,133,228
MURANG'A,KIGUMO,82,81,106,187
MURANG'A,KIGUMO,83,90,124,214
MURANG'A,KIGUMO,84,96,174,270
MURANG'A,KIGUMO,80-84,534,790,1324
MURANG'A,KIGUMO,85,79,118,197
MURANG'A,KIGUMO,86,68,101,169
MURANG'A,KIGUMO,87,57,93,150
MURANG'A,KIGUMO,88,31,41,72
MURANG'A,KIGUMO,89,48,143,191
MURANG'A,KIGUMO,85-89,283,496,779
MURANG'A,KIGUMO,90,35,90,125
MURANG'A,KIGUMO,91,34,64,98
MURANG'A,KIGUMO,92,18,46,64
MURANG'A,KIGUMO,93,8,32,40
MURANG'A,KIGUMO,94,12,33,45
MURANG'A,KIGUMO,90-94,107,265,372
MURANG'A,KIGUMO,95,23,50,73
MURANG'A,KIGUMO,96,9,24,33
MURANG'A,KIGUMO,97,12,31,43
MURANG'A,KIGUMO,98,5,26,31
MURANG'A,KIGUMO,99,11,35,46
MURANG'A,KIGUMO,95-99,60,166,226
MURANG'A,KIGUMO,100+,15,93,108
MURANG'A,KIGUMO,Not Stated,1,1,2
MURANG'A,KANDARA,Total,86698,88393,175091
MURANG'A,KANDARA,0,1810,1800,3610
MURANG'A,KANDARA,1,1864,1777,3641
MURANG'A,KANDARA,2,1905,1884,3789
MURANG'A,KANDARA,3,1874,1952,3826
MURANG'A,KANDARA,4,1929,1887,3816
MURANG'A,KANDARA,0 - 4,9382,9300,18682
MURANG'A,KANDARA,5,1839,1788,3627
MURANG'A,KANDARA,6,1820,1841,3661
MURANG'A,KANDARA,7,2001,1930,3931
MURANG'A,KANDARA,8,1942,1867,3809
MURANG'A,KANDARA,9,2031,2061,4092
MURANG'A,KANDARA,05-Sep,9633,9487,19120
MURANG'A,KANDARA,10,1946,1916,3862
MURANG'A,KANDARA,11,1797,1831,3628
MURANG'A,KANDARA,12,2081,1970,4051
MURANG'A,KANDARA,13,2087,2036,4123
MURANG'A,KANDARA,14,1989,1849,3838
MURANG'A,KANDARA,Oct-14,9900,9602,19502
MURANG'A,KANDARA,15,1931,1913,3844
MURANG'A,KANDARA,16,1900,1869,3769
MURANG'A,KANDARA,17,2102,1757,3859
MURANG'A,KANDARA,18,1675,1478,3153
MURANG'A,KANDARA,19,1645,1474,3119
MURANG'A,KANDARA,15-19,9253,8491,17744
MURANG'A,KANDARA,20,1352,1325,2677
MURANG'A,KANDARA,21,1326,1138,2464
MURANG'A,KANDARA,22,1284,1188,2472
MURANG'A,KANDARA,23,1256,1220,2476
MURANG'A,KANDARA,24,1091,1098,2189
MURANG'A,KANDARA,20-24,6309,5969,12278
MURANG'A,KANDARA,25,1118,1110,2228
MURANG'A,KANDARA,26,941,1019,1960
MURANG'A,KANDARA,27,1041,1107,2148
MURANG'A,KANDARA,28,953,1003,1956
MURANG'A,KANDARA,29,1055,1066,2121
MURANG'A,KANDARA,25-29,5108,5305,10413
MURANG'A,KANDARA,30,1295,1408,2703
MURANG'A,KANDARA,31,1013,1023,2036
MURANG'A,KANDARA,32,1224,1315,2539
MURANG'A,KANDARA,33,1091,1141,2232
MURANG'A,KANDARA,34,1000,1103,2103
MURANG'A,KANDARA,30-34,5623,5990,11613
MURANG'A,KANDARA,35,1391,1422,2813
MURANG'A,KANDARA,36,1099,1061,2160
MURANG'A,KANDARA,37,1111,993,2104
MURANG'A,KANDARA,38,1022,1041,2063
MURANG'A,KANDARA,39,1139,1063,2202
MURANG'A,KANDARA,35-39,5762,5580,11342
MURANG'A,KANDARA,40,1286,1261,2547
MURANG'A,KANDARA,41,1046,947,1993
MURANG'A,KANDARA,42,1078,993,2071
MURANG'A,KANDARA,43,921,934,1855
MURANG'A,KANDARA,44,865,765,1630
MURANG'A,KANDARA,40-44,5196,4900,10096
MURANG'A,KANDARA,45,1138,1177,2315
MURANG'A,KANDARA,46,938,929,1867
MURANG'A,KANDARA,47,961,952,1913
MURANG'A,KANDARA,48,794,758,1552
MURANG'A,KANDARA,49,750,774,1524
MURANG'A,KANDARA,45-49,4581,4590,9171
MURANG'A,KANDARA,50,904,958,1862
MURANG'A,KANDARA,51,701,667,1368
MURANG'A,KANDARA,52,753,799,1552
MURANG'A,KANDARA,53,562,633,1195
MURANG'A,KANDARA,54,625,703,1328
MURANG'A,KANDARA,50-54,3545,3760,7305
MURANG'A,KANDARA,55,695,751,1446
MURANG'A,KANDARA,56,737,805,1542
MURANG'A,KANDARA,57,713,804,1517
MURANG'A,KANDARA,58,543,641,1184
MURANG'A,KANDARA,59,639,670,1309
MURANG'A,KANDARA,55-59,3327,3671,6998
MURANG'A,KANDARA,60,732,775,1507
MURANG'A,KANDARA,61,556,651,1207
MURANG'A,KANDARA,62,459,496,955
MURANG'A,KANDARA,63,413,441,854
MURANG'A,KANDARA,64,332,338,670
MURANG'A,KANDARA,60-64,2492,2701,5193
MURANG'A,KANDARA,65,496,565,1061
MURANG'A,KANDARA,66,312,392,704
MURANG'A,KANDARA,67,663,690,1353
MURANG'A,KANDARA,68,312,314,626
MURANG'A,KANDARA,69,467,473,940
MURANG'A,KANDARA,65-69,2250,2434,4684
MURANG'A,KANDARA,70,581,772,1353
MURANG'A,KANDARA,71,434,451,885
MURANG'A,KANDARA,72,414,389,803
MURANG'A,KANDARA,73,317,314,631
MURANG'A,KANDARA,74,256,342,598
MURANG'A,KANDARA,70-74,2002,2268,4270
MURANG'A,KANDARA,75,222,368,590
MURANG'A,KANDARA,76,287,645,932
MURANG'A,KANDARA,77,167,252,419
MURANG'A,KANDARA,78,142,167,309
MURANG'A,KANDARA,79,192,277,469
MURANG'A,KANDARA,75-79,1010,1709,2719
MURANG'A,KANDARA,80,204,394,598
MURANG'A,KANDARA,81,94,196,290
MURANG'A,KANDARA,82,106,124,230
MURANG'A,KANDARA,83,133,199,332
MURANG'A,KANDARA,84,117,221,338
MURANG'A,KANDARA,80-84,654,1134,1788
MURANG'A,KANDARA,85,121,173,294
MURANG'A,KANDARA,86,72,133,205
MURANG'A,KANDARA,87,84,157,241
MURANG'A,KANDARA,88,40,72,112
MURANG'A,KANDARA,89,89,204,293
MURANG'A,KANDARA,85-89,406,739,1145
MURANG'A,KANDARA,90,53,113,166
MURANG'A,KANDARA,91,43,83,126
MURANG'A,KANDARA,92,32,44,76
MURANG'A,KANDARA,93,22,58,80
MURANG'A,KANDARA,94,17,70,87
MURANG'A,KANDARA,90-94,167,368,535
MURANG'A,KANDARA,95,18,68,86
MURANG'A,KANDARA,96,8,37,45
MURANG'A,KANDARA,97,19,52,71
MURANG'A,KANDARA,98,15,38,53
MURANG'A,KANDARA,99,15,79,94
MURANG'A,KANDARA,95-99,75,274,349
MURANG'A,KANDARA,100+,22,121,143
MURANG'A,KANDARA,Not Stated,1,-,1
MURANG'A,ABERDARE FOREST,Total,31,12,43
MURANG'A,ABERDARE FOREST,0,-,-,-
MURANG'A,ABERDARE FOREST,1,1,-,1
MURANG'A,ABERDARE FOREST,2,-,-,-
MURANG'A,ABERDARE FOREST,3,-,1,1
MURANG'A,ABERDARE FOREST,4,-,-,-
MURANG'A,ABERDARE FOREST,0 - 4,1,1,2
MURANG'A,ABERDARE FOREST,5,1,-,1
MURANG'A,ABERDARE FOREST,6,-,1,1
MURANG'A,ABERDARE FOREST,7,1,-,1
MURANG'A,ABERDARE FOREST,8,-,-,-
MURANG'A,ABERDARE FOREST,9,-,-,-
MURANG'A,ABERDARE FOREST,05-Sep,2,1,3
MURANG'A,ABERDARE FOREST,10,-,-,-
MURANG'A,ABERDARE FOREST,11,-,1,1
MURANG'A,ABERDARE FOREST,12,-,-,-
MURANG'A,ABERDARE FOREST,13,-,-,-
MURANG'A,ABERDARE FOREST,14,-,1,1
MURANG'A,ABERDARE FOREST,Oct-14,-,2,2
MURANG'A,ABERDARE FOREST,15,-,-,-
MURANG'A,ABERDARE FOREST,16,-,-,-
MURANG'A,ABERDARE FOREST,17,-,-,-
MURANG'A,ABERDARE FOREST,18,-,-,-
MURANG'A,ABERDARE FOREST,19,1,-,1
MURANG'A,ABERDARE FOREST,15-19,1,-,1
MURANG'A,ABERDARE FOREST,20,-,-,-
MURANG'A,ABERDARE FOREST,21,-,-,-
MURANG'A,ABERDARE FOREST,22,1,-,1
MURANG'A,ABERDARE FOREST,23,-,1,1
MURANG'A,ABERDARE FOREST,24,2,1,3
MURANG'A,ABERDARE FOREST,20-24,3,2,5
MURANG'A,ABERDARE FOREST,25,2,-,2
MURANG'A,ABERDARE FOREST,26,3,1,4
MURANG'A,ABERDARE FOREST,27,-,1,1
MURANG'A,ABERDARE FOREST,28,1,1,2
MURANG'A,ABERDARE FOREST,29,1,-,1
MURANG'A,ABERDARE FOREST,25-29,7,3,10
MURANG'A,ABERDARE FOREST,30,1,-,1
MURANG'A,ABERDARE FOREST,31,-,-,-
MURANG'A,ABERDARE FOREST,32,1,-,1
MURANG'A,ABERDARE FOREST,33,-,-,-
MURANG'A,ABERDARE FOREST,34,1,-,1
MURANG'A,ABERDARE FOREST,30-34,3,-,3
MURANG'A,ABERDARE FOREST,35,-,-,-
MURANG'A,ABERDARE FOREST,36,3,1,4
MURANG'A,ABERDARE FOREST,37,-,-,-
MURANG'A,ABERDARE FOREST,38,1,-,1
MURANG'A,ABERDARE FOREST,39,2,-,2
MURANG'A,ABERDARE FOREST,35-39,6,1,7
MURANG'A,ABERDARE FOREST,40,-,-,-
MURANG'A,ABERDARE FOREST,41,-,1,1
MURANG'A,ABERDARE FOREST,42,-,-,-
MURANG'A,ABERDARE FOREST,43,-,-,-
MURANG'A,ABERDARE FOREST,44,-,-,-
MURANG'A,ABERDARE FOREST,40-44,-,1,1
MURANG'A,ABERDARE FOREST,45,-,-,-
MURANG'A,ABERDARE FOREST,46,2,-,2
MURANG'A,ABERDARE FOREST,47,-,-,-
MURANG'A,ABERDARE FOREST,48,-,-,-
MURANG'A,ABERDARE FOREST,49,-,-,-
MURANG'A,ABERDARE FOREST,45-49,2,-,2
MURANG'A,ABERDARE FOREST,50,1,-,1
MURANG'A,ABERDARE FOREST,51,2,-,2
MURANG'A,ABERDARE FOREST,52,-,-,-
MURANG'A,ABERDARE FOREST,53,1,-,1
MURANG'A,ABERDARE FOREST,54,1,1,2
MURANG'A,ABERDARE FOREST,50-54,5,1,6
MURANG'A,ABERDARE FOREST,55,1,-,1
MURANG'A,ABERDARE FOREST,56,-,-,-
MURANG'A,ABERDARE FOREST,57,-,-,-
MURANG'A,ABERDARE FOREST,58,-,-,-
MURANG'A,ABERDARE FOREST,59,-,-,-
MURANG'A,ABERDARE FOREST,55-59,1,-,1
MURANG'A,ABERDARE FOREST,60,-,-,-
MURANG'A,ABERDARE FOREST,61,-,-,-
MURANG'A,ABERDARE FOREST,62,-,-,-
MURANG'A,ABERDARE FOREST,63,-,-,-
MURANG'A,ABERDARE FOREST,64,-,-,-
MURANG'A,ABERDARE FOREST,60-64,-,-,-
MURANG'A,ABERDARE FOREST,65,-,-,-
MURANG'A,ABERDARE FOREST,66,-,-,-
MURANG'A,ABERDARE FOREST,67,-,-,-
MURANG'A,ABERDARE FOREST,68,-,-,-
MURANG'A,ABERDARE FOREST,69,-,-,-
MURANG'A,ABERDARE FOREST,65-69,-,-,-
MURANG'A,ABERDARE FOREST,70,-,-,-
MURANG'A,ABERDARE FOREST,71,-,-,-
MURANG'A,ABERDARE FOREST,72,-,-,-
MURANG'A,ABERDARE FOREST,73,-,-,-
MURANG'A,ABERDARE FOREST,74,-,-,-
MURANG'A,ABERDARE FOREST,70-74,-,-,-
MURANG'A,ABERDARE FOREST,75,-,-,-
MURANG'A,ABERDARE FOREST,76,-,-,-
MURANG'A,ABERDARE FOREST,77,-,-,-
MURANG'A,ABERDARE FOREST,78,-,-,-
MURANG'A,ABERDARE FOREST,79,-,-,-
MURANG'A,ABERDARE FOREST,75-79,-,-,-
MURANG'A,ABERDARE FOREST,80,-,-,-
MURANG'A,ABERDARE FOREST,81,-,-,-
MURANG'A,ABERDARE FOREST,82,-,-,-
MURANG'A,ABERDARE FOREST,83,-,-,-
MURANG'A,ABERDARE FOREST,84,-,-,-
MURANG'A,ABERDARE FOREST,80-84,-,-,-
MURANG'A,ABERDARE FOREST,85,-,-,-
MURANG'A,ABERDARE FOREST,86,-,-,-
MURANG'A,ABERDARE FOREST,87,-,-,-
MURANG'A,ABERDARE FOREST,88,-,-,-
MURANG'A,ABERDARE FOREST,89,-,-,-
MURANG'A,ABERDARE FOREST,85-89,-,-,-
MURANG'A,ABERDARE FOREST,90,-,-,-
MURANG'A,ABERDARE FOREST,91,-,-,-
MURANG'A,ABERDARE FOREST,92,-,-,-
MURANG'A,ABERDARE FOREST,93,-,-,-
MURANG'A,ABERDARE FOREST,94,-,-,-
MURANG'A,ABERDARE FOREST,90-94,-,-,-
MURANG'A,ABERDARE FOREST,95,-,-,-
MURANG'A,ABERDARE FOREST,96,-,-,-
MURANG'A,ABERDARE FOREST,97,-,-,-
MURANG'A,ABERDARE FOREST,98,-,-,-
MURANG'A,ABERDARE FOREST,99,-,-,-
MURANG'A,ABERDARE FOREST,95-99,-,-,-
MURANG'A,ABERDARE FOREST,100+,-,-,-
MURANG'A,ABERDARE FOREST,Not Stated,-,-,-
NAIROBI,ALL,Total,2192452,2204376,4396828
NAIROBI,ALL,0,57265,56523,113788
NAIROBI,ALL,1,56019,54601,110620
NAIROBI,ALL,2,52518,51848,104366
NAIROBI,ALL,3,51115,51027,102142
NAIROBI,ALL,4,47182,46889,94071
NAIROBI,ALL,0 - 4,264099,260888,524987
NAIROBI,ALL,5,45203,44711,89914
NAIROBI,ALL,6,43635,44226,87861
NAIROBI,ALL,7,43507,43655,87162
NAIROBI,ALL,8,40916,41615,82531
NAIROBI,ALL,9,41969,43275,85244
NAIROBI,ALL,05-Sep,215230,217482,432712
NAIROBI,ALL,10,40791,40892,81683
NAIROBI,ALL,11,35581,37513,73094
NAIROBI,ALL,12,37907,39622,77529
NAIROBI,ALL,13,36701,39479,76180
NAIROBI,ALL,14,34028,36036,70064
NAIROBI,ALL,Oct-14,185008,193542,378550
NAIROBI,ALL,15,30919,35136,66055
NAIROBI,ALL,16,30408,35599,66007
NAIROBI,ALL,17,32413,37865,70278
NAIROBI,ALL,18,29102,36415,65517
NAIROBI,ALL,19,36256,47740,83996
NAIROBI,ALL,15-19,159098,192755,351853
NAIROBI,ALL,20,39853,55625,95478
NAIROBI,ALL,21,45052,57938,102990
NAIROBI,ALL,22,49186,62338,111524
NAIROBI,ALL,23,57179,70152,127331
NAIROBI,ALL,24,58264,67432,125696
NAIROBI,ALL,20-24,249534,313485,563019
NAIROBI,ALL,25,63693,69680,133373
NAIROBI,ALL,26,56174,62288,118462
NAIROBI,ALL,27,57764,60383,118147
NAIROBI,ALL,28,50792,53563,104355
NAIROBI,ALL,29,54280,54931,109211
NAIROBI,ALL,25-29,282703,300845,583548
NAIROBI,ALL,30,64070,65757,129827
NAIROBI,ALL,31,44601,42537,87138
NAIROBI,ALL,32,56015,54958,110973
NAIROBI,ALL,33,43556,42761,86317
NAIROBI,ALL,34,41234,39981,81215
NAIROBI,ALL,30-34,249476,245994,495470
NAIROBI,ALL,35,49053,44052,93105
NAIROBI,ALL,36,35610,33131,68741
NAIROBI,ALL,37,34835,30671,65506
NAIROBI,ALL,38,30710,28604,59314
NAIROBI,ALL,39,31593,27537,59130
NAIROBI,ALL,35-39,181801,163995,345796
NAIROBI,ALL,40,37229,30970,68199
NAIROBI,ALL,41,29619,23693,53312
NAIROBI,ALL,42,28657,22977,51634
NAIROBI,ALL,43,24278,19898,44176
NAIROBI,ALL,44,19495,16346,35841
NAIROBI,ALL,40-44,139278,113884,253162
NAIROBI,ALL,45,28137,21111,49248
NAIROBI,ALL,46,19749,14969,34718
NAIROBI,ALL,47,20398,14741,35139
NAIROBI,ALL,48,15447,11472,26919
NAIROBI,ALL,49,16988,11920,28908
NAIROBI,ALL,45-49,100719,74213,174932
NAIROBI,ALL,50,18699,14032,32731
NAIROBI,ALL,51,12961,9112,22073
NAIROBI,ALL,52,13381,9179,22560
NAIROBI,ALL,53,9905,7611,17516
NAIROBI,ALL,54,11271,7798,19069
NAIROBI,ALL,50-54,66217,47732,113949
NAIROBI,ALL,55,10869,7263,18132
NAIROBI,ALL,56,10179,7370,17549
NAIROBI,ALL,57,8966,6677,15643
NAIROBI,ALL,58,7164,5147,12311
NAIROBI,ALL,59,7561,5405,12966
NAIROBI,ALL,55-59,44739,31862,76601
NAIROBI,ALL,60,7694,6148,13842
NAIROBI,ALL,61,5197,3948,9145
NAIROBI,ALL,62,4853,3447,8300
NAIROBI,ALL,63,4051,3103,7154
NAIROBI,ALL,64,3106,2437,5543
NAIROBI,ALL,60-64,24901,19083,43984
NAIROBI,ALL,65,3992,3256,7248
NAIROBI,ALL,66,2591,2191,4782
NAIROBI,ALL,67,3553,2762,6315
NAIROBI,ALL,68,1914,1612,3526
NAIROBI,ALL,69,2408,2104,4512
NAIROBI,ALL,65-69,14458,11925,26383
NAIROBI,ALL,70,2676,2653,5329
NAIROBI,ALL,71,1797,1541,3338
NAIROBI,ALL,72,1672,1376,3048
NAIROBI,ALL,73,1295,1119,2414
NAIROBI,ALL,74,1129,1096,2225
NAIROBI,ALL,70-74,8569,7785,16354
NAIROBI,ALL,75,909,1084,1993
NAIROBI,ALL,76,849,947,1796
NAIROBI,ALL,77,682,763,1445
NAIROBI,ALL,78,505,516,1021
NAIROBI,ALL,79,530,652,1182
NAIROBI,ALL,75-79,3475,3962,7437
NAIROBI,ALL,80,603,917,1520
NAIROBI,ALL,81,302,432,734
NAIROBI,ALL,82,341,408,749
NAIROBI,ALL,83,335,388,723
NAIROBI,ALL,84,275,384,659
NAIROBI,ALL,80-84,1856,2529,4385
NAIROBI,ALL,85,243,335,578
NAIROBI,ALL,86,172,268,440
NAIROBI,ALL,87,155,270,425
NAIROBI,ALL,88,111,132,243
NAIROBI,ALL,89,116,248,364
NAIROBI,ALL,85-89,797,1253,2050
NAIROBI,ALL,90,89,218,307
NAIROBI,ALL,91,65,135,200
NAIROBI,ALL,92,47,98,145
NAIROBI,ALL,93,39,75,114
NAIROBI,ALL,94,30,77,107
NAIROBI,ALL,90-94,270,603,873
NAIROBI,ALL,95,32,108,140
NAIROBI,ALL,96,29,65,94
NAIROBI,ALL,97,22,46,68
NAIROBI,ALL,98,16,34,50
NAIROBI,ALL,99,16,66,82
NAIROBI,ALL,95-99,115,319,434
NAIROBI,ALL,100+,35,171,206
NAIROBI,ALL,Not Stated,74,69,143
NAIROBI,DAGORETTI,Total,217651,216526,434177
NAIROBI,DAGORETTI,0,6004,5820,11824
NAIROBI,DAGORETTI,1,5785,5715,11500
NAIROBI,DAGORETTI,2,5241,5462,10703
NAIROBI,DAGORETTI,3,5172,5285,10457
NAIROBI,DAGORETTI,4,4814,4691,9505
NAIROBI,DAGORETTI,0 - 4,27016,26973,53989
NAIROBI,DAGORETTI,5,4395,4548,8943
NAIROBI,DAGORETTI,6,4367,4531,8898
NAIROBI,DAGORETTI,7,4465,4340,8805
NAIROBI,DAGORETTI,8,4112,4220,8332
NAIROBI,DAGORETTI,9,4186,4392,8578
NAIROBI,DAGORETTI,05-Sep,21525,22031,43556
NAIROBI,DAGORETTI,10,4070,4185,8255
NAIROBI,DAGORETTI,11,3528,3671,7199
NAIROBI,DAGORETTI,12,3791,4076,7867
NAIROBI,DAGORETTI,13,3848,3984,7832
NAIROBI,DAGORETTI,14,3410,3695,7105
NAIROBI,DAGORETTI,Oct-14,18647,19611,38258
NAIROBI,DAGORETTI,15,3028,3461,6489
NAIROBI,DAGORETTI,16,3024,3490,6514
NAIROBI,DAGORETTI,17,3263,3711,6974
NAIROBI,DAGORETTI,18,2857,3368,6225
NAIROBI,DAGORETTI,19,3529,4371,7900
NAIROBI,DAGORETTI,15-19,15701,18401,34102
NAIROBI,DAGORETTI,20,3764,5189,8953
NAIROBI,DAGORETTI,21,4323,5574,9897
NAIROBI,DAGORETTI,22,4786,5822,10608
NAIROBI,DAGORETTI,23,5487,6626,12113
NAIROBI,DAGORETTI,24,5800,6511,12311
NAIROBI,DAGORETTI,20-24,24160,29722,53882
NAIROBI,DAGORETTI,25,6281,6717,12998
NAIROBI,DAGORETTI,26,5814,6117,11931
NAIROBI,DAGORETTI,27,5969,6067,12036
NAIROBI,DAGORETTI,28,5298,5196,10494
NAIROBI,DAGORETTI,29,5559,5425,10984
NAIROBI,DAGORETTI,25-29,28921,29522,58443
NAIROBI,DAGORETTI,30,6402,6357,12759
NAIROBI,DAGORETTI,31,4555,4159,8714
NAIROBI,DAGORETTI,32,5708,5365,11073
NAIROBI,DAGORETTI,33,4322,4168,8490
NAIROBI,DAGORETTI,34,4009,3833,7842
NAIROBI,DAGORETTI,30-34,24996,23882,48878
NAIROBI,DAGORETTI,35,4847,4267,9114
NAIROBI,DAGORETTI,36,3588,3264,6852
NAIROBI,DAGORETTI,37,3415,3021,6436
NAIROBI,DAGORETTI,38,2918,2810,5728
NAIROBI,DAGORETTI,39,3015,2666,5681
NAIROBI,DAGORETTI,35-39,17783,16028,33811
NAIROBI,DAGORETTI,40,3534,3056,6590
NAIROBI,DAGORETTI,41,2908,2383,5291
NAIROBI,DAGORETTI,42,2916,2333,5249
NAIROBI,DAGORETTI,43,2377,2028,4405
NAIROBI,DAGORETTI,44,1881,1549,3430
NAIROBI,DAGORETTI,40-44,13616,11349,24965
NAIROBI,DAGORETTI,45,2722,2138,4860
NAIROBI,DAGORETTI,46,2002,1485,3487
NAIROBI,DAGORETTI,47,2092,1460,3552
NAIROBI,DAGORETTI,48,1490,1096,2586
NAIROBI,DAGORETTI,49,1685,1146,2831
NAIROBI,DAGORETTI,45-49,9991,7325,17316
NAIROBI,DAGORETTI,50,1775,1291,3066
NAIROBI,DAGORETTI,51,1297,901,2198
NAIROBI,DAGORETTI,52,1281,881,2162
NAIROBI,DAGORETTI,53,998,667,1665
NAIROBI,DAGORETTI,54,999,750,1749
NAIROBI,DAGORETTI,50-54,6350,4490,10840
NAIROBI,DAGORETTI,55,1031,674,1705
NAIROBI,DAGORETTI,56,944,640,1584
NAIROBI,DAGORETTI,57,843,613,1456
NAIROBI,DAGORETTI,58,606,461,1067
NAIROBI,DAGORETTI,59,682,480,1162
NAIROBI,DAGORETTI,55-59,4106,2868,6974
NAIROBI,DAGORETTI,60,733,571,1304
NAIROBI,DAGORETTI,61,468,335,803
NAIROBI,DAGORETTI,62,461,312,773
NAIROBI,DAGORETTI,63,383,266,649
NAIROBI,DAGORETTI,64,258,193,451
NAIROBI,DAGORETTI,60-64,2303,1677,3980
NAIROBI,DAGORETTI,65,336,276,612
NAIROBI,DAGORETTI,66,186,187,373
NAIROBI,DAGORETTI,67,351,236,587
NAIROBI,DAGORETTI,68,132,126,258
NAIROBI,DAGORETTI,69,204,171,375
NAIROBI,DAGORETTI,65-69,1209,996,2205
NAIROBI,DAGORETTI,70,238,200,438
NAIROBI,DAGORETTI,71,148,155,303
NAIROBI,DAGORETTI,72,146,117,263
NAIROBI,DAGORETTI,73,107,90,197
NAIROBI,DAGORETTI,74,94,106,200
NAIROBI,DAGORETTI,70-74,733,668,1401
NAIROBI,DAGORETTI,75,62,97,159
NAIROBI,DAGORETTI,76,84,114,198
NAIROBI,DAGORETTI,77,58,86,144
NAIROBI,DAGORETTI,78,45,55,100
NAIROBI,DAGORETTI,79,56,72,128
NAIROBI,DAGORETTI,75-79,305,424,729
NAIROBI,DAGORETTI,80,52,97,149
NAIROBI,DAGORETTI,81,23,49,72
NAIROBI,DAGORETTI,82,27,35,62
NAIROBI,DAGORETTI,83,31,42,73
NAIROBI,DAGORETTI,84,27,38,65
NAIROBI,DAGORETTI,80-84,160,261,421
NAIROBI,DAGORETTI,85,24,44,68
NAIROBI,DAGORETTI,86,17,37,54
NAIROBI,DAGORETTI,87,15,27,42
NAIROBI,DAGORETTI,88,9,12,21
NAIROBI,DAGORETTI,89,9,26,35
NAIROBI,DAGORETTI,85-89,74,146,220
NAIROBI,DAGORETTI,90,13,27,40
NAIROBI,DAGORETTI,91,7,14,21
NAIROBI,DAGORETTI,92,2,13,15
NAIROBI,DAGORETTI,93,4,9,13
NAIROBI,DAGORETTI,94,5,14,19
NAIROBI,DAGORETTI,90-94,31,77,108
NAIROBI,DAGORETTI,95,6,19,25
NAIROBI,DAGORETTI,96,1,10,11
NAIROBI,DAGORETTI,97,1,8,9
NAIROBI,DAGORETTI,98,2,3,5
NAIROBI,DAGORETTI,99,1,4,5
NAIROBI,DAGORETTI,95-99,11,44,55
NAIROBI,DAGORETTI,100+,2,24,26
NAIROBI,DAGORETTI,Not Stated,11,7,18
NAIROBI,EMBAKASI,Total,492476,496270,988746
NAIROBI,EMBAKASI,0,13913,13982,27895
NAIROBI,EMBAKASI,1,13420,13073,26493
NAIROBI,EMBAKASI,2,12537,12367,24904
NAIROBI,EMBAKASI,3,12206,12172,24378
NAIROBI,EMBAKASI,4,11112,11176,22288
NAIROBI,EMBAKASI,0 - 4,63188,62770,125958
NAIROBI,EMBAKASI,5,10638,10405,21043
NAIROBI,EMBAKASI,6,10083,10174,20257
NAIROBI,EMBAKASI,7,9841,9890,19731
NAIROBI,EMBAKASI,8,9246,9295,18541
NAIROBI,EMBAKASI,9,9305,9657,18962
NAIROBI,EMBAKASI,05-Sep,49113,49421,98534
NAIROBI,EMBAKASI,10,8910,8981,17891
NAIROBI,EMBAKASI,11,7704,8195,15899
NAIROBI,EMBAKASI,12,8037,8494,16531
NAIROBI,EMBAKASI,13,7570,8222,15792
NAIROBI,EMBAKASI,14,6850,7477,14327
NAIROBI,EMBAKASI,Oct-14,39071,41369,80440
NAIROBI,EMBAKASI,15,6120,7280,13400
NAIROBI,EMBAKASI,16,5990,7300,13290
NAIROBI,EMBAKASI,17,6150,7956,14106
NAIROBI,EMBAKASI,18,5634,7839,13473
NAIROBI,EMBAKASI,19,7073,10781,17854
NAIROBI,EMBAKASI,15-19,30967,41156,72123
NAIROBI,EMBAKASI,20,7990,12731,20721
NAIROBI,EMBAKASI,21,9271,13386,22657
NAIROBI,EMBAKASI,22,10153,14570,24723
NAIROBI,EMBAKASI,23,12570,17129,29699
NAIROBI,EMBAKASI,24,13336,16815,30151
NAIROBI,EMBAKASI,20-24,53320,74631,127951
NAIROBI,EMBAKASI,25,15569,17820,33389
NAIROBI,EMBAKASI,26,14107,15890,29997
NAIROBI,EMBAKASI,27,14536,15293,29829
NAIROBI,EMBAKASI,28,12787,13686,26473
NAIROBI,EMBAKASI,29,14254,14202,28456
NAIROBI,EMBAKASI,25-29,71253,76891,148144
NAIROBI,EMBAKASI,30,16747,16733,33480
NAIROBI,EMBAKASI,31,11696,10539,22235
NAIROBI,EMBAKASI,32,14601,13359,27960
NAIROBI,EMBAKASI,33,11258,10233,21491
NAIROBI,EMBAKASI,34,10524,9316,19840
NAIROBI,EMBAKASI,30-34,64826,60180,125006
NAIROBI,EMBAKASI,35,12339,9964,22303
NAIROBI,EMBAKASI,36,8738,7599,16337
NAIROBI,EMBAKASI,37,8459,6785,15244
NAIROBI,EMBAKASI,38,7508,6386,13894
NAIROBI,EMBAKASI,39,7684,6103,13787
NAIROBI,EMBAKASI,35-39,44728,36837,81565
NAIROBI,EMBAKASI,40,8537,6398,14935
NAIROBI,EMBAKASI,41,6853,4782,11635
NAIROBI,EMBAKASI,42,6402,4581,10983
NAIROBI,EMBAKASI,43,5460,3811,9271
NAIROBI,EMBAKASI,44,4259,3058,7317
NAIROBI,EMBAKASI,40-44,31511,22630,54141
NAIROBI,EMBAKASI,45,6003,3805,9808
NAIROBI,EMBAKASI,46,4003,2577,6580
NAIROBI,EMBAKASI,47,4020,2550,6570
NAIROBI,EMBAKASI,48,2966,1890,4856
NAIROBI,EMBAKASI,49,3268,2020,5288
NAIROBI,EMBAKASI,45-49,20260,12842,33102
NAIROBI,EMBAKASI,50,3393,2237,5630
NAIROBI,EMBAKASI,51,2313,1461,3774
NAIROBI,EMBAKASI,52,2193,1370,3563
NAIROBI,EMBAKASI,53,1617,1358,2975
NAIROBI,EMBAKASI,54,1871,1093,2964
NAIROBI,EMBAKASI,50-54,11387,7519,18906
NAIROBI,EMBAKASI,55,1675,1029,2704
NAIROBI,EMBAKASI,56,1493,1069,2562
NAIROBI,EMBAKASI,57,1273,952,2225
NAIROBI,EMBAKASI,58,976,734,1710
NAIROBI,EMBAKASI,59,1112,782,1894
NAIROBI,EMBAKASI,55-59,6529,4566,11095
NAIROBI,EMBAKASI,60,1037,830,1867
NAIROBI,EMBAKASI,61,739,520,1259
NAIROBI,EMBAKASI,62,668,430,1098
NAIROBI,EMBAKASI,63,507,356,863
NAIROBI,EMBAKASI,64,428,284,712
NAIROBI,EMBAKASI,60-64,3379,2420,5799
NAIROBI,EMBAKASI,65,434,398,832
NAIROBI,EMBAKASI,66,298,267,565
NAIROBI,EMBAKASI,67,370,351,721
NAIROBI,EMBAKASI,68,199,176,375
NAIROBI,EMBAKASI,69,279,227,506
NAIROBI,EMBAKASI,65-69,1580,1419,2999
NAIROBI,EMBAKASI,70,293,317,610
NAIROBI,EMBAKASI,71,192,170,362
NAIROBI,EMBAKASI,72,157,135,292
NAIROBI,EMBAKASI,73,128,96,224
NAIROBI,EMBAKASI,74,97,88,185
NAIROBI,EMBAKASI,70-74,867,806,1673
NAIROBI,EMBAKASI,75,87,108,195
NAIROBI,EMBAKASI,76,53,72,125
NAIROBI,EMBAKASI,77,45,58,103
NAIROBI,EMBAKASI,78,31,64,95
NAIROBI,EMBAKASI,79,51,51,102
NAIROBI,EMBAKASI,75-79,267,353,620
NAIROBI,EMBAKASI,80,54,89,143
NAIROBI,EMBAKASI,81,19,30,49
NAIROBI,EMBAKASI,82,20,29,49
NAIROBI,EMBAKASI,83,22,30,52
NAIROBI,EMBAKASI,84,19,42,61
NAIROBI,EMBAKASI,80-84,134,220,354
NAIROBI,EMBAKASI,85,16,28,44
NAIROBI,EMBAKASI,86,8,19,27
NAIROBI,EMBAKASI,87,15,32,47
NAIROBI,EMBAKASI,88,7,7,14
NAIROBI,EMBAKASI,89,9,19,28
NAIROBI,EMBAKASI,85-89,55,105,160
NAIROBI,EMBAKASI,90,6,30,36
NAIROBI,EMBAKASI,91,1,17,18
NAIROBI,EMBAKASI,92,4,6,10
NAIROBI,EMBAKASI,93,2,4,6
NAIROBI,EMBAKASI,94,2,8,10
NAIROBI,EMBAKASI,90-94,15,65,80
NAIROBI,EMBAKASI,95,2,18,20
NAIROBI,EMBAKASI,96,2,4,6
NAIROBI,EMBAKASI,97,2,3,5
NAIROBI,EMBAKASI,98,1,2,3
NAIROBI,EMBAKASI,99,1,9,10
NAIROBI,EMBAKASI,95-99,8,36,44
NAIROBI,EMBAKASI,100+,4,22,26
NAIROBI,EMBAKASI,Not Stated,14,12,26
NAIROBI,KAMUKUNJI,Total,136670,131599,268269
NAIROBI,KAMUKUNJI,0,3769,3723,7492
NAIROBI,KAMUKUNJI,1,3560,3428,6988
NAIROBI,KAMUKUNJI,2,3454,3260,6714
NAIROBI,KAMUKUNJI,3,3397,3191,6588
NAIROBI,KAMUKUNJI,4,3133,3072,6205
NAIROBI,KAMUKUNJI,0 - 4,17313,16674,33987
NAIROBI,KAMUKUNJI,5,3145,2926,6071
NAIROBI,KAMUKUNJI,6,2802,2818,5620
NAIROBI,KAMUKUNJI,7,2802,2831,5633
NAIROBI,KAMUKUNJI,8,2590,2583,5173
NAIROBI,KAMUKUNJI,9,2647,2642,5289
NAIROBI,KAMUKUNJI,05-Sep,13986,13800,27786
NAIROBI,KAMUKUNJI,10,2604,2576,5180
NAIROBI,KAMUKUNJI,11,2243,2336,4579
NAIROBI,KAMUKUNJI,12,2347,2413,4760
NAIROBI,KAMUKUNJI,13,2338,2524,4862
NAIROBI,KAMUKUNJI,14,2328,2340,4668
NAIROBI,KAMUKUNJI,Oct-14,11860,12189,24049
NAIROBI,KAMUKUNJI,15,2118,2391,4509
NAIROBI,KAMUKUNJI,16,2208,2573,4781
NAIROBI,KAMUKUNJI,17,2419,2673,5092
NAIROBI,KAMUKUNJI,18,2216,2515,4731
NAIROBI,KAMUKUNJI,19,2643,3163,5806
NAIROBI,KAMUKUNJI,15-19,11604,13315,24919
NAIROBI,KAMUKUNJI,20,3109,3791,6900
NAIROBI,KAMUKUNJI,21,3410,3615,7025
NAIROBI,KAMUKUNJI,22,3699,4005,7704
NAIROBI,KAMUKUNJI,23,4019,4142,8161
NAIROBI,KAMUKUNJI,24,3922,3906,7828
NAIROBI,KAMUKUNJI,20-24,18159,19459,37618
NAIROBI,KAMUKUNJI,25,4345,4145,8490
NAIROBI,KAMUKUNJI,26,3572,3544,7116
NAIROBI,KAMUKUNJI,27,3541,3361,6902
NAIROBI,KAMUKUNJI,28,3087,2938,6025
NAIROBI,KAMUKUNJI,29,2965,2836,5801
NAIROBI,KAMUKUNJI,25-29,17510,16824,34334
NAIROBI,KAMUKUNJI,30,3654,3663,7317
NAIROBI,KAMUKUNJI,31,2486,2246,4732
NAIROBI,KAMUKUNJI,32,3036,2909,5945
NAIROBI,KAMUKUNJI,33,2374,2258,4632
NAIROBI,KAMUKUNJI,34,2184,2063,4247
NAIROBI,KAMUKUNJI,30-34,13734,13139,26873
NAIROBI,KAMUKUNJI,35,2840,2417,5257
NAIROBI,KAMUKUNJI,36,1918,1684,3602
NAIROBI,KAMUKUNJI,37,1832,1643,3475
NAIROBI,KAMUKUNJI,38,1624,1369,2993
NAIROBI,KAMUKUNJI,39,1726,1357,3083
NAIROBI,KAMUKUNJI,35-39,9940,8470,18410
NAIROBI,KAMUKUNJI,40,2241,1733,3974
NAIROBI,KAMUKUNJI,41,1614,1207,2821
NAIROBI,KAMUKUNJI,42,1560,1165,2725
NAIROBI,KAMUKUNJI,43,1323,1016,2339
NAIROBI,KAMUKUNJI,44,1002,822,1824
NAIROBI,KAMUKUNJI,40-44,7740,5943,13683
NAIROBI,KAMUKUNJI,45,1634,1265,2899
NAIROBI,KAMUKUNJI,46,1082,764,1846
NAIROBI,KAMUKUNJI,47,1048,763,1811
NAIROBI,KAMUKUNJI,48,797,596,1393
NAIROBI,KAMUKUNJI,49,904,689,1593
NAIROBI,KAMUKUNJI,45-49,5465,4077,9542
NAIROBI,KAMUKUNJI,50,1054,826,1880
NAIROBI,KAMUKUNJI,51,680,478,1158
NAIROBI,KAMUKUNJI,52,722,486,1208
NAIROBI,KAMUKUNJI,53,527,421,948
NAIROBI,KAMUKUNJI,54,605,423,1028
NAIROBI,KAMUKUNJI,50-54,3588,2634,6222
NAIROBI,KAMUKUNJI,55,623,457,1080
NAIROBI,KAMUKUNJI,56,516,411,927
NAIROBI,KAMUKUNJI,57,510,379,889
NAIROBI,KAMUKUNJI,58,378,265,643
NAIROBI,KAMUKUNJI,59,401,338,739
NAIROBI,KAMUKUNJI,55-59,2428,1850,4278
NAIROBI,KAMUKUNJI,60,476,503,979
NAIROBI,KAMUKUNJI,61,273,239,512
NAIROBI,KAMUKUNJI,62,267,218,485
NAIROBI,KAMUKUNJI,63,241,187,428
NAIROBI,KAMUKUNJI,64,165,161,326
NAIROBI,KAMUKUNJI,60-64,1422,1308,2730
NAIROBI,KAMUKUNJI,65,259,283,542
NAIROBI,KAMUKUNJI,66,155,127,282
NAIROBI,KAMUKUNJI,67,201,175,376
NAIROBI,KAMUKUNJI,68,100,96,196
NAIROBI,KAMUKUNJI,69,133,150,283
NAIROBI,KAMUKUNJI,65-69,848,831,1679
NAIROBI,KAMUKUNJI,70,234,252,486
NAIROBI,KAMUKUNJI,71,120,106,226
NAIROBI,KAMUKUNJI,72,127,94,221
NAIROBI,KAMUKUNJI,73,102,63,165
NAIROBI,KAMUKUNJI,74,88,68,156
NAIROBI,KAMUKUNJI,70-74,671,583,1254
NAIROBI,KAMUKUNJI,75,67,91,158
NAIROBI,KAMUKUNJI,76,50,60,110
NAIROBI,KAMUKUNJI,77,43,44,87
NAIROBI,KAMUKUNJI,78,40,23,63
NAIROBI,KAMUKUNJI,79,28,31,59
NAIROBI,KAMUKUNJI,75-79,228,249,477
NAIROBI,KAMUKUNJI,80,39,80,119
NAIROBI,KAMUKUNJI,81,24,19,43
NAIROBI,KAMUKUNJI,82,18,14,32
NAIROBI,KAMUKUNJI,83,17,11,28
NAIROBI,KAMUKUNJI,84,17,21,38
NAIROBI,KAMUKUNJI,80-84,115,145,260
NAIROBI,KAMUKUNJI,85,16,18,34
NAIROBI,KAMUKUNJI,86,8,8,16
NAIROBI,KAMUKUNJI,87,5,13,18
NAIROBI,KAMUKUNJI,88,1,3,4
NAIROBI,KAMUKUNJI,89,5,9,14
NAIROBI,KAMUKUNJI,85-89,35,51,86
NAIROBI,KAMUKUNJI,90,4,18,22
NAIROBI,KAMUKUNJI,91,5,11,16
NAIROBI,KAMUKUNJI,92,1,5,6
NAIROBI,KAMUKUNJI,93,2,2,4
NAIROBI,KAMUKUNJI,94,-,2,2
NAIROBI,KAMUKUNJI,90-94,12,38,50
NAIROBI,KAMUKUNJI,95,-,4,4
NAIROBI,KAMUKUNJI,96,1,-,1
NAIROBI,KAMUKUNJI,97,2,-,2
NAIROBI,KAMUKUNJI,98,-,2,2
NAIROBI,KAMUKUNJI,99,-,1,1
NAIROBI,KAMUKUNJI,95-99,3,7,10
NAIROBI,KAMUKUNJI,100+,1,9,10
NAIROBI,KAMUKUNJI,Not Stated,8,4,12
NAIROBI,KASARANI,Total,381234,399385,780619
NAIROBI,KASARANI,0,10662,10899,21561
NAIROBI,KASARANI,1,10525,10281,20806
NAIROBI,KASARANI,2,9741,9825,19566
NAIROBI,KASARANI,3,9252,9393,18645
NAIROBI,KASARANI,4,8631,8463,17094
NAIROBI,KASARANI,0 - 4,48811,48861,97672
NAIROBI,KASARANI,5,8166,8085,16251
NAIROBI,KASARANI,6,7940,7967,15907
NAIROBI,KASARANI,7,7720,7957,15677
NAIROBI,KASARANI,8,7296,7508,14804
NAIROBI,KASARANI,9,7397,7595,14992
NAIROBI,KASARANI,05-Sep,38519,39112,77631
NAIROBI,KASARANI,10,7258,7176,14434
NAIROBI,KASARANI,11,6234,6701,12935
NAIROBI,KASARANI,12,6617,6988,13605
NAIROBI,KASARANI,13,6519,7094,13613
NAIROBI,KASARANI,14,6014,6352,12366
NAIROBI,KASARANI,Oct-14,32642,34311,66953
NAIROBI,KASARANI,15,5429,6215,11644
NAIROBI,KASARANI,16,5158,6194,11352
NAIROBI,KASARANI,17,5547,6686,12233
NAIROBI,KASARANI,18,4870,6478,11348
NAIROBI,KASARANI,19,6269,8667,14936
NAIROBI,KASARANI,15-19,27273,34240,61513
NAIROBI,KASARANI,20,6517,10050,16567
NAIROBI,KASARANI,21,7526,10640,18166
NAIROBI,KASARANI,22,8486,11820,20306
NAIROBI,KASARANI,23,10215,13444,23659
NAIROBI,KASARANI,24,10358,13147,23505
NAIROBI,KASARANI,20-24,43102,59101,102203
NAIROBI,KASARANI,25,11221,13488,24709
NAIROBI,KASARANI,26,10052,12207,22259
NAIROBI,KASARANI,27,10716,11797,22513
NAIROBI,KASARANI,28,9375,10611,19986
NAIROBI,KASARANI,29,10137,10524,20661
NAIROBI,KASARANI,25-29,51501,58627,110128
NAIROBI,KASARANI,30,11814,12495,24309
NAIROBI,KASARANI,31,8111,8079,16190
NAIROBI,KASARANI,32,10036,10207,20243
NAIROBI,KASARANI,33,7854,8082,15936
NAIROBI,KASARANI,34,7425,7514,14939
NAIROBI,KASARANI,30-34,45240,46377,91617
NAIROBI,KASARANI,35,8575,7957,16532
NAIROBI,KASARANI,36,6147,5943,12090
NAIROBI,KASARANI,37,6040,5405,11445
NAIROBI,KASARANI,38,5226,5114,10340
NAIROBI,KASARANI,39,5360,4743,10103
NAIROBI,KASARANI,35-39,31348,29162,60510
NAIROBI,KASARANI,40,6333,5222,11555
NAIROBI,KASARANI,41,4817,3960,8777
NAIROBI,KASARANI,42,4632,3721,8353
NAIROBI,KASARANI,43,3818,3296,7114
NAIROBI,KASARANI,44,3023,2641,5664
NAIROBI,KASARANI,40-44,22623,18840,41463
NAIROBI,KASARANI,45,4271,3520,7791
NAIROBI,KASARANI,46,3035,2375,5410
NAIROBI,KASARANI,47,3251,2400,5651
NAIROBI,KASARANI,48,2421,1841,4262
NAIROBI,KASARANI,49,2585,1853,4438
NAIROBI,KASARANI,45-49,15563,11989,27552
NAIROBI,KASARANI,50,2874,2279,5153
NAIROBI,KASARANI,51,1996,1428,3424
NAIROBI,KASARANI,52,2177,1506,3683
NAIROBI,KASARANI,53,1522,1134,2656
NAIROBI,KASARANI,54,1744,1259,3003
NAIROBI,KASARANI,50-54,10313,7606,17919
NAIROBI,KASARANI,55,1747,1180,2927
NAIROBI,KASARANI,56,1649,1154,2803
NAIROBI,KASARANI,57,1331,1013,2344
NAIROBI,KASARANI,58,1121,745,1866
NAIROBI,KASARANI,59,1102,796,1898
NAIROBI,KASARANI,55-59,6950,4888,11838
NAIROBI,KASARANI,60,1204,863,2067
NAIROBI,KASARANI,61,739,575,1314
NAIROBI,KASARANI,62,666,482,1148
NAIROBI,KASARANI,63,569,449,1018
NAIROBI,KASARANI,64,423,308,731
NAIROBI,KASARANI,60-64,3601,2677,6278
NAIROBI,KASARANI,65,590,446,1036
NAIROBI,KASARANI,66,362,276,638
NAIROBI,KASARANI,67,507,389,896
NAIROBI,KASARANI,68,244,189,433
NAIROBI,KASARANI,69,303,268,571
NAIROBI,KASARANI,65-69,2006,1568,3574
NAIROBI,KASARANI,70,336,349,685
NAIROBI,KASARANI,71,239,174,413
NAIROBI,KASARANI,72,207,146,353
NAIROBI,KASARANI,73,154,120,274
NAIROBI,KASARANI,74,126,141,267
NAIROBI,KASARANI,70-74,1062,930,1992
NAIROBI,KASARANI,75,82,121,203
NAIROBI,KASARANI,76,91,114,205
NAIROBI,KASARANI,77,75,74,149
NAIROBI,KASARANI,78,47,53,100
NAIROBI,KASARANI,79,52,84,136
NAIROBI,KASARANI,75-79,347,446,793
NAIROBI,KASARANI,80,73,119,192
NAIROBI,KASARANI,81,24,56,80
NAIROBI,KASARANI,82,23,40,63
NAIROBI,KASARANI,83,31,50,81
NAIROBI,KASARANI,84,28,53,81
NAIROBI,KASARANI,80-84,179,318,497
NAIROBI,KASARANI,85,23,36,59
NAIROBI,KASARANI,86,16,25,41
NAIROBI,KASARANI,87,10,35,45
NAIROBI,KASARANI,88,13,14,27
NAIROBI,KASARANI,89,18,41,59
NAIROBI,KASARANI,85-89,80,151,231
NAIROBI,KASARANI,90,5,28,33
NAIROBI,KASARANI,91,14,19,33
NAIROBI,KASARANI,92,8,15,23
NAIROBI,KASARANI,93,5,9,14
NAIROBI,KASARANI,94,2,11,13
NAIROBI,KASARANI,90-94,34,82,116
NAIROBI,KASARANI,95,3,17,20
NAIROBI,KASARANI,96,5,10,15
NAIROBI,KASARANI,97,5,9,14
NAIROBI,KASARANI,98,6,6,12
NAIROBI,KASARANI,99,1,11,12
NAIROBI,KASARANI,95-99,20,53,73
NAIROBI,KASARANI,100+,10,30,40
NAIROBI,KASARANI,Not Stated,10,16,26
NAIROBI,KIBRA,Total,94199,91569,185768
NAIROBI,KIBRA,0,2163,2134,4297
NAIROBI,KIBRA,1,2107,2030,4137
NAIROBI,KIBRA,2,2011,2023,4034
NAIROBI,KIBRA,3,1979,1995,3974
NAIROBI,KIBRA,4,1812,1897,3709
NAIROBI,KIBRA,0 - 4,10072,10079,20151
NAIROBI,KIBRA,5,1791,1801,3592
NAIROBI,KIBRA,6,1860,1858,3718
NAIROBI,KIBRA,7,1885,1836,3721
NAIROBI,KIBRA,8,1785,1876,3661
NAIROBI,KIBRA,9,1861,1944,3805
NAIROBI,KIBRA,05-Sep,9182,9315,18497
NAIROBI,KIBRA,10,1903,1996,3899
NAIROBI,KIBRA,11,1751,1865,3616
NAIROBI,KIBRA,12,1850,2065,3915
NAIROBI,KIBRA,13,1911,2071,3982
NAIROBI,KIBRA,14,1781,1784,3565
NAIROBI,KIBRA,Oct-14,9196,9781,18977
NAIROBI,KIBRA,15,1630,1733,3363
NAIROBI,KIBRA,16,1525,1754,3279
NAIROBI,KIBRA,17,1674,1883,3557
NAIROBI,KIBRA,18,1457,1668,3125
NAIROBI,KIBRA,19,1752,2088,3840
NAIROBI,KIBRA,15-19,8038,9126,17164
NAIROBI,KIBRA,20,1890,2264,4154
NAIROBI,KIBRA,21,1994,2240,4234
NAIROBI,KIBRA,22,2223,2399,4622
NAIROBI,KIBRA,23,2373,2639,5012
NAIROBI,KIBRA,24,2336,2403,4739
NAIROBI,KIBRA,20-24,10816,11945,22761
NAIROBI,KIBRA,25,2448,2347,4795
NAIROBI,KIBRA,26,2017,2176,4193
NAIROBI,KIBRA,27,2049,2270,4319
NAIROBI,KIBRA,28,1820,1797,3617
NAIROBI,KIBRA,29,1793,1871,3664
NAIROBI,KIBRA,25-29,10127,10461,20588
NAIROBI,KIBRA,30,2289,2488,4777
NAIROBI,KIBRA,31,1468,1544,3012
NAIROBI,KIBRA,32,2000,2118,4118
NAIROBI,KIBRA,33,1577,1589,3166
NAIROBI,KIBRA,34,1488,1658,3146
NAIROBI,KIBRA,30-34,8822,9397,18219
NAIROBI,KIBRA,35,1971,1839,3810
NAIROBI,KIBRA,36,1395,1335,2730
NAIROBI,KIBRA,37,1388,1233,2621
NAIROBI,KIBRA,38,1170,1155,2325
NAIROBI,KIBRA,39,1309,1166,2475
NAIROBI,KIBRA,35-39,7233,6728,13961
NAIROBI,KIBRA,40,1661,1413,3074
NAIROBI,KIBRA,41,1358,1137,2495
NAIROBI,KIBRA,42,1232,1093,2325
NAIROBI,KIBRA,43,1183,895,2078
NAIROBI,KIBRA,44,866,739,1605
NAIROBI,KIBRA,40-44,6300,5277,11577
NAIROBI,KIBRA,45,1389,970,2359
NAIROBI,KIBRA,46,1035,732,1767
NAIROBI,KIBRA,47,988,701,1689
NAIROBI,KIBRA,48,756,569,1325
NAIROBI,KIBRA,49,793,532,1325
NAIROBI,KIBRA,45-49,4961,3504,8465
NAIROBI,KIBRA,50,1052,695,1747
NAIROBI,KIBRA,51,736,462,1198
NAIROBI,KIBRA,52,664,408,1072
NAIROBI,KIBRA,53,547,336,883
NAIROBI,KIBRA,54,660,382,1042
NAIROBI,KIBRA,50-54,3659,2283,5942
NAIROBI,KIBRA,55,673,330,1003
NAIROBI,KIBRA,56,592,399,991
NAIROBI,KIBRA,57,570,363,933
NAIROBI,KIBRA,58,415,245,660
NAIROBI,KIBRA,59,429,254,683
NAIROBI,KIBRA,55-59,2679,1591,4270
NAIROBI,KIBRA,60,533,298,831
NAIROBI,KIBRA,61,341,190,531
NAIROBI,KIBRA,62,307,155,462
NAIROBI,KIBRA,63,250,159,409
NAIROBI,KIBRA,64,177,128,305
NAIROBI,KIBRA,60-64,1608,930,2538
NAIROBI,KIBRA,65,247,137,384
NAIROBI,KIBRA,66,129,113,242
NAIROBI,KIBRA,67,200,130,330
NAIROBI,KIBRA,68,107,73,180
NAIROBI,KIBRA,69,133,92,225
NAIROBI,KIBRA,65-69,816,545,1361
NAIROBI,KIBRA,70,133,110,243
NAIROBI,KIBRA,71,82,60,142
NAIROBI,KIBRA,72,75,48,123
NAIROBI,KIBRA,73,62,60,122
NAIROBI,KIBRA,74,52,51,103
NAIROBI,KIBRA,70-74,404,329,733
NAIROBI,KIBRA,75,52,44,96
NAIROBI,KIBRA,76,42,33,75
NAIROBI,KIBRA,77,24,30,54
NAIROBI,KIBRA,78,21,12,33
NAIROBI,KIBRA,79,21,23,44
NAIROBI,KIBRA,75-79,160,142,302
NAIROBI,KIBRA,80,22,20,42
NAIROBI,KIBRA,81,14,15,29
NAIROBI,KIBRA,82,18,12,30
NAIROBI,KIBRA,83,18,3,21
NAIROBI,KIBRA,84,9,14,23
NAIROBI,KIBRA,80-84,81,64,145
NAIROBI,KIBRA,85,7,5,12
NAIROBI,KIBRA,86,7,11,18
NAIROBI,KIBRA,87,3,4,7
NAIROBI,KIBRA,88,4,3,7
NAIROBI,KIBRA,89,6,9,15
NAIROBI,KIBRA,85-89,27,32,59
NAIROBI,KIBRA,90,3,3,6
NAIROBI,KIBRA,91,1,4,5
NAIROBI,KIBRA,92,2,3,5
NAIROBI,KIBRA,93,2,5,7
NAIROBI,KIBRA,94,4,1,5
NAIROBI,KIBRA,90-94,12,16,28
NAIROBI,KIBRA,95,1,3,4
NAIROBI,KIBRA,96,2,-,2
NAIROBI,KIBRA,97,-,-,-
NAIROBI,KIBRA,98,-,1,1
NAIROBI,KIBRA,99,-,5,5
NAIROBI,KIBRA,95-99,3,9,12
NAIROBI,KIBRA,100+,-,11,11
NAIROBI,KIBRA,Not Stated,3,4,7
NAIROBI,LANG'ATA,Total,96698,100774,197472
NAIROBI,LANG'ATA,0,1828,1707,3535
NAIROBI,LANG'ATA,1,1857,1827,3684
NAIROBI,LANG'ATA,2,1822,1777,3599
NAIROBI,LANG'ATA,3,1796,1847,3643
NAIROBI,LANG'ATA,4,1759,1695,3454
NAIROBI,LANG'ATA,0 - 4,9062,8853,17915
NAIROBI,LANG'ATA,5,1765,1743,3508
NAIROBI,LANG'ATA,6,1735,1667,3402
NAIROBI,LANG'ATA,7,1769,1687,3456
NAIROBI,LANG'ATA,8,1705,1652,3357
NAIROBI,LANG'ATA,9,1728,1729,3457
NAIROBI,LANG'ATA,05-Sep,8702,8478,17180
NAIROBI,LANG'ATA,10,1659,1650,3309
NAIROBI,LANG'ATA,11,1552,1617,3169
NAIROBI,LANG'ATA,12,1608,1632,3240
NAIROBI,LANG'ATA,13,1528,1701,3229
NAIROBI,LANG'ATA,14,1558,1618,3176
NAIROBI,LANG'ATA,Oct-14,7905,8218,16123
NAIROBI,LANG'ATA,15,1391,1573,2964
NAIROBI,LANG'ATA,16,1482,1720,3202
NAIROBI,LANG'ATA,17,1512,1683,3195
NAIROBI,LANG'ATA,18,1470,1836,3306
NAIROBI,LANG'ATA,19,1792,2303,4095
NAIROBI,LANG'ATA,15-19,7647,9115,16762
NAIROBI,LANG'ATA,20,1986,2541,4527
NAIROBI,LANG'ATA,21,2121,2652,4773
NAIROBI,LANG'ATA,22,2157,2700,4857
NAIROBI,LANG'ATA,23,2447,2878,5325
NAIROBI,LANG'ATA,24,2492,2681,5173
NAIROBI,LANG'ATA,20-24,11203,13452,24655
NAIROBI,LANG'ATA,25,2452,2680,5132
NAIROBI,LANG'ATA,26,2095,2440,4535
NAIROBI,LANG'ATA,27,2122,2318,4440
NAIROBI,LANG'ATA,28,1943,2077,4020
NAIROBI,LANG'ATA,29,1940,2226,4166
NAIROBI,LANG'ATA,25-29,10552,11741,22293
NAIROBI,LANG'ATA,30,2205,2604,4809
NAIROBI,LANG'ATA,31,1676,1867,3543
NAIROBI,LANG'ATA,32,2021,2295,4316
NAIROBI,LANG'ATA,33,1740,1890,3630
NAIROBI,LANG'ATA,34,1642,1790,3432
NAIROBI,LANG'ATA,30-34,9284,10446,19730
NAIROBI,LANG'ATA,35,1906,2089,3995
NAIROBI,LANG'ATA,36,1508,1594,3102
NAIROBI,LANG'ATA,37,1515,1534,3049
NAIROBI,LANG'ATA,38,1338,1502,2840
NAIROBI,LANG'ATA,39,1384,1517,2901
NAIROBI,LANG'ATA,35-39,7651,8236,15887
NAIROBI,LANG'ATA,40,1573,1750,3323
NAIROBI,LANG'ATA,41,1413,1310,2723
NAIROBI,LANG'ATA,42,1389,1379,2768
NAIROBI,LANG'ATA,43,1189,1248,2437
NAIROBI,LANG'ATA,44,1051,1028,2079
NAIROBI,LANG'ATA,40-44,6615,6715,13330
NAIROBI,LANG'ATA,45,1449,1323,2772
NAIROBI,LANG'ATA,46,1073,976,2049
NAIROBI,LANG'ATA,47,1151,997,2148
NAIROBI,LANG'ATA,48,925,789,1714
NAIROBI,LANG'ATA,49,1030,826,1856
NAIROBI,LANG'ATA,45-49,5628,4911,10539
NAIROBI,LANG'ATA,50,1171,967,2138
NAIROBI,LANG'ATA,51,777,656,1433
NAIROBI,LANG'ATA,52,895,658,1553
NAIROBI,LANG'ATA,53,689,595,1284
NAIROBI,LANG'ATA,54,709,602,1311
NAIROBI,LANG'ATA,50-54,4241,3478,7719
NAIROBI,LANG'ATA,55,723,520,1243
NAIROBI,LANG'ATA,56,722,582,1304
NAIROBI,LANG'ATA,57,678,509,1187
NAIROBI,LANG'ATA,58,593,445,1038
NAIROBI,LANG'ATA,59,614,476,1090
NAIROBI,LANG'ATA,55-59,3330,2532,5862
NAIROBI,LANG'ATA,60,539,536,1075
NAIROBI,LANG'ATA,61,383,339,722
NAIROBI,LANG'ATA,62,402,362,764
NAIROBI,LANG'ATA,63,323,342,665
NAIROBI,LANG'ATA,64,277,249,526
NAIROBI,LANG'ATA,60-64,1924,1828,3752
NAIROBI,LANG'ATA,65,327,281,608
NAIROBI,LANG'ATA,66,258,230,488
NAIROBI,LANG'ATA,67,324,234,558
NAIROBI,LANG'ATA,68,196,185,381
NAIROBI,LANG'ATA,69,230,222,452
NAIROBI,LANG'ATA,65-69,1335,1152,2487
NAIROBI,LANG'ATA,70,240,247,487
NAIROBI,LANG'ATA,71,189,173,362
NAIROBI,LANG'ATA,72,164,137,301
NAIROBI,LANG'ATA,73,133,125,258
NAIROBI,LANG'ATA,74,123,113,236
NAIROBI,LANG'ATA,70-74,849,795,1644
NAIROBI,LANG'ATA,75,108,112,220
NAIROBI,LANG'ATA,76,99,86,185
NAIROBI,LANG'ATA,77,76,97,173
NAIROBI,LANG'ATA,78,63,63,126
NAIROBI,LANG'ATA,79,71,49,120
NAIROBI,LANG'ATA,75-79,417,407,824
NAIROBI,LANG'ATA,80,62,84,146
NAIROBI,LANG'ATA,81,37,42,79
NAIROBI,LANG'ATA,82,47,51,98
NAIROBI,LANG'ATA,83,43,37,80
NAIROBI,LANG'ATA,84,35,33,68
NAIROBI,LANG'ATA,80-84,224,247,471
NAIROBI,LANG'ATA,85,23,23,46
NAIROBI,LANG'ATA,86,17,19,36
NAIROBI,LANG'ATA,87,12,19,31
NAIROBI,LANG'ATA,88,12,12,24
NAIROBI,LANG'ATA,89,8,18,26
NAIROBI,LANG'ATA,85-89,72,91,163
NAIROBI,LANG'ATA,90,14,15,29
NAIROBI,LANG'ATA,91,9,13,22
NAIROBI,LANG'ATA,92,4,7,11
NAIROBI,LANG'ATA,93,4,5,9
NAIROBI,LANG'ATA,94,4,4,8
NAIROBI,LANG'ATA,90-94,35,44,79
NAIROBI,LANG'ATA,95,3,2,5
NAIROBI,LANG'ATA,96,5,7,12
NAIROBI,LANG'ATA,97,3,3,6
NAIROBI,LANG'ATA,98,1,3,4
NAIROBI,LANG'ATA,99,2,4,6
NAIROBI,LANG'ATA,95-99,14,19,33
NAIROBI,LANG'ATA,100+,3,15,18
NAIROBI,LANG'ATA,Not Stated,5,1,6
NAIROBI,MAKADARA,Total,96369,93157,189526
NAIROBI,MAKADARA,0,2255,2044,4299
NAIROBI,MAKADARA,1,2203,2019,4222
NAIROBI,MAKADARA,2,2078,1932,4010
NAIROBI,MAKADARA,3,2010,1986,3996
NAIROBI,MAKADARA,4,1869,1852,3721
NAIROBI,MAKADARA,0 - 4,10415,9833,20248
NAIROBI,MAKADARA,5,1717,1747,3464
NAIROBI,MAKADARA,6,1724,1680,3404
NAIROBI,MAKADARA,7,1612,1753,3365
NAIROBI,MAKADARA,8,1617,1641,3258
NAIROBI,MAKADARA,9,1644,1722,3366
NAIROBI,MAKADARA,05-Sep,8314,8543,16857
NAIROBI,MAKADARA,10,1656,1633,3289
NAIROBI,MAKADARA,11,1461,1485,2946
NAIROBI,MAKADARA,12,1572,1600,3172
NAIROBI,MAKADARA,13,1565,1595,3160
NAIROBI,MAKADARA,14,1435,1464,2899
NAIROBI,MAKADARA,Oct-14,7689,7777,15466
NAIROBI,MAKADARA,15,1262,1440,2702
NAIROBI,MAKADARA,16,1281,1465,2746
NAIROBI,MAKADARA,17,1330,1529,2859
NAIROBI,MAKADARA,18,1222,1547,2769
NAIROBI,MAKADARA,19,1609,2033,3642
NAIROBI,MAKADARA,15-19,6704,8014,14718
NAIROBI,MAKADARA,20,1843,2435,4278
NAIROBI,MAKADARA,21,2077,2546,4623
NAIROBI,MAKADARA,22,2416,2635,5051
NAIROBI,MAKADARA,23,2762,3023,5785
NAIROBI,MAKADARA,24,2716,2767,5483
NAIROBI,MAKADARA,20-24,11814,13406,25220
NAIROBI,MAKADARA,25,2876,2983,5859
NAIROBI,MAKADARA,26,2512,2601,5113
NAIROBI,MAKADARA,27,2414,2418,4832
NAIROBI,MAKADARA,28,2103,2168,4271
NAIROBI,MAKADARA,29,2315,2273,4588
NAIROBI,MAKADARA,25-29,12220,12443,24663
NAIROBI,MAKADARA,30,2688,2625,5313
NAIROBI,MAKADARA,31,1791,1779,3570
NAIROBI,MAKADARA,32,2356,2319,4675
NAIROBI,MAKADARA,33,1814,1839,3653
NAIROBI,MAKADARA,34,1746,1697,3443
NAIROBI,MAKADARA,30-34,10395,10259,20654
NAIROBI,MAKADARA,35,2171,1910,4081
NAIROBI,MAKADARA,36,1595,1486,3081
NAIROBI,MAKADARA,37,1586,1392,2978
NAIROBI,MAKADARA,38,1354,1259,2613
NAIROBI,MAKADARA,39,1440,1245,2685
NAIROBI,MAKADARA,35-39,8146,7292,15438
NAIROBI,MAKADARA,40,1735,1395,3130
NAIROBI,MAKADARA,41,1473,1146,2619
NAIROBI,MAKADARA,42,1367,1097,2464
NAIROBI,MAKADARA,43,1168,921,2089
NAIROBI,MAKADARA,44,998,814,1812
NAIROBI,MAKADARA,40-44,6741,5373,12114
NAIROBI,MAKADARA,45,1443,1015,2458
NAIROBI,MAKADARA,46,988,762,1750
NAIROBI,MAKADARA,47,1052,699,1751
NAIROBI,MAKADARA,48,802,594,1396
NAIROBI,MAKADARA,49,849,637,1486
NAIROBI,MAKADARA,45-49,5134,3707,8841
NAIROBI,MAKADARA,50,971,715,1686
NAIROBI,MAKADARA,51,649,477,1126
NAIROBI,MAKADARA,52,712,489,1201
NAIROBI,MAKADARA,53,510,356,866
NAIROBI,MAKADARA,54,587,376,963
NAIROBI,MAKADARA,50-54,3429,2413,5842
NAIROBI,MAKADARA,55,562,387,949
NAIROBI,MAKADARA,56,521,394,915
NAIROBI,MAKADARA,57,510,340,850
NAIROBI,MAKADARA,58,396,271,667
NAIROBI,MAKADARA,59,434,249,683
NAIROBI,MAKADARA,55-59,2423,1641,4064
NAIROBI,MAKADARA,60,425,306,731
NAIROBI,MAKADARA,61,255,214,469
NAIROBI,MAKADARA,62,229,169,398
NAIROBI,MAKADARA,63,196,149,345
NAIROBI,MAKADARA,64,161,117,278
NAIROBI,MAKADARA,60-64,1266,955,2221
NAIROBI,MAKADARA,65,206,177,383
NAIROBI,MAKADARA,66,148,112,260
NAIROBI,MAKADARA,67,214,167,381
NAIROBI,MAKADARA,68,112,94,206
NAIROBI,MAKADARA,69,127,123,250
NAIROBI,MAKADARA,65-69,807,673,1480
NAIROBI,MAKADARA,70,177,143,320
NAIROBI,MAKADARA,71,118,76,194
NAIROBI,MAKADARA,72,105,72,177
NAIROBI,MAKADARA,73,76,60,136
NAIROBI,MAKADARA,74,58,64,122
NAIROBI,MAKADARA,70-74,534,415,949
NAIROBI,MAKADARA,75,59,44,103
NAIROBI,MAKADARA,76,43,49,92
NAIROBI,MAKADARA,77,38,35,73
NAIROBI,MAKADARA,78,25,28,53
NAIROBI,MAKADARA,79,29,39,68
NAIROBI,MAKADARA,75-79,194,195,389
NAIROBI,MAKADARA,80,33,46,79
NAIROBI,MAKADARA,81,13,14,27
NAIROBI,MAKADARA,82,15,22,37
NAIROBI,MAKADARA,83,14,15,29
NAIROBI,MAKADARA,84,15,11,26
NAIROBI,MAKADARA,80-84,90,108,198
NAIROBI,MAKADARA,85,8,18,26
NAIROBI,MAKADARA,86,9,13,22
NAIROBI,MAKADARA,87,8,10,18
NAIROBI,MAKADARA,88,5,5,10
NAIROBI,MAKADARA,89,5,14,19
NAIROBI,MAKADARA,85-89,35,60,95
NAIROBI,MAKADARA,90,6,9,15
NAIROBI,MAKADARA,91,2,5,7
NAIROBI,MAKADARA,92,1,6,7
NAIROBI,MAKADARA,93,1,4,5
NAIROBI,MAKADARA,94,-,4,4
NAIROBI,MAKADARA,90-94,10,28,38
NAIROBI,MAKADARA,95,2,4,6
NAIROBI,MAKADARA,96,2,3,5
NAIROBI,MAKADARA,97,-,2,2
NAIROBI,MAKADARA,98,1,1,2
NAIROBI,MAKADARA,99,-,3,3
NAIROBI,MAKADARA,95-99,5,13,18
NAIROBI,MAKADARA,100+,2,8,10
NAIROBI,MAKADARA,Not Stated,2,1,3
NAIROBI,MATHARE,Total,106522,100028,206550
NAIROBI,MATHARE,0,2621,2810,5431
NAIROBI,MATHARE,1,2747,2703,5450
NAIROBI,MATHARE,2,2551,2451,5002
NAIROBI,MATHARE,3,2444,2522,4966
NAIROBI,MATHARE,4,2233,2275,4508
NAIROBI,MATHARE,0 - 4,12596,12761,25357
NAIROBI,MATHARE,5,2097,2152,4249
NAIROBI,MATHARE,6,2102,2191,4293
NAIROBI,MATHARE,7,2076,2094,4170
NAIROBI,MATHARE,8,2008,1948,3956
NAIROBI,MATHARE,9,2104,2097,4201
NAIROBI,MATHARE,05-Sep,10387,10482,20869
NAIROBI,MATHARE,10,1905,2002,3907
NAIROBI,MATHARE,11,1649,1836,3485
NAIROBI,MATHARE,12,1981,1988,3969
NAIROBI,MATHARE,13,1760,1965,3725
NAIROBI,MATHARE,14,1605,1807,3412
NAIROBI,MATHARE,Oct-14,8900,9598,18498
NAIROBI,MATHARE,15,1538,1684,3222
NAIROBI,MATHARE,16,1496,1595,3091
NAIROBI,MATHARE,17,1644,1847,3491
NAIROBI,MATHARE,18,1514,1799,3313
NAIROBI,MATHARE,19,1910,2187,4097
NAIROBI,MATHARE,15-19,8102,9112,17214
NAIROBI,MATHARE,20,2200,2814,5014
NAIROBI,MATHARE,21,2539,2668,5207
NAIROBI,MATHARE,22,2696,2991,5687
NAIROBI,MATHARE,23,3062,3271,6333
NAIROBI,MATHARE,24,3085,3043,6128
NAIROBI,MATHARE,20-24,13582,14787,28369
NAIROBI,MATHARE,25,3289,3135,6424
NAIROBI,MATHARE,26,2786,2693,5479
NAIROBI,MATHARE,27,2771,2592,5363
NAIROBI,MATHARE,28,2413,2232,4645
NAIROBI,MATHARE,29,2522,2310,4832
NAIROBI,MATHARE,25-29,13781,12962,26743
NAIROBI,MATHARE,30,3079,2945,6024
NAIROBI,MATHARE,31,1978,1807,3785
NAIROBI,MATHARE,32,2693,2480,5173
NAIROBI,MATHARE,33,1968,1857,3825
NAIROBI,MATHARE,34,1859,1665,3524
NAIROBI,MATHARE,30-34,11577,10754,22331
NAIROBI,MATHARE,35,2315,1962,4277
NAIROBI,MATHARE,36,1690,1398,3088
NAIROBI,MATHARE,37,1697,1373,3070
NAIROBI,MATHARE,38,1417,1146,2563
NAIROBI,MATHARE,39,1462,1176,2638
NAIROBI,MATHARE,35-39,8581,7055,15636
NAIROBI,MATHARE,40,1744,1436,3180
NAIROBI,MATHARE,41,1409,1083,2492
NAIROBI,MATHARE,42,1416,1010,2426
NAIROBI,MATHARE,43,1145,833,1978
NAIROBI,MATHARE,44,915,676,1591
NAIROBI,MATHARE,40-44,6629,5038,11667
NAIROBI,MATHARE,45,1379,876,2255
NAIROBI,MATHARE,46,951,618,1569
NAIROBI,MATHARE,47,978,631,1609
NAIROBI,MATHARE,48,744,441,1185
NAIROBI,MATHARE,49,797,456,1253
NAIROBI,MATHARE,45-49,4849,3022,7871
NAIROBI,MATHARE,50,945,587,1532
NAIROBI,MATHARE,51,607,372,979
NAIROBI,MATHARE,52,611,329,940
NAIROBI,MATHARE,53,421,277,698
NAIROBI,MATHARE,54,544,263,807
NAIROBI,MATHARE,50-54,3128,1828,4956
NAIROBI,MATHARE,55,520,267,787
NAIROBI,MATHARE,56,530,281,811
NAIROBI,MATHARE,57,397,241,638
NAIROBI,MATHARE,58,333,160,493
NAIROBI,MATHARE,59,328,211,539
NAIROBI,MATHARE,55-59,2108,1160,3268
NAIROBI,MATHARE,60,362,241,603
NAIROBI,MATHARE,61,261,128,389
NAIROBI,MATHARE,62,197,120,317
NAIROBI,MATHARE,63,183,99,282
NAIROBI,MATHARE,64,141,68,209
NAIROBI,MATHARE,60-64,1144,656,1800
NAIROBI,MATHARE,65,192,120,312
NAIROBI,MATHARE,66,129,58,187
NAIROBI,MATHARE,67,183,101,284
NAIROBI,MATHARE,68,82,43,125
NAIROBI,MATHARE,69,89,68,157
NAIROBI,MATHARE,65-69,675,390,1065
NAIROBI,MATHARE,70,120,93,213
NAIROBI,MATHARE,71,66,44,110
NAIROBI,MATHARE,72,61,27,88
NAIROBI,MATHARE,73,48,20,68
NAIROBI,MATHARE,74,28,22,50
NAIROBI,MATHARE,70-74,323,206,529
NAIROBI,MATHARE,75,22,25,47
NAIROBI,MATHARE,76,26,20,46
NAIROBI,MATHARE,77,17,16,33
NAIROBI,MATHARE,78,14,12,26
NAIROBI,MATHARE,79,14,18,32
NAIROBI,MATHARE,75-79,93,91,184
NAIROBI,MATHARE,80,20,33,53
NAIROBI,MATHARE,81,6,11,17
NAIROBI,MATHARE,82,4,4,8
NAIROBI,MATHARE,83,10,5,15
NAIROBI,MATHARE,84,4,12,16
NAIROBI,MATHARE,80-84,44,65,109
NAIROBI,MATHARE,85,5,7,12
NAIROBI,MATHARE,86,4,7,11
NAIROBI,MATHARE,87,4,4,8
NAIROBI,MATHARE,88,1,4,5
NAIROBI,MATHARE,89,3,8,11
NAIROBI,MATHARE,85-89,17,30,47
NAIROBI,MATHARE,90,2,2,4
NAIROBI,MATHARE,91,-,3,3
NAIROBI,MATHARE,92,-,5,5
NAIROBI,MATHARE,93,-,4,4
NAIROBI,MATHARE,94,1,1,2
NAIROBI,MATHARE,90-94,3,15,18
NAIROBI,MATHARE,95,-,2,2
NAIROBI,MATHARE,96,1,5,6
NAIROBI,MATHARE,97,-,2,2
NAIROBI,MATHARE,98,-,-,-
NAIROBI,MATHARE,99,-,2,2
NAIROBI,MATHARE,95-99,1,11,12
NAIROBI,MATHARE,100+,1,3,4
NAIROBI,MATHARE,Not Stated,1,2,3
NAIROBI,NJIRU,Total,307642,318809,626451
NAIROBI,NJIRU,0,8859,8336,17195
NAIROBI,NJIRU,1,8533,8346,16879
NAIROBI,NJIRU,2,8128,7888,16016
NAIROBI,NJIRU,3,8045,7843,15888
NAIROBI,NJIRU,4,7353,7347,14700
NAIROBI,NJIRU,0 - 4,40918,39760,80678
NAIROBI,NJIRU,5,6984,6981,13965
NAIROBI,NJIRU,6,6781,6942,13723
NAIROBI,NJIRU,7,6970,6977,13947
NAIROBI,NJIRU,8,6468,6816,13284
NAIROBI,NJIRU,9,6823,7066,13889
NAIROBI,NJIRU,05-Sep,34026,34782,68808
NAIROBI,NJIRU,10,6664,6525,13189
NAIROBI,NJIRU,11,5660,5880,11540
NAIROBI,NJIRU,12,6136,6236,12372
NAIROBI,NJIRU,13,5689,6173,11862
NAIROBI,NJIRU,14,5322,5711,11033
NAIROBI,NJIRU,Oct-14,29471,30525,59996
NAIROBI,NJIRU,15,4887,5612,10499
NAIROBI,NJIRU,16,4762,5585,10347
NAIROBI,NJIRU,17,5072,5827,10899
NAIROBI,NJIRU,18,4307,5308,9615
NAIROBI,NJIRU,19,5130,6711,11841
NAIROBI,NJIRU,15-19,24158,29043,53201
NAIROBI,NJIRU,20,5312,7493,12805
NAIROBI,NJIRU,21,5766,7829,13595
NAIROBI,NJIRU,22,6086,8239,14325
NAIROBI,NJIRU,23,6952,9303,16255
NAIROBI,NJIRU,24,7039,9092,16131
NAIROBI,NJIRU,20-24,31155,41956,73111
NAIROBI,NJIRU,25,7724,9147,16871
NAIROBI,NJIRU,26,6825,8191,15016
NAIROBI,NJIRU,27,7202,8031,15233
NAIROBI,NJIRU,28,6348,7180,13528
NAIROBI,NJIRU,29,6865,7530,14395
NAIROBI,NJIRU,25-29,34964,40079,75043
NAIROBI,NJIRU,30,8336,9028,17364
NAIROBI,NJIRU,31,5847,5739,11586
NAIROBI,NJIRU,32,7514,7777,15291
NAIROBI,NJIRU,33,5868,5972,11840
NAIROBI,NJIRU,34,5544,5688,11232
NAIROBI,NJIRU,30-34,33109,34204,67313
NAIROBI,NJIRU,35,6571,6334,12905
NAIROBI,NJIRU,36,4791,4742,9533
NAIROBI,NJIRU,37,4793,4464,9257
NAIROBI,NJIRU,38,4352,4189,8541
NAIROBI,NJIRU,39,4335,4021,8356
NAIROBI,NJIRU,35-39,24842,23750,48592
NAIROBI,NJIRU,40,5255,4565,9820
NAIROBI,NJIRU,41,4053,3475,7528
NAIROBI,NJIRU,42,3971,3315,7286
NAIROBI,NJIRU,43,3419,2900,6319
NAIROBI,NJIRU,44,2689,2479,5168
NAIROBI,NJIRU,40-44,19387,16734,36121
NAIROBI,NJIRU,45,3940,3021,6961
NAIROBI,NJIRU,46,2723,2311,5034
NAIROBI,NJIRU,47,2887,2221,5108
NAIROBI,NJIRU,48,2137,1725,3862
NAIROBI,NJIRU,49,2390,1735,4125
NAIROBI,NJIRU,45-49,14077,11013,25090
NAIROBI,NJIRU,50,2587,2056,4643
NAIROBI,NJIRU,51,1827,1289,3116
NAIROBI,NJIRU,52,1992,1364,3356
NAIROBI,NJIRU,53,1330,1010,2340
NAIROBI,NJIRU,54,1595,1165,2760
NAIROBI,NJIRU,50-54,9331,6884,16215
NAIROBI,NJIRU,55,1472,1003,2475
NAIROBI,NJIRU,56,1409,1061,2470
NAIROBI,NJIRU,57,1177,923,2100
NAIROBI,NJIRU,58,920,713,1633
NAIROBI,NJIRU,59,957,712,1669
NAIROBI,NJIRU,55-59,5935,4412,10347
NAIROBI,NJIRU,60,975,779,1754
NAIROBI,NJIRU,61,706,548,1254
NAIROBI,NJIRU,62,614,395,1009
NAIROBI,NJIRU,63,499,374,873
NAIROBI,NJIRU,64,368,264,632
NAIROBI,NJIRU,60-64,3162,2360,5522
NAIROBI,NJIRU,65,461,373,834
NAIROBI,NJIRU,66,298,242,540
NAIROBI,NJIRU,67,412,365,777
NAIROBI,NJIRU,68,205,168,373
NAIROBI,NJIRU,69,277,244,521
NAIROBI,NJIRU,65-69,1653,1392,3045
NAIROBI,NJIRU,70,284,312,596
NAIROBI,NJIRU,71,186,200,386
NAIROBI,NJIRU,72,188,141,329
NAIROBI,NJIRU,73,116,130,246
NAIROBI,NJIRU,74,102,114,216
NAIROBI,NJIRU,70-74,876,897,1773
NAIROBI,NJIRU,75,76,103,179
NAIROBI,NJIRU,76,92,115,207
NAIROBI,NJIRU,77,67,76,143
NAIROBI,NJIRU,78,42,40,82
NAIROBI,NJIRU,79,45,70,115
NAIROBI,NJIRU,75-79,322,404,726
NAIROBI,NJIRU,80,41,98,139
NAIROBI,NJIRU,81,18,48,66
NAIROBI,NJIRU,82,33,39,72
NAIROBI,NJIRU,83,24,51,75
NAIROBI,NJIRU,84,18,55,73
NAIROBI,NJIRU,80-84,134,291,425
NAIROBI,NJIRU,85,19,26,45
NAIROBI,NJIRU,86,17,37,54
NAIROBI,NJIRU,87,14,27,41
NAIROBI,NJIRU,88,11,13,24
NAIROBI,NJIRU,89,11,48,59
NAIROBI,NJIRU,85-89,72,151,223
NAIROBI,NJIRU,90,4,28,32
NAIROBI,NJIRU,91,7,23,30
NAIROBI,NJIRU,92,3,13,16
NAIROBI,NJIRU,93,5,10,15
NAIROBI,NJIRU,94,4,8,12
NAIROBI,NJIRU,90-94,23,82,105
NAIROBI,NJIRU,95,6,13,19
NAIROBI,NJIRU,96,3,10,13
NAIROBI,NJIRU,97,2,9,11
NAIROBI,NJIRU,98,2,7,9
NAIROBI,NJIRU,99,2,12,14
NAIROBI,NJIRU,95-99,15,51,66
NAIROBI,NJIRU,100+,1,27,28
NAIROBI,NJIRU,Not Stated,11,12,23
NAIROBI,STAREHE,Total,109173,101238,210411
NAIROBI,STAREHE,0,2213,2128,4341
NAIROBI,STAREHE,1,2174,2105,4279
NAIROBI,STAREHE,2,2077,2068,4145
NAIROBI,STAREHE,3,2016,1940,3956
NAIROBI,STAREHE,4,1787,1794,3581
NAIROBI,STAREHE,0 - 4,10267,10035,20302
NAIROBI,STAREHE,5,1857,1750,3607
NAIROBI,STAREHE,6,1724,1757,3481
NAIROBI,STAREHE,7,1707,1657,3364
NAIROBI,STAREHE,8,1637,1620,3257
NAIROBI,STAREHE,9,1666,1804,3470
NAIROBI,STAREHE,05-Sep,8591,8588,17179
NAIROBI,STAREHE,10,1710,1661,3371
NAIROBI,STAREHE,11,1488,1588,3076
NAIROBI,STAREHE,12,1658,1682,3340
NAIROBI,STAREHE,13,1611,1644,3255
NAIROBI,STAREHE,14,1535,1524,3059
NAIROBI,STAREHE,Oct-14,8002,8099,16101
NAIROBI,STAREHE,15,1412,1615,3027
NAIROBI,STAREHE,16,1517,1612,3129
NAIROBI,STAREHE,17,1703,1753,3456
NAIROBI,STAREHE,18,1668,1870,3538
NAIROBI,STAREHE,19,2232,2638,4870
NAIROBI,STAREHE,15-19,8532,9488,18020
NAIROBI,STAREHE,20,2724,3072,5796
NAIROBI,STAREHE,21,3084,3303,6387
NAIROBI,STAREHE,22,3340,3557,6897
NAIROBI,STAREHE,23,3681,3655,7336
NAIROBI,STAREHE,24,3613,3239,6852
NAIROBI,STAREHE,20-24,16442,16826,33268
NAIROBI,STAREHE,25,3670,3314,6984
NAIROBI,STAREHE,26,2952,2779,5731
NAIROBI,STAREHE,27,2960,2668,5628
NAIROBI,STAREHE,28,2534,2453,4987
NAIROBI,STAREHE,29,2582,2270,4852
NAIROBI,STAREHE,25-29,14698,13484,28182
NAIROBI,STAREHE,30,3130,2895,6025
NAIROBI,STAREHE,31,2098,1907,4005
NAIROBI,STAREHE,32,2605,2430,5035
NAIROBI,STAREHE,33,1956,1893,3849
NAIROBI,STAREHE,34,1962,1776,3738
NAIROBI,STAREHE,30-34,11751,10901,22652
NAIROBI,STAREHE,35,2378,2009,4387
NAIROBI,STAREHE,36,1740,1530,3270
NAIROBI,STAREHE,37,1643,1400,3043
NAIROBI,STAREHE,38,1508,1281,2789
NAIROBI,STAREHE,39,1517,1223,2740
NAIROBI,STAREHE,35-39,8786,7443,16229
NAIROBI,STAREHE,40,1913,1376,3289
NAIROBI,STAREHE,41,1480,1086,2566
NAIROBI,STAREHE,42,1469,1094,2563
NAIROBI,STAREHE,43,1157,936,2093
NAIROBI,STAREHE,44,953,793,1746
NAIROBI,STAREHE,40-44,6972,5285,12257
NAIROBI,STAREHE,45,1560,1056,2616
NAIROBI,STAREHE,46,983,745,1728
NAIROBI,STAREHE,47,1000,683,1683
NAIROBI,STAREHE,48,865,570,1435
NAIROBI,STAREHE,49,907,609,1516
NAIROBI,STAREHE,45-49,5315,3663,8978
NAIROBI,STAREHE,50,1044,786,1830
NAIROBI,STAREHE,51,739,485,1224
NAIROBI,STAREHE,52,726,497,1223
NAIROBI,STAREHE,53,549,419,968
NAIROBI,STAREHE,54,677,423,1100
NAIROBI,STAREHE,50-54,3735,2610,6345
NAIROBI,STAREHE,55,612,418,1030
NAIROBI,STAREHE,56,594,421,1015
NAIROBI,STAREHE,57,536,405,941
NAIROBI,STAREHE,58,446,300,746
NAIROBI,STAREHE,59,498,322,820
NAIROBI,STAREHE,55-59,2686,1866,4552
NAIROBI,STAREHE,60,497,399,896
NAIROBI,STAREHE,61,310,209,519
NAIROBI,STAREHE,62,291,208,499
NAIROBI,STAREHE,63,230,187,417
NAIROBI,STAREHE,64,194,171,365
NAIROBI,STAREHE,60-64,1522,1174,2696
NAIROBI,STAREHE,65,287,185,472
NAIROBI,STAREHE,66,154,134,288
NAIROBI,STAREHE,67,223,150,373
NAIROBI,STAREHE,68,135,105,240
NAIROBI,STAREHE,69,139,172,311
NAIROBI,STAREHE,65-69,938,746,1684
NAIROBI,STAREHE,70,161,194,355
NAIROBI,STAREHE,71,98,90,188
NAIROBI,STAREHE,72,98,76,174
NAIROBI,STAREHE,73,81,70,151
NAIROBI,STAREHE,74,74,80,154
NAIROBI,STAREHE,70-74,512,510,1022
NAIROBI,STAREHE,75,59,74,133
NAIROBI,STAREHE,76,61,56,117
NAIROBI,STAREHE,77,48,56,104
NAIROBI,STAREHE,78,27,28,55
NAIROBI,STAREHE,79,33,47,80
NAIROBI,STAREHE,75-79,228,261,489
NAIROBI,STAREHE,80,48,57,105
NAIROBI,STAREHE,81,22,21,43
NAIROBI,STAREHE,82,21,20,41
NAIROBI,STAREHE,83,19,23,42
NAIROBI,STAREHE,84,14,17,31
NAIROBI,STAREHE,80-84,124,138,262
NAIROBI,STAREHE,85,15,20,35
NAIROBI,STAREHE,86,9,11,20
NAIROBI,STAREHE,87,12,18,30
NAIROBI,STAREHE,88,6,10,16
NAIROBI,STAREHE,89,3,8,11
NAIROBI,STAREHE,85-89,45,67,112
NAIROBI,STAREHE,90,7,17,24
NAIROBI,STAREHE,91,2,3,5
NAIROBI,STAREHE,92,1,3,4
NAIROBI,STAREHE,93,1,6,7
NAIROBI,STAREHE,94,-,3,3
NAIROBI,STAREHE,90-94,11,32,43
NAIROBI,STAREHE,95,3,7,10
NAIROBI,STAREHE,96,1,2,3
NAIROBI,STAREHE,97,2,2,4
NAIROBI,STAREHE,98,-,1,1
NAIROBI,STAREHE,99,-,1,1
NAIROBI,STAREHE,95-99,6,13,19
NAIROBI,STAREHE,100+,4,6,10
NAIROBI,STAREHE,Not Stated,6,3,9
NAIROBI,WESTLANDS,Total,153818,155021,308839
NAIROBI,WESTLANDS,0,2978,2940,5918
NAIROBI,WESTLANDS,1,3108,3074,6182
NAIROBI,WESTLANDS,2,2878,2795,5673
NAIROBI,WESTLANDS,3,2798,2853,5651
NAIROBI,WESTLANDS,4,2679,2627,5306
NAIROBI,WESTLANDS,0 - 4,14441,14289,28730
NAIROBI,WESTLANDS,5,2648,2573,5221
NAIROBI,WESTLANDS,6,2517,2641,5158
NAIROBI,WESTLANDS,7,2660,2633,5293
NAIROBI,WESTLANDS,8,2452,2456,4908
NAIROBI,WESTLANDS,9,2608,2627,5235
NAIROBI,WESTLANDS,05-Sep,12885,12930,25815
NAIROBI,WESTLANDS,10,2452,2507,4959
NAIROBI,WESTLANDS,11,2311,2339,4650
NAIROBI,WESTLANDS,12,2310,2448,4758
NAIROBI,WESTLANDS,13,2362,2506,4868
NAIROBI,WESTLANDS,14,2190,2264,4454
NAIROBI,WESTLANDS,Oct-14,11625,12064,23689
NAIROBI,WESTLANDS,15,2104,2132,4236
NAIROBI,WESTLANDS,16,1965,2311,4276
NAIROBI,WESTLANDS,17,2099,2317,4416
NAIROBI,WESTLANDS,18,1887,2187,4074
NAIROBI,WESTLANDS,19,2317,2798,5115
NAIROBI,WESTLANDS,15-19,10372,11745,22117
NAIROBI,WESTLANDS,20,2518,3245,5763
NAIROBI,WESTLANDS,21,2941,3485,6426
NAIROBI,WESTLANDS,22,3144,3600,6744
NAIROBI,WESTLANDS,23,3611,4042,7653
NAIROBI,WESTLANDS,24,3567,3828,7395
NAIROBI,WESTLANDS,20-24,15781,18200,33981
NAIROBI,WESTLANDS,25,3818,3904,7722
NAIROBI,WESTLANDS,26,3442,3650,7092
NAIROBI,WESTLANDS,27,3484,3568,7052
NAIROBI,WESTLANDS,28,3084,3225,6309
NAIROBI,WESTLANDS,29,3348,3464,6812
NAIROBI,WESTLANDS,25-29,17176,17811,34987
NAIROBI,WESTLANDS,30,3726,3924,7650
NAIROBI,WESTLANDS,31,2895,2871,5766
NAIROBI,WESTLANDS,32,3445,3699,7144
NAIROBI,WESTLANDS,33,2825,2980,5805
NAIROBI,WESTLANDS,34,2851,2981,5832
NAIROBI,WESTLANDS,30-34,15742,16455,32197
NAIROBI,WESTLANDS,35,3140,3304,6444
NAIROBI,WESTLANDS,36,2500,2556,5056
NAIROBI,WESTLANDS,37,2467,2421,4888
NAIROBI,WESTLANDS,38,2295,2393,4688
NAIROBI,WESTLANDS,39,2361,2320,4681
NAIROBI,WESTLANDS,35-39,12763,12994,25757
NAIROBI,WESTLANDS,40,2703,2626,5329
NAIROBI,WESTLANDS,41,2241,2124,4365
NAIROBI,WESTLANDS,42,2303,2189,4492
NAIROBI,WESTLANDS,43,2039,2014,4053
NAIROBI,WESTLANDS,44,1858,1747,3605
NAIROBI,WESTLANDS,40-44,11144,10700,21844
NAIROBI,WESTLANDS,45,2347,2122,4469
NAIROBI,WESTLANDS,46,1874,1624,3498
NAIROBI,WESTLANDS,47,1931,1636,3567
NAIROBI,WESTLANDS,48,1544,1361,2905
NAIROBI,WESTLANDS,49,1780,1417,3197
NAIROBI,WESTLANDS,45-49,9476,8160,17636
NAIROBI,WESTLANDS,50,1833,1593,3426
NAIROBI,WESTLANDS,51,1340,1103,2443
NAIROBI,WESTLANDS,52,1408,1191,2599
NAIROBI,WESTLANDS,53,1195,1038,2233
NAIROBI,WESTLANDS,54,1280,1062,2342
NAIROBI,WESTLANDS,50-54,7056,5987,13043
NAIROBI,WESTLANDS,55,1231,998,2229
NAIROBI,WESTLANDS,56,1209,958,2167
NAIROBI,WESTLANDS,57,1141,939,2080
NAIROBI,WESTLANDS,58,980,808,1788
NAIROBI,WESTLANDS,59,1004,785,1789
NAIROBI,WESTLANDS,55-59,5565,4488,10053
NAIROBI,WESTLANDS,60,913,822,1735
NAIROBI,WESTLANDS,61,722,651,1373
NAIROBI,WESTLANDS,62,751,596,1347
NAIROBI,WESTLANDS,63,670,535,1205
NAIROBI,WESTLANDS,64,514,494,1008
NAIROBI,WESTLANDS,60-64,3570,3098,6668
NAIROBI,WESTLANDS,65,653,580,1233
NAIROBI,WESTLANDS,66,474,445,919
NAIROBI,WESTLANDS,67,568,464,1032
NAIROBI,WESTLANDS,68,402,357,759
NAIROBI,WESTLANDS,69,494,367,861
NAIROBI,WESTLANDS,65-69,2591,2213,4804
NAIROBI,WESTLANDS,70,460,436,896
NAIROBI,WESTLANDS,71,359,293,652
NAIROBI,WESTLANDS,72,344,383,727
NAIROBI,WESTLANDS,73,288,285,573
NAIROBI,WESTLANDS,74,287,249,536
NAIROBI,WESTLANDS,70-74,1738,1646,3384
NAIROBI,WESTLANDS,75,235,265,500
NAIROBI,WESTLANDS,76,208,228,436
NAIROBI,WESTLANDS,77,191,191,382
NAIROBI,WESTLANDS,78,150,138,288
NAIROBI,WESTLANDS,79,130,168,298
NAIROBI,WESTLANDS,75-79,914,990,1904
NAIROBI,WESTLANDS,80,159,194,353
NAIROBI,WESTLANDS,81,102,127,229
NAIROBI,WESTLANDS,82,115,142,257
NAIROBI,WESTLANDS,83,106,121,227
NAIROBI,WESTLANDS,84,89,88,177
NAIROBI,WESTLANDS,80-84,571,672,1243
NAIROBI,WESTLANDS,85,87,110,197
NAIROBI,WESTLANDS,86,60,81,141
NAIROBI,WESTLANDS,87,57,81,138
NAIROBI,WESTLANDS,88,42,49,91
NAIROBI,WESTLANDS,89,39,48,87
NAIROBI,WESTLANDS,85-89,285,369,654
NAIROBI,WESTLANDS,90,25,41,66
NAIROBI,WESTLANDS,91,17,23,40
NAIROBI,WESTLANDS,92,21,22,43
NAIROBI,WESTLANDS,93,13,17,30
NAIROBI,WESTLANDS,94,8,21,29
NAIROBI,WESTLANDS,90-94,84,124,208
NAIROBI,WESTLANDS,95,6,19,25
NAIROBI,WESTLANDS,96,6,14,20
NAIROBI,WESTLANDS,97,5,8,13
NAIROBI,WESTLANDS,98,3,8,11
NAIROBI,WESTLANDS,99,9,14,23
NAIROBI,WESTLANDS,95-99,29,63,92
NAIROBI,WESTLANDS,100+,7,16,23
NAIROBI,WESTLANDS,Not Stated,3,7,10
NAKURU,ALL,Total,1077272,1084835,2162107
NAKURU,ALL,0,27196,26886,54082
NAKURU,ALL,1,26974,26476,53450
NAKURU,ALL,2,27336,26854,54190
NAKURU,ALL,3,28270,27946,56216
NAKURU,ALL,4,28241,27152,55393
NAKURU,ALL,0 - 4,138017,135314,273331
NAKURU,ALL,5,26946,25929,52875
NAKURU,ALL,6,26457,26385,52842
NAKURU,ALL,7,27631,26722,54353
NAKURU,ALL,8,25485,25310,50795
NAKURU,ALL,9,28733,27896,56629
NAKURU,ALL,05-Sep,135252,132242,267494
NAKURU,ALL,10,28343,27620,55963
NAKURU,ALL,11,25485,25664,51149
NAKURU,ALL,12,29006,28231,57237
NAKURU,ALL,13,28429,28386,56815
NAKURU,ALL,14,27008,26318,53326
NAKURU,ALL,Oct-14,138271,136219,274490
NAKURU,ALL,15,26199,25490,51689
NAKURU,ALL,16,24407,24099,48506
NAKURU,ALL,17,25189,24070,49259
NAKURU,ALL,18,20105,19523,39628
NAKURU,ALL,19,23380,22996,46376
NAKURU,ALL,15-19,119280,116178,235458
NAKURU,ALL,20,20917,21851,42768
NAKURU,ALL,21,21174,21651,42825
NAKURU,ALL,22,20478,21641,42119
NAKURU,ALL,23,21271,22940,44211
NAKURU,ALL,24,19486,20847,40333
NAKURU,ALL,20-24,103326,108930,212256
NAKURU,ALL,25,20354,21848,42202
NAKURU,ALL,26,16834,19057,35891
NAKURU,ALL,27,18272,19292,37564
NAKURU,ALL,28,14628,16287,30915
NAKURU,ALL,29,16414,17831,34245
NAKURU,ALL,25-29,86502,94315,180817
NAKURU,ALL,30,19939,22209,42148
NAKURU,ALL,31,14157,15241,29398
NAKURU,ALL,32,18360,20169,38529
NAKURU,ALL,33,14845,16588,31433
NAKURU,ALL,34,13978,15291,29269
NAKURU,ALL,30-34,81279,89498,170777
NAKURU,ALL,35,18655,18933,37588
NAKURU,ALL,36,12652,12610,25262
NAKURU,ALL,37,12681,11926,24607
NAKURU,ALL,38,10240,10080,20320
NAKURU,ALL,39,11470,10931,22401
NAKURU,ALL,35-39,65698,64480,130178
NAKURU,ALL,40,13886,12898,26784
NAKURU,ALL,41,13365,11726,25091
NAKURU,ALL,42,11828,10575,22403
NAKURU,ALL,43,9386,9268,18654
NAKURU,ALL,44,7582,7457,15039
NAKURU,ALL,40-44,56047,51924,107971
NAKURU,ALL,45,13045,11829,24874
NAKURU,ALL,46,8451,8174,16625
NAKURU,ALL,47,9619,8858,18477
NAKURU,ALL,48,6647,6325,12972
NAKURU,ALL,49,7856,7428,15284
NAKURU,ALL,45-49,45618,42614,88232
NAKURU,ALL,50,8829,8699,17528
NAKURU,ALL,51,6679,6376,13055
NAKURU,ALL,52,6506,6045,12551
NAKURU,ALL,53,4553,4588,9141
NAKURU,ALL,54,5480,5257,10737
NAKURU,ALL,50-54,32047,30965,63012
NAKURU,ALL,55,5689,5193,10882
NAKURU,ALL,56,5694,5583,11277
NAKURU,ALL,57,4730,5070,9800
NAKURU,ALL,58,4522,5026,9548
NAKURU,ALL,59,4687,4504,9191
NAKURU,ALL,55-59,25322,25376,50698
NAKURU,ALL,60,5111,5131,10242
NAKURU,ALL,61,3595,3740,7335
NAKURU,ALL,62,3207,3118,6325
NAKURU,ALL,63,2781,2840,5621
NAKURU,ALL,64,2087,2230,4317
NAKURU,ALL,60-64,16781,17059,33840
NAKURU,ALL,65,3431,3390,6821
NAKURU,ALL,66,2182,2112,4294
NAKURU,ALL,67,3582,3626,7208
NAKURU,ALL,68,1602,1599,3201
NAKURU,ALL,69,2462,2568,5030
NAKURU,ALL,65-69,13259,13295,26554
NAKURU,ALL,70,2940,3575,6515
NAKURU,ALL,71,2119,2086,4205
NAKURU,ALL,72,1918,1645,3563
NAKURU,ALL,73,1440,1443,2883
NAKURU,ALL,74,1308,1572,2880
NAKURU,ALL,70-74,9725,10321,20046
NAKURU,ALL,75,1164,1674,2838
NAKURU,ALL,76,1226,1937,3163
NAKURU,ALL,77,982,1141,2123
NAKURU,ALL,78,675,788,1463
NAKURU,ALL,79,816,1232,2048
NAKURU,ALL,75-79,4863,6772,11635
NAKURU,ALL,80,952,1504,2456
NAKURU,ALL,81,547,721,1268
NAKURU,ALL,82,560,555,1115
NAKURU,ALL,83,564,660,1224
NAKURU,ALL,84,546,807,1353
NAKURU,ALL,80-84,3169,4247,7416
NAKURU,ALL,85,415,666,1081
NAKURU,ALL,86,283,521,804
NAKURU,ALL,87,343,500,843
NAKURU,ALL,88,216,260,476
NAKURU,ALL,89,373,720,1093
NAKURU,ALL,85-89,1630,2667,4297
NAKURU,ALL,90,209,469,678
NAKURU,ALL,91,179,291,470
NAKURU,ALL,92,101,173,274
NAKURU,ALL,93,86,154,240
NAKURU,ALL,94,66,160,226
NAKURU,ALL,90-94,641,1247,1888
NAKURU,ALL,95,113,235,348
NAKURU,ALL,96,71,122,193
NAKURU,ALL,97,88,129,217
NAKURU,ALL,98,50,77,127
NAKURU,ALL,99,65,170,235
NAKURU,ALL,95-99,387,733,1120
NAKURU,ALL,100+,127,429,556
NAKURU,ALL,Not Stated,31,10,41
NAKURU,GILGIL,Total,92955,92247,185202
NAKURU,GILGIL,0,2235,2266,4501
NAKURU,GILGIL,1,2273,2205,4478
NAKURU,GILGIL,2,2230,2178,4408
NAKURU,GILGIL,3,2235,2243,4478
NAKURU,GILGIL,4,2293,2146,4439
NAKURU,GILGIL,0 - 4,11266,11038,22304
NAKURU,GILGIL,5,2159,2162,4321
NAKURU,GILGIL,6,2184,2224,4408
NAKURU,GILGIL,7,2376,2229,4605
NAKURU,GILGIL,8,2203,2175,4378
NAKURU,GILGIL,9,2491,2249,4740
NAKURU,GILGIL,05-Sep,11413,11039,22452
NAKURU,GILGIL,10,2425,2305,4730
NAKURU,GILGIL,11,2061,2082,4143
NAKURU,GILGIL,12,2392,2353,4745
NAKURU,GILGIL,13,2531,2373,4904
NAKURU,GILGIL,14,2230,2196,4426
NAKURU,GILGIL,Oct-14,11639,11309,22948
NAKURU,GILGIL,15,2209,2153,4362
NAKURU,GILGIL,16,2101,2080,4181
NAKURU,GILGIL,17,2097,2055,4152
NAKURU,GILGIL,18,1857,1754,3611
NAKURU,GILGIL,19,2728,2207,4935
NAKURU,GILGIL,15-19,10992,10249,21241
NAKURU,GILGIL,20,2742,2115,4857
NAKURU,GILGIL,21,2695,1929,4624
NAKURU,GILGIL,22,2288,1867,4155
NAKURU,GILGIL,23,2100,1790,3890
NAKURU,GILGIL,24,1716,1652,3368
NAKURU,GILGIL,20-24,11541,9353,20894
NAKURU,GILGIL,25,1527,1585,3112
NAKURU,GILGIL,26,1235,1459,2694
NAKURU,GILGIL,27,1262,1436,2698
NAKURU,GILGIL,28,1076,1320,2396
NAKURU,GILGIL,29,1220,1384,2604
NAKURU,GILGIL,25-29,6320,7184,13504
NAKURU,GILGIL,30,1487,1833,3320
NAKURU,GILGIL,31,1068,1204,2272
NAKURU,GILGIL,32,1416,1577,2993
NAKURU,GILGIL,33,1138,1324,2462
NAKURU,GILGIL,34,1125,1280,2405
NAKURU,GILGIL,30-34,6234,7218,13452
NAKURU,GILGIL,35,1473,1547,3020
NAKURU,GILGIL,36,1025,1066,2091
NAKURU,GILGIL,37,1026,1001,2027
NAKURU,GILGIL,38,855,870,1725
NAKURU,GILGIL,39,902,966,1868
NAKURU,GILGIL,35-39,5281,5450,10731
NAKURU,GILGIL,40,1096,1070,2166
NAKURU,GILGIL,41,1031,940,1971
NAKURU,GILGIL,42,895,860,1755
NAKURU,GILGIL,43,770,820,1590
NAKURU,GILGIL,44,571,588,1159
NAKURU,GILGIL,40-44,4363,4278,8641
NAKURU,GILGIL,45,980,966,1946
NAKURU,GILGIL,46,676,712,1388
NAKURU,GILGIL,47,830,768,1598
NAKURU,GILGIL,48,592,610,1202
NAKURU,GILGIL,49,628,668,1296
NAKURU,GILGIL,45-49,3706,3724,7430
NAKURU,GILGIL,50,750,831,1581
NAKURU,GILGIL,51,549,561,1110
NAKURU,GILGIL,52,595,605,1200
NAKURU,GILGIL,53,395,463,858
NAKURU,GILGIL,54,485,525,1010
NAKURU,GILGIL,50-54,2774,2985,5759
NAKURU,GILGIL,55,535,563,1098
NAKURU,GILGIL,56,571,555,1126
NAKURU,GILGIL,57,415,483,898
NAKURU,GILGIL,58,372,441,813
NAKURU,GILGIL,59,390,449,839
NAKURU,GILGIL,55-59,2283,2491,4774
NAKURU,GILGIL,60,446,517,963
NAKURU,GILGIL,61,330,392,722
NAKURU,GILGIL,62,339,303,642
NAKURU,GILGIL,63,264,278,542
NAKURU,GILGIL,64,198,238,436
NAKURU,GILGIL,60-64,1577,1728,3305
NAKURU,GILGIL,65,344,324,668
NAKURU,GILGIL,66,229,197,426
NAKURU,GILGIL,67,374,375,749
NAKURU,GILGIL,68,174,150,324
NAKURU,GILGIL,69,262,282,544
NAKURU,GILGIL,65-69,1383,1328,2711
NAKURU,GILGIL,70,300,390,690
NAKURU,GILGIL,71,207,220,427
NAKURU,GILGIL,72,204,179,383
NAKURU,GILGIL,73,170,147,317
NAKURU,GILGIL,74,146,171,317
NAKURU,GILGIL,70-74,1027,1107,2134
NAKURU,GILGIL,75,126,185,311
NAKURU,GILGIL,76,143,212,355
NAKURU,GILGIL,77,93,143,236
NAKURU,GILGIL,78,73,91,164
NAKURU,GILGIL,79,79,159,238
NAKURU,GILGIL,75-79,514,790,1304
NAKURU,GILGIL,80,113,161,274
NAKURU,GILGIL,81,61,75,136
NAKURU,GILGIL,82,49,53,102
NAKURU,GILGIL,83,66,70,136
NAKURU,GILGIL,84,64,73,137
NAKURU,GILGIL,80-84,353,432,785
NAKURU,GILGIL,85,45,58,103
NAKURU,GILGIL,86,30,58,88
NAKURU,GILGIL,87,38,42,80
NAKURU,GILGIL,88,21,32,53
NAKURU,GILGIL,89,45,72,117
NAKURU,GILGIL,85-89,179,262,441
NAKURU,GILGIL,90,21,53,74
NAKURU,GILGIL,91,15,29,44
NAKURU,GILGIL,92,7,25,32
NAKURU,GILGIL,93,6,23,29
NAKURU,GILGIL,94,3,16,19
NAKURU,GILGIL,90-94,52,146,198
NAKURU,GILGIL,95,14,28,42
NAKURU,GILGIL,96,5,10,15
NAKURU,GILGIL,97,14,11,25
NAKURU,GILGIL,98,6,10,16
NAKURU,GILGIL,99,5,20,25
NAKURU,GILGIL,95-99,44,79,123
NAKURU,GILGIL,100+,8,54,62
NAKURU,GILGIL,Not Stated,6,3,9
NAKURU,KURESOI NORTH,Total,87472,87599,175071
NAKURU,KURESOI NORTH,0,2148,2119,4267
NAKURU,KURESOI NORTH,1,2244,2246,4490
NAKURU,KURESOI NORTH,2,2398,2335,4733
NAKURU,KURESOI NORTH,3,2655,2527,5182
NAKURU,KURESOI NORTH,4,2753,2600,5353
NAKURU,KURESOI NORTH,0 - 4,12198,11827,24025
NAKURU,KURESOI NORTH,5,2575,2534,5109
NAKURU,KURESOI NORTH,6,2622,2573,5195
NAKURU,KURESOI NORTH,7,2586,2653,5239
NAKURU,KURESOI NORTH,8,2363,2415,4778
NAKURU,KURESOI NORTH,9,2998,2907,5905
NAKURU,KURESOI NORTH,05-Sep,13144,13082,26226
NAKURU,KURESOI NORTH,10,2746,2713,5459
NAKURU,KURESOI NORTH,11,2502,2518,5020
NAKURU,KURESOI NORTH,12,2961,2815,5776
NAKURU,KURESOI NORTH,13,2763,2720,5483
NAKURU,KURESOI NORTH,14,2733,2564,5297
NAKURU,KURESOI NORTH,Oct-14,13705,13330,27035
NAKURU,KURESOI NORTH,15,2629,2493,5122
NAKURU,KURESOI NORTH,16,2374,2141,4515
NAKURU,KURESOI NORTH,17,2293,2029,4322
NAKURU,KURESOI NORTH,18,1749,1513,3262
NAKURU,KURESOI NORTH,19,1899,1888,3787
NAKURU,KURESOI NORTH,15-19,10944,10064,21008
NAKURU,KURESOI NORTH,20,1467,1577,3044
NAKURU,KURESOI NORTH,21,1421,1553,2974
NAKURU,KURESOI NORTH,22,1349,1460,2809
NAKURU,KURESOI NORTH,23,1357,1453,2810
NAKURU,KURESOI NORTH,24,1216,1313,2529
NAKURU,KURESOI NORTH,20-24,6810,7356,14166
NAKURU,KURESOI NORTH,25,1411,1568,2979
NAKURU,KURESOI NORTH,26,1070,1214,2284
NAKURU,KURESOI NORTH,27,1310,1486,2796
NAKURU,KURESOI NORTH,28,847,953,1800
NAKURU,KURESOI NORTH,29,989,1139,2128
NAKURU,KURESOI NORTH,25-29,5627,6360,11987
NAKURU,KURESOI NORTH,30,1238,1473,2711
NAKURU,KURESOI NORTH,31,979,1153,2132
NAKURU,KURESOI NORTH,32,1142,1424,2566
NAKURU,KURESOI NORTH,33,1045,1167,2212
NAKURU,KURESOI NORTH,34,903,1048,1951
NAKURU,KURESOI NORTH,30-34,5307,6265,11572
NAKURU,KURESOI NORTH,35,1251,1322,2573
NAKURU,KURESOI NORTH,36,794,695,1489
NAKURU,KURESOI NORTH,37,841,784,1625
NAKURU,KURESOI NORTH,38,563,524,1087
NAKURU,KURESOI NORTH,39,737,632,1369
NAKURU,KURESOI NORTH,35-39,4186,3957,8143
NAKURU,KURESOI NORTH,40,869,769,1638
NAKURU,KURESOI NORTH,41,1016,905,1921
NAKURU,KURESOI NORTH,42,794,770,1564
NAKURU,KURESOI NORTH,43,568,621,1189
NAKURU,KURESOI NORTH,44,482,516,998
NAKURU,KURESOI NORTH,40-44,3729,3581,7310
NAKURU,KURESOI NORTH,45,1078,944,2022
NAKURU,KURESOI NORTH,46,606,619,1225
NAKURU,KURESOI NORTH,47,721,720,1441
NAKURU,KURESOI NORTH,48,429,421,850
NAKURU,KURESOI NORTH,49,589,608,1197
NAKURU,KURESOI NORTH,45-49,3423,3312,6735
NAKURU,KURESOI NORTH,50,612,651,1263
NAKURU,KURESOI NORTH,51,540,485,1025
NAKURU,KURESOI NORTH,52,426,377,803
NAKURU,KURESOI NORTH,53,308,317,625
NAKURU,KURESOI NORTH,54,385,287,672
NAKURU,KURESOI NORTH,50-54,2271,2117,4388
NAKURU,KURESOI NORTH,55,379,353,732
NAKURU,KURESOI NORTH,56,365,398,763
NAKURU,KURESOI NORTH,57,352,396,748
NAKURU,KURESOI NORTH,58,407,520,927
NAKURU,KURESOI NORTH,59,375,341,716
NAKURU,KURESOI NORTH,55-59,1878,2008,3886
NAKURU,KURESOI NORTH,60,407,417,824
NAKURU,KURESOI NORTH,61,337,357,694
NAKURU,KURESOI NORTH,62,240,234,474
NAKURU,KURESOI NORTH,63,226,232,458
NAKURU,KURESOI NORTH,64,164,179,343
NAKURU,KURESOI NORTH,60-64,1374,1419,2793
NAKURU,KURESOI NORTH,65,289,288,577
NAKURU,KURESOI NORTH,66,179,144,323
NAKURU,KURESOI NORTH,67,331,284,615
NAKURU,KURESOI NORTH,68,132,119,251
NAKURU,KURESOI NORTH,69,209,204,413
NAKURU,KURESOI NORTH,65-69,1140,1039,2179
NAKURU,KURESOI NORTH,70,250,277,527
NAKURU,KURESOI NORTH,71,193,173,366
NAKURU,KURESOI NORTH,72,175,123,298
NAKURU,KURESOI NORTH,73,128,96,224
NAKURU,KURESOI NORTH,74,103,105,208
NAKURU,KURESOI NORTH,70-74,849,774,1623
NAKURU,KURESOI NORTH,75,91,115,206
NAKURU,KURESOI NORTH,76,100,95,195
NAKURU,KURESOI NORTH,77,100,78,178
NAKURU,KURESOI NORTH,78,65,58,123
NAKURU,KURESOI NORTH,79,79,94,173
NAKURU,KURESOI NORTH,75-79,435,440,875
NAKURU,KURESOI NORTH,80,64,111,175
NAKURU,KURESOI NORTH,81,45,57,102
NAKURU,KURESOI NORTH,82,40,37,77
NAKURU,KURESOI NORTH,83,48,45,93
NAKURU,KURESOI NORTH,84,37,54,91
NAKURU,KURESOI NORTH,80-84,234,304,538
NAKURU,KURESOI NORTH,85,25,41,66
NAKURU,KURESOI NORTH,86,17,26,43
NAKURU,KURESOI NORTH,87,32,42,74
NAKURU,KURESOI NORTH,88,11,27,38
NAKURU,KURESOI NORTH,89,30,70,100
NAKURU,KURESOI NORTH,85-89,115,206,321
NAKURU,KURESOI NORTH,90,18,32,50
NAKURU,KURESOI NORTH,91,19,18,37
NAKURU,KURESOI NORTH,92,8,9,17
NAKURU,KURESOI NORTH,93,4,14,18
NAKURU,KURESOI NORTH,94,9,11,20
NAKURU,KURESOI NORTH,90-94,58,84,142
NAKURU,KURESOI NORTH,95,13,13,26
NAKURU,KURESOI NORTH,96,4,9,13
NAKURU,KURESOI NORTH,97,8,5,13
NAKURU,KURESOI NORTH,98,4,7,11
NAKURU,KURESOI NORTH,99,8,14,22
NAKURU,KURESOI NORTH,95-99,37,48,85
NAKURU,KURESOI NORTH,100+,7,25,32
NAKURU,KURESOI NORTH,Not Stated,1,1,2
NAKURU,KURESOI SOUTH,Total,78204,77117,155321
NAKURU,KURESOI SOUTH,0,1979,1897,3876
NAKURU,KURESOI SOUTH,1,2080,2050,4130
NAKURU,KURESOI SOUTH,2,2235,2146,4381
NAKURU,KURESOI SOUTH,3,2339,2240,4579
NAKURU,KURESOI SOUTH,4,2349,2375,4724
NAKURU,KURESOI SOUTH,0 - 4,10982,10708,21690
NAKURU,KURESOI SOUTH,5,2444,2237,4681
NAKURU,KURESOI SOUTH,6,2301,2264,4565
NAKURU,KURESOI SOUTH,7,2507,2388,4895
NAKURU,KURESOI SOUTH,8,2059,2033,4092
NAKURU,KURESOI SOUTH,9,2562,2556,5118
NAKURU,KURESOI SOUTH,05-Sep,11873,11478,23351
NAKURU,KURESOI SOUTH,10,2530,2384,4914
NAKURU,KURESOI SOUTH,11,2330,2303,4633
NAKURU,KURESOI SOUTH,12,2651,2455,5106
NAKURU,KURESOI SOUTH,13,2350,2428,4778
NAKURU,KURESOI SOUTH,14,2282,2214,4496
NAKURU,KURESOI SOUTH,Oct-14,12143,11784,23927
NAKURU,KURESOI SOUTH,15,2348,2160,4508
NAKURU,KURESOI SOUTH,16,1903,1840,3743
NAKURU,KURESOI SOUTH,17,1968,1658,3626
NAKURU,KURESOI SOUTH,18,1463,1297,2760
NAKURU,KURESOI SOUTH,19,1726,1816,3542
NAKURU,KURESOI SOUTH,15-19,9408,8771,18179
NAKURU,KURESOI SOUTH,20,1365,1435,2800
NAKURU,KURESOI SOUTH,21,1316,1511,2827
NAKURU,KURESOI SOUTH,22,1263,1402,2665
NAKURU,KURESOI SOUTH,23,1269,1583,2852
NAKURU,KURESOI SOUTH,24,1108,1287,2395
NAKURU,KURESOI SOUTH,20-24,6321,7218,13539
NAKURU,KURESOI SOUTH,25,1366,1371,2737
NAKURU,KURESOI SOUTH,26,1036,1117,2153
NAKURU,KURESOI SOUTH,27,1215,1293,2508
NAKURU,KURESOI SOUTH,28,767,890,1657
NAKURU,KURESOI SOUTH,29,938,1102,2040
NAKURU,KURESOI SOUTH,25-29,5322,5773,11095
NAKURU,KURESOI SOUTH,30,1136,1390,2526
NAKURU,KURESOI SOUTH,31,914,1028,1942
NAKURU,KURESOI SOUTH,32,1104,1210,2314
NAKURU,KURESOI SOUTH,33,1037,1096,2133
NAKURU,KURESOI SOUTH,34,898,967,1865
NAKURU,KURESOI SOUTH,30-34,5089,5691,10780
NAKURU,KURESOI SOUTH,35,1167,1034,2201
NAKURU,KURESOI SOUTH,36,705,565,1270
NAKURU,KURESOI SOUTH,37,824,662,1486
NAKURU,KURESOI SOUTH,38,411,398,809
NAKURU,KURESOI SOUTH,39,623,491,1114
NAKURU,KURESOI SOUTH,35-39,3730,3150,6880
NAKURU,KURESOI SOUTH,40,825,724,1549
NAKURU,KURESOI SOUTH,41,1052,845,1897
NAKURU,KURESOI SOUTH,42,752,599,1351
NAKURU,KURESOI SOUTH,43,556,588,1144
NAKURU,KURESOI SOUTH,44,404,465,869
NAKURU,KURESOI SOUTH,40-44,3589,3221,6810
NAKURU,KURESOI SOUTH,45,1079,872,1951
NAKURU,KURESOI SOUTH,46,551,495,1046
NAKURU,KURESOI SOUTH,47,579,606,1185
NAKURU,KURESOI SOUTH,48,314,287,601
NAKURU,KURESOI SOUTH,49,476,462,938
NAKURU,KURESOI SOUTH,45-49,2999,2722,5721
NAKURU,KURESOI SOUTH,50,458,413,871
NAKURU,KURESOI SOUTH,51,476,449,925
NAKURU,KURESOI SOUTH,52,294,308,602
NAKURU,KURESOI SOUTH,53,230,205,435
NAKURU,KURESOI SOUTH,54,260,263,523
NAKURU,KURESOI SOUTH,50-54,1718,1638,3356
NAKURU,KURESOI SOUTH,55,230,243,473
NAKURU,KURESOI SOUTH,56,281,270,551
NAKURU,KURESOI SOUTH,57,266,309,575
NAKURU,KURESOI SOUTH,58,395,562,957
NAKURU,KURESOI SOUTH,59,342,280,622
NAKURU,KURESOI SOUTH,55-59,1514,1664,3178
NAKURU,KURESOI SOUTH,60,356,332,688
NAKURU,KURESOI SOUTH,61,240,242,482
NAKURU,KURESOI SOUTH,62,235,199,434
NAKURU,KURESOI SOUTH,63,203,217,420
NAKURU,KURESOI SOUTH,64,141,136,277
NAKURU,KURESOI SOUTH,60-64,1175,1126,2301
NAKURU,KURESOI SOUTH,65,264,260,524
NAKURU,KURESOI SOUTH,66,154,133,287
NAKURU,KURESOI SOUTH,67,290,233,523
NAKURU,KURESOI SOUTH,68,95,93,188
NAKURU,KURESOI SOUTH,69,180,136,316
NAKURU,KURESOI SOUTH,65-69,983,855,1838
NAKURU,KURESOI SOUTH,70,181,196,377
NAKURU,KURESOI SOUTH,71,180,147,327
NAKURU,KURESOI SOUTH,72,122,71,193
NAKURU,KURESOI SOUTH,73,103,60,163
NAKURU,KURESOI SOUTH,74,93,96,189
NAKURU,KURESOI SOUTH,70-74,679,570,1249
NAKURU,KURESOI SOUTH,75,75,85,160
NAKURU,KURESOI SOUTH,76,59,52,111
NAKURU,KURESOI SOUTH,77,92,48,140
NAKURU,KURESOI SOUTH,78,47,36,83
NAKURU,KURESOI SOUTH,79,54,73,127
NAKURU,KURESOI SOUTH,75-79,327,294,621
NAKURU,KURESOI SOUTH,80,47,75,122
NAKURU,KURESOI SOUTH,81,34,36,70
NAKURU,KURESOI SOUTH,82,30,21,51
NAKURU,KURESOI SOUTH,83,29,32,61
NAKURU,KURESOI SOUTH,84,29,41,70
NAKURU,KURESOI SOUTH,80-84,169,205,374
NAKURU,KURESOI SOUTH,85,19,28,47
NAKURU,KURESOI SOUTH,86,29,20,49
NAKURU,KURESOI SOUTH,87,24,21,45
NAKURU,KURESOI SOUTH,88,12,12,24
NAKURU,KURESOI SOUTH,89,29,50,79
NAKURU,KURESOI SOUTH,85-89,113,131,244
NAKURU,KURESOI SOUTH,90,11,26,37
NAKURU,KURESOI SOUTH,91,8,14,22
NAKURU,KURESOI SOUTH,92,6,11,17
NAKURU,KURESOI SOUTH,93,9,3,12
NAKURU,KURESOI SOUTH,94,5,10,15
NAKURU,KURESOI SOUTH,90-94,39,64,103
NAKURU,KURESOI SOUTH,95,8,15,23
NAKURU,KURESOI SOUTH,96,3,5,8
NAKURU,KURESOI SOUTH,97,1,7,8
NAKURU,KURESOI SOUTH,98,3,1,4
NAKURU,KURESOI SOUTH,99,2,8,10
NAKURU,KURESOI SOUTH,95-99,17,36,53
NAKURU,KURESOI SOUTH,100+,14,17,31
NAKURU,KURESOI SOUTH,Not Stated,-,1,1
NAKURU,MOLO,Total,78129,78598,156727
NAKURU,MOLO,0,1857,1952,3809
NAKURU,MOLO,1,1925,1811,3736
NAKURU,MOLO,2,1960,1907,3867
NAKURU,MOLO,3,2102,2095,4197
NAKURU,MOLO,4,2109,2091,4200
NAKURU,MOLO,0 - 4,9953,9856,19809
NAKURU,MOLO,5,2042,2016,4058
NAKURU,MOLO,6,2014,1974,3988
NAKURU,MOLO,7,2078,2045,4123
NAKURU,MOLO,8,1963,1943,3906
NAKURU,MOLO,9,2244,2089,4333
NAKURU,MOLO,05-Sep,10341,10067,20408
NAKURU,MOLO,10,2208,2089,4297
NAKURU,MOLO,11,2010,1989,3999
NAKURU,MOLO,12,2351,2240,4591
NAKURU,MOLO,13,2369,2282,4651
NAKURU,MOLO,14,2169,2046,4215
NAKURU,MOLO,Oct-14,11107,10646,21753
NAKURU,MOLO,15,2107,2043,4150
NAKURU,MOLO,16,2058,2005,4063
NAKURU,MOLO,17,2076,1929,4005
NAKURU,MOLO,18,1600,1460,3060
NAKURU,MOLO,19,1672,1562,3234
NAKURU,MOLO,15-19,9513,8999,18512
NAKURU,MOLO,20,1302,1326,2628
NAKURU,MOLO,21,1264,1313,2577
NAKURU,MOLO,22,1270,1330,2600
NAKURU,MOLO,23,1205,1357,2562
NAKURU,MOLO,24,1174,1227,2401
NAKURU,MOLO,20-24,6215,6553,12768
NAKURU,MOLO,25,1221,1331,2552
NAKURU,MOLO,26,980,1134,2114
NAKURU,MOLO,27,1197,1225,2422
NAKURU,MOLO,28,907,992,1899
NAKURU,MOLO,29,1014,1164,2178
NAKURU,MOLO,25-29,5319,5846,11165
NAKURU,MOLO,30,1236,1438,2674
NAKURU,MOLO,31,890,1016,1906
NAKURU,MOLO,32,1281,1278,2559
NAKURU,MOLO,33,955,1104,2059
NAKURU,MOLO,34,950,1057,2007
NAKURU,MOLO,30-34,5312,5893,11205
NAKURU,MOLO,35,1274,1357,2631
NAKURU,MOLO,36,873,829,1702
NAKURU,MOLO,37,834,826,1660
NAKURU,MOLO,38,650,674,1324
NAKURU,MOLO,39,795,713,1508
NAKURU,MOLO,35-39,4426,4399,8825
NAKURU,MOLO,40,923,854,1777
NAKURU,MOLO,41,960,853,1813
NAKURU,MOLO,42,856,763,1619
NAKURU,MOLO,43,648,671,1319
NAKURU,MOLO,44,536,567,1103
NAKURU,MOLO,40-44,3923,3708,7631
NAKURU,MOLO,45,961,920,1881
NAKURU,MOLO,46,625,625,1250
NAKURU,MOLO,47,727,677,1404
NAKURU,MOLO,48,465,492,957
NAKURU,MOLO,49,616,573,1189
NAKURU,MOLO,45-49,3394,3287,6681
NAKURU,MOLO,50,687,694,1381
NAKURU,MOLO,51,541,523,1064
NAKURU,MOLO,52,447,477,924
NAKURU,MOLO,53,336,345,681
NAKURU,MOLO,54,435,394,829
NAKURU,MOLO,50-54,2446,2433,4879
NAKURU,MOLO,55,465,429,894
NAKURU,MOLO,56,432,421,853
NAKURU,MOLO,57,395,415,810
NAKURU,MOLO,58,381,407,788
NAKURU,MOLO,59,406,381,787
NAKURU,MOLO,55-59,2079,2053,4132
NAKURU,MOLO,60,442,417,859
NAKURU,MOLO,61,265,321,586
NAKURU,MOLO,62,252,255,507
NAKURU,MOLO,63,216,209,425
NAKURU,MOLO,64,172,192,364
NAKURU,MOLO,60-64,1347,1394,2741
NAKURU,MOLO,65,276,275,551
NAKURU,MOLO,66,180,185,365
NAKURU,MOLO,67,311,281,592
NAKURU,MOLO,68,123,148,271
NAKURU,MOLO,69,202,226,428
NAKURU,MOLO,65-69,1092,1115,2207
NAKURU,MOLO,70,239,308,547
NAKURU,MOLO,71,176,183,359
NAKURU,MOLO,72,152,128,280
NAKURU,MOLO,73,107,117,224
NAKURU,MOLO,74,113,140,253
NAKURU,MOLO,70-74,787,876,1663
NAKURU,MOLO,75,90,133,223
NAKURU,MOLO,76,99,195,294
NAKURU,MOLO,77,73,109,182
NAKURU,MOLO,78,57,70,127
NAKURU,MOLO,79,68,96,164
NAKURU,MOLO,75-79,387,603,990
NAKURU,MOLO,80,89,151,240
NAKURU,MOLO,81,43,68,111
NAKURU,MOLO,82,35,58,93
NAKURU,MOLO,83,44,73,117
NAKURU,MOLO,84,49,66,115
NAKURU,MOLO,80-84,260,416,676
NAKURU,MOLO,85,32,60,92
NAKURU,MOLO,86,25,37,62
NAKURU,MOLO,87,29,53,82
NAKURU,MOLO,88,22,22,44
NAKURU,MOLO,89,34,65,99
NAKURU,MOLO,85-89,142,237,379
NAKURU,MOLO,90,16,35,51
NAKURU,MOLO,91,13,42,55
NAKURU,MOLO,92,7,11,18
NAKURU,MOLO,93,8,15,23
NAKURU,MOLO,94,5,11,16
NAKURU,MOLO,90-94,49,114,163
NAKURU,MOLO,95,10,24,34
NAKURU,MOLO,96,3,15,18
NAKURU,MOLO,97,5,8,13
NAKURU,MOLO,98,4,8,12
NAKURU,MOLO,99,4,13,17
NAKURU,MOLO,95-99,26,68,94
NAKURU,MOLO,100+,10,35,45
NAKURU,MOLO,Not Stated,1,-,1
NAKURU,NAIVASHA,Total,179222,176132,355354
NAKURU,NAIVASHA,0,4817,4625,9442
NAKURU,NAIVASHA,1,4358,4181,8539
NAKURU,NAIVASHA,2,4242,4260,8502
NAKURU,NAIVASHA,3,4502,4331,8833
NAKURU,NAIVASHA,4,4230,4150,8380
NAKURU,NAIVASHA,0 - 4,22149,21547,43696
NAKURU,NAIVASHA,5,4027,3892,7919
NAKURU,NAIVASHA,6,4065,3906,7971
NAKURU,NAIVASHA,7,4039,4042,8081
NAKURU,NAIVASHA,8,3787,3827,7614
NAKURU,NAIVASHA,9,4181,4260,8441
NAKURU,NAIVASHA,05-Sep,20099,19927,40026
NAKURU,NAIVASHA,10,4120,4136,8256
NAKURU,NAIVASHA,11,3734,3844,7578
NAKURU,NAIVASHA,12,4114,4025,8139
NAKURU,NAIVASHA,13,4102,4156,8258
NAKURU,NAIVASHA,14,3918,3809,7727
NAKURU,NAIVASHA,Oct-14,19988,19970,39958
NAKURU,NAIVASHA,15,3579,3538,7117
NAKURU,NAIVASHA,16,3280,3443,6723
NAKURU,NAIVASHA,17,3521,3469,6990
NAKURU,NAIVASHA,18,2966,2950,5916
NAKURU,NAIVASHA,19,3615,3713,7328
NAKURU,NAIVASHA,15-19,16961,17113,34074
NAKURU,NAIVASHA,20,3642,3927,7569
NAKURU,NAIVASHA,21,3851,3813,7664
NAKURU,NAIVASHA,22,3807,3958,7765
NAKURU,NAIVASHA,23,4086,4200,8286
NAKURU,NAIVASHA,24,3894,3806,7700
NAKURU,NAIVASHA,20-24,19280,19704,38984
NAKURU,NAIVASHA,25,3888,4127,8015
NAKURU,NAIVASHA,26,3436,3670,7106
NAKURU,NAIVASHA,27,3420,3382,6802
NAKURU,NAIVASHA,28,2970,3022,5992
NAKURU,NAIVASHA,29,3258,3267,6525
NAKURU,NAIVASHA,25-29,16972,17468,34440
NAKURU,NAIVASHA,30,4045,4125,8170
NAKURU,NAIVASHA,31,2686,2707,5393
NAKURU,NAIVASHA,32,3511,3710,7221
NAKURU,NAIVASHA,33,2811,2937,5748
NAKURU,NAIVASHA,34,2642,2684,5326
NAKURU,NAIVASHA,30-34,15695,16163,31858
NAKURU,NAIVASHA,35,3558,3544,7102
NAKURU,NAIVASHA,36,2553,2355,4908
NAKURU,NAIVASHA,37,2461,2230,4691
NAKURU,NAIVASHA,38,2180,2001,4181
NAKURU,NAIVASHA,39,2264,2048,4312
NAKURU,NAIVASHA,35-39,13016,12178,25194
NAKURU,NAIVASHA,40,2760,2383,5143
NAKURU,NAIVASHA,41,2396,2056,4452
NAKURU,NAIVASHA,42,2259,1884,4143
NAKURU,NAIVASHA,43,1748,1590,3338
NAKURU,NAIVASHA,44,1410,1321,2731
NAKURU,NAIVASHA,40-44,10573,9234,19807
NAKURU,NAIVASHA,45,2335,1992,4327
NAKURU,NAIVASHA,46,1605,1370,2975
NAKURU,NAIVASHA,47,1775,1368,3143
NAKURU,NAIVASHA,48,1315,1068,2383
NAKURU,NAIVASHA,49,1371,1120,2491
NAKURU,NAIVASHA,45-49,8401,6918,15319
NAKURU,NAIVASHA,50,1595,1357,2952
NAKURU,NAIVASHA,51,1080,910,1990
NAKURU,NAIVASHA,52,1170,1026,2196
NAKURU,NAIVASHA,53,793,697,1490
NAKURU,NAIVASHA,54,897,812,1709
NAKURU,NAIVASHA,50-54,5535,4802,10337
NAKURU,NAIVASHA,55,940,807,1747
NAKURU,NAIVASHA,56,923,836,1759
NAKURU,NAIVASHA,57,725,671,1396
NAKURU,NAIVASHA,58,599,516,1115
NAKURU,NAIVASHA,59,649,541,1190
NAKURU,NAIVASHA,55-59,3836,3371,7207
NAKURU,NAIVASHA,60,742,693,1435
NAKURU,NAIVASHA,61,497,500,997
NAKURU,NAIVASHA,62,409,413,822
NAKURU,NAIVASHA,63,370,335,705
NAKURU,NAIVASHA,64,246,251,497
NAKURU,NAIVASHA,60-64,2264,2192,4456
NAKURU,NAIVASHA,65,443,402,845
NAKURU,NAIVASHA,66,264,296,560
NAKURU,NAIVASHA,67,442,496,938
NAKURU,NAIVASHA,68,199,229,428
NAKURU,NAIVASHA,69,306,331,637
NAKURU,NAIVASHA,65-69,1654,1754,3408
NAKURU,NAIVASHA,70,413,503,916
NAKURU,NAIVASHA,71,264,280,544
NAKURU,NAIVASHA,72,262,245,507
NAKURU,NAIVASHA,73,184,226,410
NAKURU,NAIVASHA,74,166,216,382
NAKURU,NAIVASHA,70-74,1289,1470,2759
NAKURU,NAIVASHA,75,157,238,395
NAKURU,NAIVASHA,76,172,311,483
NAKURU,NAIVASHA,77,120,144,264
NAKURU,NAIVASHA,78,86,137,223
NAKURU,NAIVASHA,79,116,167,283
NAKURU,NAIVASHA,75-79,651,997,1648
NAKURU,NAIVASHA,80,131,213,344
NAKURU,NAIVASHA,81,79,99,178
NAKURU,NAIVASHA,82,80,78,158
NAKURU,NAIVASHA,83,84,94,178
NAKURU,NAIVASHA,84,77,119,196
NAKURU,NAIVASHA,80-84,451,603,1054
NAKURU,NAIVASHA,85,70,113,183
NAKURU,NAIVASHA,86,32,85,117
NAKURU,NAIVASHA,87,45,78,123
NAKURU,NAIVASHA,88,36,32,68
NAKURU,NAIVASHA,89,47,87,134
NAKURU,NAIVASHA,85-89,230,395,625
NAKURU,NAIVASHA,90,31,72,103
NAKURU,NAIVASHA,91,21,38,59
NAKURU,NAIVASHA,92,17,24,41
NAKURU,NAIVASHA,93,10,17,27
NAKURU,NAIVASHA,94,10,18,28
NAKURU,NAIVASHA,90-94,89,169,258
NAKURU,NAIVASHA,95,18,36,54
NAKURU,NAIVASHA,96,13,14,27
NAKURU,NAIVASHA,97,13,16,29
NAKURU,NAIVASHA,98,7,11,18
NAKURU,NAIVASHA,99,9,32,41
NAKURU,NAIVASHA,95-99,60,109,169
NAKURU,NAIVASHA,100+,18,47,65
NAKURU,NAIVASHA,Not Stated,11,1,12
NAKURU,NAKURU EAST,Total,92956,100960,193916
NAKURU,NAKURU EAST,0,2454,2415,4869
NAKURU,NAKURU EAST,1,2361,2283,4644
NAKURU,NAKURU EAST,2,2346,2337,4683
NAKURU,NAKURU EAST,3,2347,2280,4627
NAKURU,NAKURU EAST,4,2237,2180,4417
NAKURU,NAKURU EAST,0 - 4,11745,11495,23240
NAKURU,NAKURU EAST,5,2041,2009,4050
NAKURU,NAKURU EAST,6,1961,2025,3986
NAKURU,NAKURU EAST,7,2042,1987,4029
NAKURU,NAKURU EAST,8,1951,1990,3941
NAKURU,NAKURU EAST,9,2128,2057,4185
NAKURU,NAKURU EAST,05-Sep,10123,10068,20191
NAKURU,NAKURU EAST,10,2085,2049,4134
NAKURU,NAKURU EAST,11,1836,1958,3794
NAKURU,NAKURU EAST,12,1990,2071,4061
NAKURU,NAKURU EAST,13,2066,2169,4235
NAKURU,NAKURU EAST,14,1970,2015,3985
NAKURU,NAKURU EAST,Oct-14,9947,10262,20209
NAKURU,NAKURU EAST,15,1825,1989,3814
NAKURU,NAKURU EAST,16,1876,1968,3844
NAKURU,NAKURU EAST,17,2039,2125,4164
NAKURU,NAKURU EAST,18,1706,1833,3539
NAKURU,NAKURU EAST,19,1901,2326,4227
NAKURU,NAKURU EAST,15-19,9347,10241,19588
NAKURU,NAKURU EAST,20,1793,2305,4098
NAKURU,NAKURU EAST,21,1943,2333,4276
NAKURU,NAKURU EAST,22,1904,2370,4274
NAKURU,NAKURU EAST,23,2043,2504,4547
NAKURU,NAKURU EAST,24,1876,2437,4313
NAKURU,NAKURU EAST,20-24,9559,11949,21508
NAKURU,NAKURU EAST,25,2034,2459,4493
NAKURU,NAKURU EAST,26,1733,2261,3994
NAKURU,NAKURU EAST,27,1807,2173,3980
NAKURU,NAKURU EAST,28,1576,2010,3586
NAKURU,NAKURU EAST,29,1748,2187,3935
NAKURU,NAKURU EAST,25-29,8898,11090,19988
NAKURU,NAKURU EAST,30,2008,2585,4593
NAKURU,NAKURU EAST,31,1459,1708,3167
NAKURU,NAKURU EAST,32,1895,2295,4190
NAKURU,NAKURU EAST,33,1494,1926,3420
NAKURU,NAKURU EAST,34,1497,1731,3228
NAKURU,NAKURU EAST,30-34,8353,10245,18598
NAKURU,NAKURU EAST,35,1787,2103,3890
NAKURU,NAKURU EAST,36,1343,1528,2871
NAKURU,NAKURU EAST,37,1326,1408,2734
NAKURU,NAKURU EAST,38,1189,1320,2509
NAKURU,NAKURU EAST,39,1278,1308,2586
NAKURU,NAKURU EAST,35-39,6923,7667,14590
NAKURU,NAKURU EAST,40,1440,1505,2945
NAKURU,NAKURU EAST,41,1134,1171,2305
NAKURU,NAKURU EAST,42,1210,1110,2320
NAKURU,NAKURU EAST,43,960,989,1949
NAKURU,NAKURU EAST,44,777,791,1568
NAKURU,NAKURU EAST,40-44,5521,5566,11087
NAKURU,NAKURU EAST,45,1093,1076,2169
NAKURU,NAKURU EAST,46,812,790,1602
NAKURU,NAKURU EAST,47,867,770,1637
NAKURU,NAKURU EAST,48,610,638,1248
NAKURU,NAKURU EAST,49,720,716,1436
NAKURU,NAKURU EAST,45-49,4102,3990,8092
NAKURU,NAKURU EAST,50,825,820,1645
NAKURU,NAKURU EAST,51,589,583,1172
NAKURU,NAKURU EAST,52,611,587,1198
NAKURU,NAKURU EAST,53,463,434,897
NAKURU,NAKURU EAST,54,514,486,1000
NAKURU,NAKURU EAST,50-54,3002,2910,5912
NAKURU,NAKURU EAST,55,557,469,1026
NAKURU,NAKURU EAST,56,515,502,1017
NAKURU,NAKURU EAST,57,437,443,880
NAKURU,NAKURU EAST,58,348,344,692
NAKURU,NAKURU EAST,59,385,377,762
NAKURU,NAKURU EAST,55-59,2242,2135,4377
NAKURU,NAKURU EAST,60,420,414,834
NAKURU,NAKURU EAST,61,262,255,517
NAKURU,NAKURU EAST,62,272,259,531
NAKURU,NAKURU EAST,63,227,216,443
NAKURU,NAKURU EAST,64,186,184,370
NAKURU,NAKURU EAST,60-64,1367,1328,2695
NAKURU,NAKURU EAST,65,238,210,448
NAKURU,NAKURU EAST,66,151,150,301
NAKURU,NAKURU EAST,67,230,216,446
NAKURU,NAKURU EAST,68,119,112,231
NAKURU,NAKURU EAST,69,148,131,279
NAKURU,NAKURU EAST,65-69,886,819,1705
NAKURU,NAKURU EAST,70,153,184,337
NAKURU,NAKURU EAST,71,110,115,225
NAKURU,NAKURU EAST,72,111,102,213
NAKURU,NAKURU EAST,73,69,62,131
NAKURU,NAKURU EAST,74,70,68,138
NAKURU,NAKURU EAST,70-74,513,531,1044
NAKURU,NAKURU EAST,75,53,71,124
NAKURU,NAKURU EAST,76,50,71,121
NAKURU,NAKURU EAST,77,40,54,94
NAKURU,NAKURU EAST,78,34,34,68
NAKURU,NAKURU EAST,79,27,37,64
NAKURU,NAKURU EAST,75-79,204,267,471
NAKURU,NAKURU EAST,80,41,62,103
NAKURU,NAKURU EAST,81,21,41,62
NAKURU,NAKURU EAST,82,21,28,49
NAKURU,NAKURU EAST,83,18,32,50
NAKURU,NAKURU EAST,84,21,34,55
NAKURU,NAKURU EAST,80-84,122,197,319
NAKURU,NAKURU EAST,85,19,25,44
NAKURU,NAKURU EAST,86,16,29,45
NAKURU,NAKURU EAST,87,12,18,30
NAKURU,NAKURU EAST,88,8,8,16
NAKURU,NAKURU EAST,89,10,18,28
NAKURU,NAKURU EAST,85-89,65,98,163
NAKURU,NAKURU EAST,90,2,16,18
NAKURU,NAKURU EAST,91,4,15,19
NAKURU,NAKURU EAST,92,2,8,10
NAKURU,NAKURU EAST,93,2,6,8
NAKURU,NAKURU EAST,94,3,5,8
NAKURU,NAKURU EAST,90-94,13,50,63
NAKURU,NAKURU EAST,95,2,6,8
NAKURU,NAKURU EAST,96,1,9,10
NAKURU,NAKURU EAST,97,4,9,13
NAKURU,NAKURU EAST,98,1,1,2
NAKURU,NAKURU EAST,99,4,6,10
NAKURU,NAKURU EAST,95-99,12,31,43
NAKURU,NAKURU EAST,100+,6,21,27
NAKURU,NAKURU EAST,Not Stated,6,-,6
NAKURU,NAKURU NORTH,Total,106155,111880,218035
NAKURU,NAKURU NORTH,0,2783,2633,5416
NAKURU,NAKURU NORTH,1,2713,2753,5466
NAKURU,NAKURU NORTH,2,2675,2707,5382
NAKURU,NAKURU NORTH,3,2772,2735,5507
NAKURU,NAKURU NORTH,4,2733,2627,5360
NAKURU,NAKURU NORTH,0 - 4,13676,13455,27131
NAKURU,NAKURU NORTH,5,2573,2435,5008
NAKURU,NAKURU NORTH,6,2472,2573,5045
NAKURU,NAKURU NORTH,7,2639,2526,5165
NAKURU,NAKURU NORTH,8,2509,2423,4932
NAKURU,NAKURU NORTH,9,2740,2686,5426
NAKURU,NAKURU NORTH,05-Sep,12933,12643,25576
NAKURU,NAKURU NORTH,10,2625,2590,5215
NAKURU,NAKURU NORTH,11,2418,2294,4712
NAKURU,NAKURU NORTH,12,2729,2731,5460
NAKURU,NAKURU NORTH,13,2741,2706,5447
NAKURU,NAKURU NORTH,14,2555,2631,5186
NAKURU,NAKURU NORTH,Oct-14,13068,12952,26020
NAKURU,NAKURU NORTH,15,2570,2620,5190
NAKURU,NAKURU NORTH,16,2559,2449,5008
NAKURU,NAKURU NORTH,17,2546,2492,5038
NAKURU,NAKURU NORTH,18,2096,2127,4223
NAKURU,NAKURU NORTH,19,2155,2153,4308
NAKURU,NAKURU NORTH,15-19,11926,11841,23767
NAKURU,NAKURU NORTH,20,1834,2001,3835
NAKURU,NAKURU NORTH,21,1842,2026,3868
NAKURU,NAKURU NORTH,22,1793,2006,3799
NAKURU,NAKURU NORTH,23,1852,2364,4216
NAKURU,NAKURU NORTH,24,1747,2058,3805
NAKURU,NAKURU NORTH,20-24,9068,10455,19523
NAKURU,NAKURU NORTH,25,1836,2089,3925
NAKURU,NAKURU NORTH,26,1577,1919,3496
NAKURU,NAKURU NORTH,27,1662,1825,3487
NAKURU,NAKURU NORTH,28,1361,1735,3096
NAKURU,NAKURU NORTH,29,1588,1795,3383
NAKURU,NAKURU NORTH,25-29,8024,9363,17387
NAKURU,NAKURU NORTH,30,1993,2243,4236
NAKURU,NAKURU NORTH,31,1351,1465,2816
NAKURU,NAKURU NORTH,32,1795,2082,3877
NAKURU,NAKURU NORTH,33,1440,1728,3168
NAKURU,NAKURU NORTH,34,1337,1700,3037
NAKURU,NAKURU NORTH,30-34,7916,9218,17134
NAKURU,NAKURU NORTH,35,1824,1901,3725
NAKURU,NAKURU NORTH,36,1282,1452,2734
NAKURU,NAKURU NORTH,37,1254,1286,2540
NAKURU,NAKURU NORTH,38,1153,1158,2311
NAKURU,NAKURU NORTH,39,1202,1336,2538
NAKURU,NAKURU NORTH,35-39,6715,7133,13848
NAKURU,NAKURU NORTH,40,1424,1498,2922
NAKURU,NAKURU NORTH,41,1288,1226,2514
NAKURU,NAKURU NORTH,42,1218,1144,2362
NAKURU,NAKURU NORTH,43,991,1017,2008
NAKURU,NAKURU NORTH,44,828,823,1651
NAKURU,NAKURU NORTH,40-44,5749,5708,11457
NAKURU,NAKURU NORTH,45,1266,1263,2529
NAKURU,NAKURU NORTH,46,834,906,1740
NAKURU,NAKURU NORTH,47,1050,1074,2124
NAKURU,NAKURU NORTH,48,742,853,1595
NAKURU,NAKURU NORTH,49,848,866,1714
NAKURU,NAKURU NORTH,45-49,4740,4962,9702
NAKURU,NAKURU NORTH,50,952,1047,1999
NAKURU,NAKURU NORTH,51,711,772,1483
NAKURU,NAKURU NORTH,52,797,775,1572
NAKURU,NAKURU NORTH,53,527,607,1134
NAKURU,NAKURU NORTH,54,666,696,1362
NAKURU,NAKURU NORTH,50-54,3653,3897,7550
NAKURU,NAKURU NORTH,55,691,635,1326
NAKURU,NAKURU NORTH,56,668,726,1394
NAKURU,NAKURU NORTH,57,529,614,1143
NAKURU,NAKURU NORTH,58,448,465,913
NAKURU,NAKURU NORTH,59,509,578,1087
NAKURU,NAKURU NORTH,55-59,2845,3018,5863
NAKURU,NAKURU NORTH,60,572,565,1137
NAKURU,NAKURU NORTH,61,394,407,801
NAKURU,NAKURU NORTH,62,348,381,729
NAKURU,NAKURU NORTH,63,330,381,711
NAKURU,NAKURU NORTH,64,238,277,515
NAKURU,NAKURU NORTH,60-64,1882,2011,3893
NAKURU,NAKURU NORTH,65,403,434,837
NAKURU,NAKURU NORTH,66,228,245,473
NAKURU,NAKURU NORTH,67,375,477,852
NAKURU,NAKURU NORTH,68,181,169,350
NAKURU,NAKURU NORTH,69,268,348,616
NAKURU,NAKURU NORTH,65-69,1455,1673,3128
NAKURU,NAKURU NORTH,70,347,465,812
NAKURU,NAKURU NORTH,71,244,266,510
NAKURU,NAKURU NORTH,72,245,216,461
NAKURU,NAKURU NORTH,73,175,224,399
NAKURU,NAKURU NORTH,74,154,199,353
NAKURU,NAKURU NORTH,70-74,1165,1370,2535
NAKURU,NAKURU NORTH,75,162,232,394
NAKURU,NAKURU NORTH,76,150,271,421
NAKURU,NAKURU NORTH,77,104,151,255
NAKURU,NAKURU NORTH,78,79,106,185
NAKURU,NAKURU NORTH,79,89,151,240
NAKURU,NAKURU NORTH,75-79,584,911,1495
NAKURU,NAKURU NORTH,80,119,196,315
NAKURU,NAKURU NORTH,81,63,107,170
NAKURU,NAKURU NORTH,82,75,82,157
NAKURU,NAKURU NORTH,83,69,84,153
NAKURU,NAKURU NORTH,84,77,119,196
NAKURU,NAKURU NORTH,80-84,403,588,991
NAKURU,NAKURU NORTH,85,58,85,143
NAKURU,NAKURU NORTH,86,39,80,119
NAKURU,NAKURU NORTH,87,50,65,115
NAKURU,NAKURU NORTH,88,21,36,57
NAKURU,NAKURU NORTH,89,46,88,134
NAKURU,NAKURU NORTH,85-89,214,354,568
NAKURU,NAKURU NORTH,90,21,58,79
NAKURU,NAKURU NORTH,91,30,29,59
NAKURU,NAKURU NORTH,92,11,22,33
NAKURU,NAKURU NORTH,93,9,22,31
NAKURU,NAKURU NORTH,94,6,26,32
NAKURU,NAKURU NORTH,90-94,77,157,234
NAKURU,NAKURU NORTH,95,11,31,42
NAKURU,NAKURU NORTH,96,12,16,28
NAKURU,NAKURU NORTH,97,11,20,31
NAKURU,NAKURU NORTH,98,6,14,20
NAKURU,NAKURU NORTH,99,5,17,22
NAKURU,NAKURU NORTH,95-99,45,98,143
NAKURU,NAKURU NORTH,100+,15,72,87
NAKURU,NAKURU NORTH,Not Stated,2,1,3
NAKURU,NAKURU WEST,Total,101797,96854,198651
NAKURU,NAKURU WEST,0,2667,2711,5378
NAKURU,NAKURU WEST,1,2530,2468,4998
NAKURU,NAKURU WEST,2,2566,2526,5092
NAKURU,NAKURU WEST,3,2481,2509,4990
NAKURU,NAKURU WEST,4,2403,2298,4701
NAKURU,NAKURU WEST,0 - 4,12647,12512,25159
NAKURU,NAKURU WEST,5,2127,2143,4270
NAKURU,NAKURU WEST,6,2173,2175,4348
NAKURU,NAKURU WEST,7,2185,2141,4326
NAKURU,NAKURU WEST,8,2092,2097,4189
NAKURU,NAKURU WEST,9,2189,2189,4378
NAKURU,NAKURU WEST,05-Sep,10766,10745,21511
NAKURU,NAKURU WEST,10,2190,2138,4328
NAKURU,NAKURU WEST,11,1854,1987,3841
NAKURU,NAKURU WEST,12,2126,2226,4352
NAKURU,NAKURU WEST,13,2020,2155,4175
NAKURU,NAKURU WEST,14,1877,1962,3839
NAKURU,NAKURU WEST,Oct-14,10067,10468,20535
NAKURU,NAKURU WEST,15,1793,1910,3703
NAKURU,NAKURU WEST,16,1747,1888,3635
NAKURU,NAKURU WEST,17,1911,1904,3815
NAKURU,NAKURU WEST,18,1637,1729,3366
NAKURU,NAKURU WEST,19,1970,2104,4074
NAKURU,NAKURU WEST,15-19,9058,9535,18593
NAKURU,NAKURU WEST,20,2021,2301,4322
NAKURU,NAKURU WEST,21,2155,2422,4577
NAKURU,NAKURU WEST,22,2318,2688,5006
NAKURU,NAKURU WEST,23,2678,2874,5552
NAKURU,NAKURU WEST,24,2614,2784,5398
NAKURU,NAKURU WEST,20-24,11786,13069,24855
NAKURU,NAKURU WEST,25,2855,2835,5690
NAKURU,NAKURU WEST,26,2344,2539,4883
NAKURU,NAKURU WEST,27,2540,2392,4932
NAKURU,NAKURU WEST,28,2093,2005,4098
NAKURU,NAKURU WEST,29,2269,2106,4375
NAKURU,NAKURU WEST,25-29,12101,11877,23978
NAKURU,NAKURU WEST,30,2680,2611,5291
NAKURU,NAKURU WEST,31,1851,1674,3525
NAKURU,NAKURU WEST,32,2353,2277,4630
NAKURU,NAKURU WEST,33,1762,1678,3440
NAKURU,NAKURU WEST,34,1659,1554,3213
NAKURU,NAKURU WEST,30-34,10305,9794,20099
NAKURU,NAKURU WEST,35,2161,1742,3903
NAKURU,NAKURU WEST,36,1461,1276,2737
NAKURU,NAKURU WEST,37,1386,1141,2527
NAKURU,NAKURU WEST,38,1186,975,2161
NAKURU,NAKURU WEST,39,1242,944,2186
NAKURU,NAKURU WEST,35-39,7436,6078,13514
NAKURU,NAKURU WEST,40,1541,1236,2777
NAKURU,NAKURU WEST,41,1371,845,2216
NAKURU,NAKURU WEST,42,1216,917,2133
NAKURU,NAKURU WEST,43,1013,736,1749
NAKURU,NAKURU WEST,44,770,579,1349
NAKURU,NAKURU WEST,40-44,5911,4313,10224
NAKURU,NAKURU WEST,45,1245,840,2085
NAKURU,NAKURU WEST,46,766,576,1342
NAKURU,NAKURU WEST,47,850,598,1448
NAKURU,NAKURU WEST,48,591,439,1030
NAKURU,NAKURU WEST,49,714,470,1184
NAKURU,NAKURU WEST,45-49,4166,2923,7089
NAKURU,NAKURU WEST,50,851,615,1466
NAKURU,NAKURU WEST,51,610,385,995
NAKURU,NAKURU WEST,52,540,357,897
NAKURU,NAKURU WEST,53,378,302,680
NAKURU,NAKURU WEST,54,426,324,750
NAKURU,NAKURU WEST,50-54,2805,1983,4788
NAKURU,NAKURU WEST,55,466,294,760
NAKURU,NAKURU WEST,56,487,339,826
NAKURU,NAKURU WEST,57,401,312,713
NAKURU,NAKURU WEST,58,348,219,567
NAKURU,NAKURU WEST,59,333,226,559
NAKURU,NAKURU WEST,55-59,2035,1390,3425
NAKURU,NAKURU WEST,60,370,263,633
NAKURU,NAKURU WEST,61,241,174,415
NAKURU,NAKURU WEST,62,199,154,353
NAKURU,NAKURU WEST,63,189,145,334
NAKURU,NAKURU WEST,64,153,107,260
NAKURU,NAKURU WEST,60-64,1152,843,1995
NAKURU,NAKURU WEST,65,220,136,356
NAKURU,NAKURU WEST,66,120,84,204
NAKURU,NAKURU WEST,67,185,147,332
NAKURU,NAKURU WEST,68,95,71,166
NAKURU,NAKURU WEST,69,120,97,217
NAKURU,NAKURU WEST,65-69,740,535,1275
NAKURU,NAKURU WEST,70,148,128,276
NAKURU,NAKURU WEST,71,96,71,167
NAKURU,NAKURU WEST,72,83,55,138
NAKURU,NAKURU WEST,73,55,41,96
NAKURU,NAKURU WEST,74,62,45,107
NAKURU,NAKURU WEST,70-74,444,340,784
NAKURU,NAKURU WEST,75,42,62,104
NAKURU,NAKURU WEST,76,56,45,101
NAKURU,NAKURU WEST,77,30,40,70
NAKURU,NAKURU WEST,78,27,20,47
NAKURU,NAKURU WEST,79,26,30,56
NAKURU,NAKURU WEST,75-79,181,197,378
NAKURU,NAKURU WEST,80,32,39,71
NAKURU,NAKURU WEST,81,16,22,38
NAKURU,NAKURU WEST,82,31,11,42
NAKURU,NAKURU WEST,83,22,20,42
NAKURU,NAKURU WEST,84,15,25,40
NAKURU,NAKURU WEST,80-84,116,117,233
NAKURU,NAKURU WEST,85,13,18,31
NAKURU,NAKURU WEST,86,10,15,25
NAKURU,NAKURU WEST,87,9,13,22
NAKURU,NAKURU WEST,88,3,7,10
NAKURU,NAKURU WEST,89,6,21,27
NAKURU,NAKURU WEST,85-89,41,74,115
NAKURU,NAKURU WEST,90,7,8,15
NAKURU,NAKURU WEST,91,6,7,13
NAKURU,NAKURU WEST,92,7,8,15
NAKURU,NAKURU WEST,93,2,4,6
NAKURU,NAKURU WEST,94,2,1,3
NAKURU,NAKURU WEST,90-94,24,28,52
NAKURU,NAKURU WEST,95,1,11,12
NAKURU,NAKURU WEST,96,2,4,6
NAKURU,NAKURU WEST,97,2,2,4
NAKURU,NAKURU WEST,98,3,-,3
NAKURU,NAKURU WEST,99,3,6,9
NAKURU,NAKURU WEST,95-99,11,23,34
NAKURU,NAKURU WEST,100+,5,10,15
NAKURU,NAKURU WEST,Not Stated,-,-,-
NAKURU,NJORO,Total,118361,120408,238769
NAKURU,NJORO,0,2961,2991,5952
NAKURU,NJORO,1,3050,3040,6090
NAKURU,NJORO,2,3081,3087,6168
NAKURU,NJORO,3,3163,3270,6433
NAKURU,NJORO,4,3319,3168,6487
NAKURU,NJORO,0 - 4,15574,15556,31130
NAKURU,NJORO,5,3300,3225,6525
NAKURU,NJORO,6,3172,3210,6382
NAKURU,NJORO,7,3473,3226,6699
NAKURU,NJORO,8,3056,3009,6065
NAKURU,NJORO,9,3555,3334,6889
NAKURU,NJORO,05-Sep,16556,16004,32560
NAKURU,NJORO,10,3500,3438,6938
NAKURU,NJORO,11,3286,3214,6500
NAKURU,NJORO,12,3711,3414,7125
NAKURU,NJORO,13,3571,3476,7047
NAKURU,NJORO,14,3484,3266,6750
NAKURU,NJORO,Oct-14,17552,16808,34360
NAKURU,NJORO,15,3354,3042,6396
NAKURU,NJORO,16,3048,2889,5937
NAKURU,NJORO,17,3082,2824,5906
NAKURU,NJORO,18,2266,2154,4420
NAKURU,NJORO,19,2443,2275,4718
NAKURU,NJORO,15-19,14193,13184,27377
NAKURU,NJORO,20,2039,2132,4171
NAKURU,NJORO,21,1974,2133,4107
NAKURU,NJORO,22,2005,2063,4068
NAKURU,NJORO,23,2106,2128,4234
NAKURU,NJORO,24,1757,1861,3618
NAKURU,NJORO,20-24,9881,10317,20198
NAKURU,NJORO,25,1837,1950,3787
NAKURU,NJORO,26,1455,1650,3105
NAKURU,NJORO,27,1724,1845,3569
NAKURU,NJORO,28,1402,1541,2943
NAKURU,NJORO,29,1524,1685,3209
NAKURU,NJORO,25-29,7942,8671,16613
NAKURU,NJORO,30,1747,2011,3758
NAKURU,NJORO,31,1361,1538,2899
NAKURU,NJORO,32,1731,1972,3703
NAKURU,NJORO,33,1404,1688,3092
NAKURU,NJORO,34,1348,1476,2824
NAKURU,NJORO,30-34,7591,8685,16276
NAKURU,NJORO,35,1887,2004,3891
NAKURU,NJORO,36,1132,1255,2387
NAKURU,NJORO,37,1221,1178,2399
NAKURU,NJORO,38,894,921,1815
NAKURU,NJORO,39,1075,1163,2238
NAKURU,NJORO,35-39,6209,6521,12730
NAKURU,NJORO,40,1318,1309,2627
NAKURU,NJORO,41,1434,1340,2774
NAKURU,NJORO,42,1129,1134,2263
NAKURU,NJORO,43,922,965,1887
NAKURU,NJORO,44,764,779,1543
NAKURU,NJORO,40-44,5567,5527,11094
NAKURU,NJORO,45,1320,1329,2649
NAKURU,NJORO,46,909,912,1821
NAKURU,NJORO,47,982,1042,2024
NAKURU,NJORO,48,697,673,1370
NAKURU,NJORO,49,808,893,1701
NAKURU,NJORO,45-49,4716,4849,9565
NAKURU,NJORO,50,918,940,1858
NAKURU,NJORO,51,673,741,1414
NAKURU,NJORO,52,689,683,1372
NAKURU,NJORO,53,456,533,989
NAKURU,NJORO,54,605,630,1235
NAKURU,NJORO,50-54,3341,3527,6868
NAKURU,NJORO,55,589,572,1161
NAKURU,NJORO,56,625,667,1292
NAKURU,NJORO,57,476,597,1073
NAKURU,NJORO,58,526,662,1188
NAKURU,NJORO,59,582,585,1167
NAKURU,NJORO,55-59,2798,3083,5881
NAKURU,NJORO,60,563,617,1180
NAKURU,NJORO,61,432,490,922
NAKURU,NJORO,62,401,396,797
NAKURU,NJORO,63,315,350,665
NAKURU,NJORO,64,265,274,539
NAKURU,NJORO,60-64,1976,2127,4103
NAKURU,NJORO,65,402,458,860
NAKURU,NJORO,66,315,304,619
NAKURU,NJORO,67,449,513,962
NAKURU,NJORO,68,210,215,425
NAKURU,NJORO,69,331,357,688
NAKURU,NJORO,65-69,1707,1847,3554
NAKURU,NJORO,70,377,483,860
NAKURU,NJORO,71,284,271,555
NAKURU,NJORO,72,237,210,447
NAKURU,NJORO,73,200,198,398
NAKURU,NJORO,74,183,216,399
NAKURU,NJORO,70-74,1281,1378,2659
NAKURU,NJORO,75,136,253,389
NAKURU,NJORO,76,178,337,515
NAKURU,NJORO,77,136,164,300
NAKURU,NJORO,78,84,102,186
NAKURU,NJORO,79,119,165,284
NAKURU,NJORO,75-79,653,1021,1674
NAKURU,NJORO,80,139,193,332
NAKURU,NJORO,81,73,93,166
NAKURU,NJORO,82,79,81,160
NAKURU,NJORO,83,78,95,173
NAKURU,NJORO,84,68,117,185
NAKURU,NJORO,80-84,437,579,1016
NAKURU,NJORO,85,55,94,149
NAKURU,NJORO,86,31,91,122
NAKURU,NJORO,87,41,68,109
NAKURU,NJORO,88,29,41,70
NAKURU,NJORO,89,55,101,156
NAKURU,NJORO,85-89,211,395,606
NAKURU,NJORO,90,37,64,101
NAKURU,NJORO,91,25,45,70
NAKURU,NJORO,92,14,19,33
NAKURU,NJORO,93,13,20,33
NAKURU,NJORO,94,6,26,32
NAKURU,NJORO,90-94,95,174,269
NAKURU,NJORO,95,18,26,44
NAKURU,NJORO,96,14,14,28
NAKURU,NJORO,97,13,19,32
NAKURU,NJORO,98,10,8,18
NAKURU,NJORO,99,10,22,32
NAKURU,NJORO,95-99,65,89,154
NAKURU,NJORO,100+,15,66,81
NAKURU,NJORO,Not Stated,1,-,1
NAKURU,RONGAI,Total,99976,99922,199898
NAKURU,RONGAI,0,2329,2370,4699
NAKURU,RONGAI,1,2449,2448,4897
NAKURU,RONGAI,2,2549,2375,4924
NAKURU,RONGAI,3,2575,2637,5212
NAKURU,RONGAI,4,2701,2520,5221
NAKURU,RONGAI,0 - 4,12603,12350,24953
NAKURU,RONGAI,5,2609,2306,4915
NAKURU,RONGAI,6,2406,2479,4885
NAKURU,RONGAI,7,2624,2454,5078
NAKURU,RONGAI,8,2459,2333,4792
NAKURU,RONGAI,9,2472,2529,5001
NAKURU,RONGAI,05-Sep,12570,12101,24671
NAKURU,RONGAI,10,2708,2595,5303
NAKURU,RONGAI,11,2331,2363,4694
NAKURU,RONGAI,12,2681,2648,5329
NAKURU,RONGAI,13,2642,2700,5342
NAKURU,RONGAI,14,2501,2392,4893
NAKURU,RONGAI,Oct-14,12863,12698,25561
NAKURU,RONGAI,15,2479,2403,4882
NAKURU,RONGAI,16,2278,2312,4590
NAKURU,RONGAI,17,2429,2436,4865
NAKURU,RONGAI,18,1871,1852,3723
NAKURU,RONGAI,19,2293,2133,4426
NAKURU,RONGAI,15-19,11350,11136,22486
NAKURU,RONGAI,20,1972,2091,4063
NAKURU,RONGAI,21,2047,1992,4039
NAKURU,RONGAI,22,1906,1905,3811
NAKURU,RONGAI,23,1962,2056,4018
NAKURU,RONGAI,24,1853,1871,3724
NAKURU,RONGAI,20-24,9740,9915,19655
NAKURU,RONGAI,25,1854,1969,3823
NAKURU,RONGAI,26,1530,1620,3150
NAKURU,RONGAI,27,1675,1706,3381
NAKURU,RONGAI,28,1268,1385,2653
NAKURU,RONGAI,29,1444,1543,2987
NAKURU,RONGAI,25-29,7771,8223,15994
NAKURU,RONGAI,30,1827,1894,3721
NAKURU,RONGAI,31,1234,1321,2555
NAKURU,RONGAI,32,1644,1781,3425
NAKURU,RONGAI,33,1343,1414,2757
NAKURU,RONGAI,34,1174,1306,2480
NAKURU,RONGAI,30-34,7222,7716,14938
NAKURU,RONGAI,35,1681,1700,3381
NAKURU,RONGAI,36,1097,1115,2212
NAKURU,RONGAI,37,1121,983,2104
NAKURU,RONGAI,38,826,898,1724
NAKURU,RONGAI,39,999,928,1927
NAKURU,RONGAI,35-39,5724,5624,11348
NAKURU,RONGAI,40,1245,1113,2358
NAKURU,RONGAI,41,1245,1111,2356
NAKURU,RONGAI,42,1062,927,1989
NAKURU,RONGAI,43,832,873,1705
NAKURU,RONGAI,44,749,696,1445
NAKURU,RONGAI,40-44,5133,4720,9853
NAKURU,RONGAI,45,1245,1062,2307
NAKURU,RONGAI,46,754,760,1514
NAKURU,RONGAI,47,853,810,1663
NAKURU,RONGAI,48,599,528,1127
NAKURU,RONGAI,49,746,683,1429
NAKURU,RONGAI,45-49,4197,3843,8040
NAKURU,RONGAI,50,793,836,1629
NAKURU,RONGAI,51,607,623,1230
NAKURU,RONGAI,52,601,533,1134
NAKURU,RONGAI,53,442,405,847
NAKURU,RONGAI,54,522,523,1045
NAKURU,RONGAI,50-54,2965,2920,5885
NAKURU,RONGAI,55,542,540,1082
NAKURU,RONGAI,56,518,535,1053
NAKURU,RONGAI,57,481,532,1013
NAKURU,RONGAI,58,481,589,1070
NAKURU,RONGAI,59,496,468,964
NAKURU,RONGAI,55-59,2518,2664,5182
NAKURU,RONGAI,60,524,579,1103
NAKURU,RONGAI,61,381,380,761
NAKURU,RONGAI,62,343,329,672
NAKURU,RONGAI,63,294,313,607
NAKURU,RONGAI,64,201,246,447
NAKURU,RONGAI,60-64,1743,1847,3590
NAKURU,RONGAI,65,340,386,726
NAKURU,RONGAI,66,210,220,430
NAKURU,RONGAI,67,365,362,727
NAKURU,RONGAI,68,171,182,353
NAKURU,RONGAI,69,255,268,523
NAKURU,RONGAI,65-69,1341,1418,2759
NAKURU,RONGAI,70,324,392,716
NAKURU,RONGAI,71,229,200,429
NAKURU,RONGAI,72,193,175,368
NAKURU,RONGAI,73,145,158,303
NAKURU,RONGAI,74,143,175,318
NAKURU,RONGAI,70-74,1034,1100,2134
NAKURU,RONGAI,75,146,166,312
NAKURU,RONGAI,76,116,176,292
NAKURU,RONGAI,77,112,112,224
NAKURU,RONGAI,78,63,68,131
NAKURU,RONGAI,79,99,135,234
NAKURU,RONGAI,75-79,536,657,1193
NAKURU,RONGAI,80,104,157,261
NAKURU,RONGAI,81,59,72,131
NAKURU,RONGAI,82,62,58,120
NAKURU,RONGAI,83,55,55,110
NAKURU,RONGAI,84,57,86,143
NAKURU,RONGAI,80-84,337,428,765
NAKURU,RONGAI,85,49,82,131
NAKURU,RONGAI,86,28,43,71
NAKURU,RONGAI,87,31,57,88
NAKURU,RONGAI,88,29,23,52
NAKURU,RONGAI,89,38,76,114
NAKURU,RONGAI,85-89,175,281,456
NAKURU,RONGAI,90,24,67,91
NAKURU,RONGAI,91,19,28,47
NAKURU,RONGAI,92,14,23,37
NAKURU,RONGAI,93,17,15,32
NAKURU,RONGAI,94,10,23,33
NAKURU,RONGAI,90-94,84,156,240
NAKURU,RONGAI,95,12,27,39
NAKURU,RONGAI,96,10,15,25
NAKURU,RONGAI,97,10,13,23
NAKURU,RONGAI,98,3,12,15
NAKURU,RONGAI,99,12,15,27
NAKURU,RONGAI,95-99,47,82,129
NAKURU,RONGAI,100+,20,43,63
NAKURU,RONGAI,Not Stated,3,-,3
NAKURU,SUBUKIA,Total,42045,43118,85163
NAKURU,SUBUKIA,0,966,907,1873
NAKURU,SUBUKIA,1,991,991,1982
NAKURU,SUBUKIA,2,1054,996,2050
NAKURU,SUBUKIA,3,1099,1079,2178
NAKURU,SUBUKIA,4,1114,997,2111
NAKURU,SUBUKIA,0 - 4,5224,4970,10194
NAKURU,SUBUKIA,5,1049,970,2019
NAKURU,SUBUKIA,6,1087,982,2069
NAKURU,SUBUKIA,7,1082,1031,2113
NAKURU,SUBUKIA,8,1043,1065,2108
NAKURU,SUBUKIA,9,1173,1040,2213
NAKURU,SUBUKIA,05-Sep,5434,5088,10522
NAKURU,SUBUKIA,10,1206,1183,2389
NAKURU,SUBUKIA,11,1123,1112,2235
NAKURU,SUBUKIA,12,1300,1253,2553
NAKURU,SUBUKIA,13,1274,1221,2495
NAKURU,SUBUKIA,14,1289,1223,2512
NAKURU,SUBUKIA,Oct-14,6192,5992,12184
NAKURU,SUBUKIA,15,1306,1139,2445
NAKURU,SUBUKIA,16,1183,1084,2267
NAKURU,SUBUKIA,17,1227,1149,2376
NAKURU,SUBUKIA,18,894,854,1748
NAKURU,SUBUKIA,19,978,819,1797
NAKURU,SUBUKIA,15-19,5588,5045,10633
NAKURU,SUBUKIA,20,740,641,1381
NAKURU,SUBUKIA,21,666,626,1292
NAKURU,SUBUKIA,22,575,592,1167
NAKURU,SUBUKIA,23,613,631,1244
NAKURU,SUBUKIA,24,531,551,1082
NAKURU,SUBUKIA,20-24,3125,3041,6166
NAKURU,SUBUKIA,25,525,564,1089
NAKURU,SUBUKIA,26,438,474,912
NAKURU,SUBUKIA,27,460,529,989
NAKURU,SUBUKIA,28,361,434,795
NAKURU,SUBUKIA,29,422,459,881
NAKURU,SUBUKIA,25-29,2206,2460,4666
NAKURU,SUBUKIA,30,542,606,1148
NAKURU,SUBUKIA,31,364,427,791
NAKURU,SUBUKIA,32,488,563,1051
NAKURU,SUBUKIA,33,416,526,942
NAKURU,SUBUKIA,34,445,488,933
NAKURU,SUBUKIA,30-34,2255,2610,4865
NAKURU,SUBUKIA,35,592,679,1271
NAKURU,SUBUKIA,36,387,474,861
NAKURU,SUBUKIA,37,387,427,814
NAKURU,SUBUKIA,38,333,341,674
NAKURU,SUBUKIA,39,353,402,755
NAKURU,SUBUKIA,35-39,2052,2323,4375
NAKURU,SUBUKIA,40,445,437,882
NAKURU,SUBUKIA,41,438,434,872
NAKURU,SUBUKIA,42,437,467,904
NAKURU,SUBUKIA,43,378,398,776
NAKURU,SUBUKIA,44,291,332,623
NAKURU,SUBUKIA,40-44,1989,2068,4057
NAKURU,SUBUKIA,45,443,565,1008
NAKURU,SUBUKIA,46,313,409,722
NAKURU,SUBUKIA,47,385,425,810
NAKURU,SUBUKIA,48,293,316,609
NAKURU,SUBUKIA,49,340,369,709
NAKURU,SUBUKIA,45-49,1774,2084,3858
NAKURU,SUBUKIA,50,388,495,883
NAKURU,SUBUKIA,51,303,344,647
NAKURU,SUBUKIA,52,336,317,653
NAKURU,SUBUKIA,53,225,280,505
NAKURU,SUBUKIA,54,285,317,602
NAKURU,SUBUKIA,50-54,1537,1753,3290
NAKURU,SUBUKIA,55,295,288,583
NAKURU,SUBUKIA,56,309,334,643
NAKURU,SUBUKIA,57,253,298,551
NAKURU,SUBUKIA,58,217,301,518
NAKURU,SUBUKIA,59,220,278,498
NAKURU,SUBUKIA,55-59,1294,1499,2793
NAKURU,SUBUKIA,60,269,317,586
NAKURU,SUBUKIA,61,216,222,438
NAKURU,SUBUKIA,62,169,195,364
NAKURU,SUBUKIA,63,147,164,311
NAKURU,SUBUKIA,64,123,146,269
NAKURU,SUBUKIA,60-64,924,1044,1968
NAKURU,SUBUKIA,65,212,217,429
NAKURU,SUBUKIA,66,152,154,306
NAKURU,SUBUKIA,67,230,242,472
NAKURU,SUBUKIA,68,103,111,214
NAKURU,SUBUKIA,69,181,188,369
NAKURU,SUBUKIA,65-69,878,912,1790
NAKURU,SUBUKIA,70,208,249,457
NAKURU,SUBUKIA,71,136,160,296
NAKURU,SUBUKIA,72,134,141,275
NAKURU,SUBUKIA,73,104,114,218
NAKURU,SUBUKIA,74,75,141,216
NAKURU,SUBUKIA,70-74,657,805,1462
NAKURU,SUBUKIA,75,86,134,220
NAKURU,SUBUKIA,76,103,172,275
NAKURU,SUBUKIA,77,82,98,180
NAKURU,SUBUKIA,78,60,66,126
NAKURU,SUBUKIA,79,60,125,185
NAKURU,SUBUKIA,75-79,391,595,986
NAKURU,SUBUKIA,80,73,146,219
NAKURU,SUBUKIA,81,53,51,104
NAKURU,SUBUKIA,82,58,48,106
NAKURU,SUBUKIA,83,51,60,111
NAKURU,SUBUKIA,84,52,73,125
NAKURU,SUBUKIA,80-84,287,378,665
NAKURU,SUBUKIA,85,30,62,92
NAKURU,SUBUKIA,86,26,37,63
NAKURU,SUBUKIA,87,32,43,75
NAKURU,SUBUKIA,88,24,20,44
NAKURU,SUBUKIA,89,33,72,105
NAKURU,SUBUKIA,85-89,145,234,379
NAKURU,SUBUKIA,90,21,38,59
NAKURU,SUBUKIA,91,19,26,45
NAKURU,SUBUKIA,92,8,13,21
NAKURU,SUBUKIA,93,6,15,21
NAKURU,SUBUKIA,94,7,13,20
NAKURU,SUBUKIA,90-94,61,105,166
NAKURU,SUBUKIA,95,6,18,24
NAKURU,SUBUKIA,96,4,11,15
NAKURU,SUBUKIA,97,7,19,26
NAKURU,SUBUKIA,98,3,5,8
NAKURU,SUBUKIA,99,3,17,20
NAKURU,SUBUKIA,95-99,23,70,93
NAKURU,SUBUKIA,100+,9,39,48
NAKURU,SUBUKIA,Not Stated,-,3,3
NANDI,ALL,Total,441259,444430,885689
NANDI,ALL,0,9988,9702,19690
NANDI,ALL,1,10385,10273,20658
NANDI,ALL,2,10656,10567,21223
NANDI,ALL,3,10882,11079,21961
NANDI,ALL,4,11380,11058,22438
NANDI,ALL,0 - 4,53291,52679,105970
NANDI,ALL,5,11229,10884,22113
NANDI,ALL,6,11161,11334,22495
NANDI,ALL,7,11877,11488,23365
NANDI,ALL,8,11553,11266,22819
NANDI,ALL,9,12691,12651,25342
NANDI,ALL,05-Sep,58511,57623,116134
NANDI,ALL,10,12503,11883,24386
NANDI,ALL,11,12018,12318,24336
NANDI,ALL,12,13564,13007,26571
NANDI,ALL,13,13155,12994,26149
NANDI,ALL,14,12483,12188,24671
NANDI,ALL,Oct-14,63723,62390,126113
NANDI,ALL,15,12209,11959,24168
NANDI,ALL,16,11471,11194,22665
NANDI,ALL,17,11775,11228,23003
NANDI,ALL,18,9290,8945,18235
NANDI,ALL,19,10625,10045,20670
NANDI,ALL,15-19,55370,53371,108741
NANDI,ALL,20,8768,8942,17710
NANDI,ALL,21,8425,8483,16908
NANDI,ALL,22,7533,7904,15437
NANDI,ALL,23,7583,8530,16113
NANDI,ALL,24,6829,7448,14277
NANDI,ALL,20-24,39138,41307,80445
NANDI,ALL,25,7361,7735,15096
NANDI,ALL,26,6084,7036,13120
NANDI,ALL,27,6605,7132,13737
NANDI,ALL,28,4946,5691,10637
NANDI,ALL,29,5978,6772,12750
NANDI,ALL,25-29,30974,34366,65340
NANDI,ALL,30,6706,7501,14207
NANDI,ALL,31,5595,6216,11811
NANDI,ALL,32,6815,7750,14565
NANDI,ALL,33,6088,7130,13218
NANDI,ALL,34,5372,5934,11306
NANDI,ALL,30-34,30576,34531,65107
NANDI,ALL,35,6733,6692,13425
NANDI,ALL,36,4605,3936,8541
NANDI,ALL,37,4926,3989,8915
NANDI,ALL,38,3399,2847,6246
NANDI,ALL,39,4292,3680,7972
NANDI,ALL,35-39,23955,21144,45099
NANDI,ALL,40,4399,4019,8418
NANDI,ALL,41,4780,4158,8938
NANDI,ALL,42,4434,4072,8506
NANDI,ALL,43,4149,4245,8394
NANDI,ALL,44,3394,3240,6634
NANDI,ALL,40-44,21156,19734,40890
NANDI,ALL,45,4774,4402,9176
NANDI,ALL,46,3657,3446,7103
NANDI,ALL,47,3699,3616,7315
NANDI,ALL,48,2332,2324,4656
NANDI,ALL,49,3183,3178,6361
NANDI,ALL,45-49,17645,16966,34611
NANDI,ALL,50,2946,3018,5964
NANDI,ALL,51,2739,2720,5459
NANDI,ALL,52,2170,2253,4423
NANDI,ALL,53,1868,2034,3902
NANDI,ALL,54,2100,1957,4057
NANDI,ALL,50-54,11823,11982,23805
NANDI,ALL,55,2203,1822,4025
NANDI,ALL,56,1998,2010,4008
NANDI,ALL,57,1976,2590,4566
NANDI,ALL,58,2005,2448,4453
NANDI,ALL,59,2173,2211,4384
NANDI,ALL,55-59,10355,11081,21436
NANDI,ALL,60,2213,2189,4402
NANDI,ALL,61,1832,1753,3585
NANDI,ALL,62,1496,1375,2871
NANDI,ALL,63,1397,1537,2934
NANDI,ALL,64,1105,1151,2256
NANDI,ALL,60-64,8043,8005,16048
NANDI,ALL,65,1588,1742,3330
NANDI,ALL,66,937,1049,1986
NANDI,ALL,67,1663,1709,3372
NANDI,ALL,68,677,746,1423
NANDI,ALL,69,1186,1339,2525
NANDI,ALL,65-69,6051,6585,12636
NANDI,ALL,70,1172,1449,2621
NANDI,ALL,71,1056,1042,2098
NANDI,ALL,72,819,733,1552
NANDI,ALL,73,667,681,1348
NANDI,ALL,74,635,785,1420
NANDI,ALL,70-74,4349,4690,9039
NANDI,ALL,75,678,744,1422
NANDI,ALL,76,639,774,1413
NANDI,ALL,77,646,648,1294
NANDI,ALL,78,323,327,650
NANDI,ALL,79,472,738,1210
NANDI,ALL,75-79,2758,3231,5989
NANDI,ALL,80,496,658,1154
NANDI,ALL,81,295,354,649
NANDI,ALL,82,304,236,540
NANDI,ALL,83,335,347,682
NANDI,ALL,84,254,367,621
NANDI,ALL,80-84,1684,1962,3646
NANDI,ALL,85,227,284,511
NANDI,ALL,86,219,229,448
NANDI,ALL,87,210,272,482
NANDI,ALL,88,107,121,228
NANDI,ALL,89,227,469,696
NANDI,ALL,85-89,990,1375,2365
NANDI,ALL,90,131,218,349
NANDI,ALL,91,97,145,242
NANDI,ALL,92,84,99,183
NANDI,ALL,93,89,93,182
NANDI,ALL,94,71,121,192
NANDI,ALL,90-94,472,676,1148
NANDI,ALL,95,142,211,353
NANDI,ALL,96,37,39,76
NANDI,ALL,97,52,64,116
NANDI,ALL,98,28,45,73
NANDI,ALL,99,57,133,190
NANDI,ALL,95-99,316,492,808
NANDI,ALL,100+,79,238,317
NANDI,ALL,Not Stated,-,2,2
NANDI,CHESUMEI,Total,80949,83180,164129
NANDI,CHESUMEI,0,1751,1774,3525
NANDI,CHESUMEI,1,1978,1908,3886
NANDI,CHESUMEI,2,1973,1953,3926
NANDI,CHESUMEI,3,1869,2020,3889
NANDI,CHESUMEI,4,1988,1936,3924
NANDI,CHESUMEI,0 - 4,9559,9591,19150
NANDI,CHESUMEI,5,1960,1834,3794
NANDI,CHESUMEI,6,1857,1935,3792
NANDI,CHESUMEI,7,2015,1929,3944
NANDI,CHESUMEI,8,1927,1970,3897
NANDI,CHESUMEI,9,2124,2207,4331
NANDI,CHESUMEI,05-Sep,9883,9875,19758
NANDI,CHESUMEI,10,2143,1971,4114
NANDI,CHESUMEI,11,2082,2067,4149
NANDI,CHESUMEI,12,2395,2349,4744
NANDI,CHESUMEI,13,2296,2309,4605
NANDI,CHESUMEI,14,2148,2103,4251
NANDI,CHESUMEI,Oct-14,11064,10799,21863
NANDI,CHESUMEI,15,2146,2145,4291
NANDI,CHESUMEI,16,1959,2090,4049
NANDI,CHESUMEI,17,2093,2041,4134
NANDI,CHESUMEI,18,1752,1775,3527
NANDI,CHESUMEI,19,1997,2011,4008
NANDI,CHESUMEI,15-19,9947,10062,20009
NANDI,CHESUMEI,20,1745,1787,3532
NANDI,CHESUMEI,21,1693,1698,3391
NANDI,CHESUMEI,22,1504,1546,3050
NANDI,CHESUMEI,23,1478,1660,3138
NANDI,CHESUMEI,24,1395,1530,2925
NANDI,CHESUMEI,20-24,7815,8221,16036
NANDI,CHESUMEI,25,1454,1497,2951
NANDI,CHESUMEI,26,1203,1398,2601
NANDI,CHESUMEI,27,1399,1482,2881
NANDI,CHESUMEI,28,984,1119,2103
NANDI,CHESUMEI,29,1183,1374,2557
NANDI,CHESUMEI,25-29,6223,6870,13093
NANDI,CHESUMEI,30,1362,1440,2802
NANDI,CHESUMEI,31,1066,1195,2261
NANDI,CHESUMEI,32,1284,1471,2755
NANDI,CHESUMEI,33,1138,1321,2459
NANDI,CHESUMEI,34,1048,1154,2202
NANDI,CHESUMEI,30-34,5898,6581,12479
NANDI,CHESUMEI,35,1315,1326,2641
NANDI,CHESUMEI,36,873,813,1686
NANDI,CHESUMEI,37,943,814,1757
NANDI,CHESUMEI,38,627,577,1204
NANDI,CHESUMEI,39,876,819,1695
NANDI,CHESUMEI,35-39,4634,4349,8983
NANDI,CHESUMEI,40,928,853,1781
NANDI,CHESUMEI,41,880,783,1663
NANDI,CHESUMEI,42,782,816,1598
NANDI,CHESUMEI,43,773,801,1574
NANDI,CHESUMEI,44,606,606,1212
NANDI,CHESUMEI,40-44,3969,3859,7828
NANDI,CHESUMEI,45,888,840,1728
NANDI,CHESUMEI,46,646,673,1319
NANDI,CHESUMEI,47,663,668,1331
NANDI,CHESUMEI,48,445,474,919
NANDI,CHESUMEI,49,600,626,1226
NANDI,CHESUMEI,45-49,3242,3281,6523
NANDI,CHESUMEI,50,614,621,1235
NANDI,CHESUMEI,51,493,540,1033
NANDI,CHESUMEI,52,416,456,872
NANDI,CHESUMEI,53,369,396,765
NANDI,CHESUMEI,54,419,383,802
NANDI,CHESUMEI,50-54,2311,2396,4707
NANDI,CHESUMEI,55,419,337,756
NANDI,CHESUMEI,56,383,373,756
NANDI,CHESUMEI,57,391,565,956
NANDI,CHESUMEI,58,351,470,821
NANDI,CHESUMEI,59,440,428,868
NANDI,CHESUMEI,55-59,1984,2173,4157
NANDI,CHESUMEI,60,438,422,860
NANDI,CHESUMEI,61,350,344,694
NANDI,CHESUMEI,62,284,258,542
NANDI,CHESUMEI,63,246,291,537
NANDI,CHESUMEI,64,224,216,440
NANDI,CHESUMEI,60-64,1542,1531,3073
NANDI,CHESUMEI,65,276,319,595
NANDI,CHESUMEI,66,147,208,355
NANDI,CHESUMEI,67,260,301,561
NANDI,CHESUMEI,68,110,123,233
NANDI,CHESUMEI,69,234,249,483
NANDI,CHESUMEI,65-69,1027,1200,2227
NANDI,CHESUMEI,70,228,255,483
NANDI,CHESUMEI,71,174,196,370
NANDI,CHESUMEI,72,146,146,292
NANDI,CHESUMEI,73,114,137,251
NANDI,CHESUMEI,74,114,167,281
NANDI,CHESUMEI,70-74,776,901,1677
NANDI,CHESUMEI,75,117,131,248
NANDI,CHESUMEI,76,114,143,257
NANDI,CHESUMEI,77,105,115,220
NANDI,CHESUMEI,78,56,49,105
NANDI,CHESUMEI,79,79,126,205
NANDI,CHESUMEI,75-79,471,564,1035
NANDI,CHESUMEI,80,84,121,205
NANDI,CHESUMEI,81,57,76,133
NANDI,CHESUMEI,82,58,45,103
NANDI,CHESUMEI,83,58,60,118
NANDI,CHESUMEI,84,43,80,123
NANDI,CHESUMEI,80-84,300,382,682
NANDI,CHESUMEI,85,34,69,103
NANDI,CHESUMEI,86,38,35,73
NANDI,CHESUMEI,87,28,55,83
NANDI,CHESUMEI,88,18,22,40
NANDI,CHESUMEI,89,36,86,122
NANDI,CHESUMEI,85-89,154,267,421
NANDI,CHESUMEI,90,24,48,72
NANDI,CHESUMEI,91,12,28,40
NANDI,CHESUMEI,92,16,18,34
NANDI,CHESUMEI,93,13,16,29
NANDI,CHESUMEI,94,17,21,38
NANDI,CHESUMEI,90-94,82,131,213
NANDI,CHESUMEI,95,24,31,55
NANDI,CHESUMEI,96,5,9,14
NANDI,CHESUMEI,97,7,12,19
NANDI,CHESUMEI,98,7,12,19
NANDI,CHESUMEI,99,12,29,41
NANDI,CHESUMEI,95-99,55,93,148
NANDI,CHESUMEI,100+,13,54,67
NANDI,CHESUMEI,Not Stated,-,-,-
NANDI,NANDI CENTRAL,Total,73291,74255,147546
NANDI,NANDI CENTRAL,0,1695,1665,3360
NANDI,NANDI CENTRAL,1,1694,1683,3377
NANDI,NANDI CENTRAL,2,1724,1687,3411
NANDI,NANDI CENTRAL,3,1696,1798,3494
NANDI,NANDI CENTRAL,4,1829,1790,3619
NANDI,NANDI CENTRAL,0 - 4,8638,8623,17261
NANDI,NANDI CENTRAL,5,1709,1730,3439
NANDI,NANDI CENTRAL,6,1813,1778,3591
NANDI,NANDI CENTRAL,7,1913,1863,3776
NANDI,NANDI CENTRAL,8,1974,1813,3787
NANDI,NANDI CENTRAL,9,1928,1977,3905
NANDI,NANDI CENTRAL,05-Sep,9337,9161,18498
NANDI,NANDI CENTRAL,10,2042,2002,4044
NANDI,NANDI CENTRAL,11,1967,1943,3910
NANDI,NANDI CENTRAL,12,2196,2122,4318
NANDI,NANDI CENTRAL,13,2113,2118,4231
NANDI,NANDI CENTRAL,14,2021,2005,4026
NANDI,NANDI CENTRAL,Oct-14,10339,10190,20529
NANDI,NANDI CENTRAL,15,1893,1894,3787
NANDI,NANDI CENTRAL,16,1913,1870,3783
NANDI,NANDI CENTRAL,17,1952,1875,3827
NANDI,NANDI CENTRAL,18,1640,1510,3150
NANDI,NANDI CENTRAL,19,1696,1681,3377
NANDI,NANDI CENTRAL,15-19,9094,8830,17924
NANDI,NANDI CENTRAL,20,1471,1564,3035
NANDI,NANDI CENTRAL,21,1462,1477,2939
NANDI,NANDI CENTRAL,22,1309,1284,2593
NANDI,NANDI CENTRAL,23,1328,1440,2768
NANDI,NANDI CENTRAL,24,1144,1279,2423
NANDI,NANDI CENTRAL,20-24,6714,7044,13758
NANDI,NANDI CENTRAL,25,1269,1269,2538
NANDI,NANDI CENTRAL,26,1028,1143,2171
NANDI,NANDI CENTRAL,27,1102,1140,2242
NANDI,NANDI CENTRAL,28,893,1053,1946
NANDI,NANDI CENTRAL,29,1040,1186,2226
NANDI,NANDI CENTRAL,25-29,5332,5791,11123
NANDI,NANDI CENTRAL,30,1211,1350,2561
NANDI,NANDI CENTRAL,31,951,1022,1973
NANDI,NANDI CENTRAL,32,1205,1348,2553
NANDI,NANDI CENTRAL,33,1020,1229,2249
NANDI,NANDI CENTRAL,34,946,1030,1976
NANDI,NANDI CENTRAL,30-34,5333,5979,11312
NANDI,NANDI CENTRAL,35,1141,1162,2303
NANDI,NANDI CENTRAL,36,802,747,1549
NANDI,NANDI CENTRAL,37,824,692,1516
NANDI,NANDI CENTRAL,38,630,578,1208
NANDI,NANDI CENTRAL,39,699,626,1325
NANDI,NANDI CENTRAL,35-39,4096,3805,7901
NANDI,NANDI CENTRAL,40,757,689,1446
NANDI,NANDI CENTRAL,41,804,692,1496
NANDI,NANDI CENTRAL,42,773,689,1462
NANDI,NANDI CENTRAL,43,707,701,1408
NANDI,NANDI CENTRAL,44,562,564,1126
NANDI,NANDI CENTRAL,40-44,3603,3335,6938
NANDI,NANDI CENTRAL,45,756,768,1524
NANDI,NANDI CENTRAL,46,602,578,1180
NANDI,NANDI CENTRAL,47,599,642,1241
NANDI,NANDI CENTRAL,48,430,384,814
NANDI,NANDI CENTRAL,49,525,516,1041
NANDI,NANDI CENTRAL,45-49,2912,2888,5800
NANDI,NANDI CENTRAL,50,501,537,1038
NANDI,NANDI CENTRAL,51,471,463,934
NANDI,NANDI CENTRAL,52,362,374,736
NANDI,NANDI CENTRAL,53,318,350,668
NANDI,NANDI CENTRAL,54,355,309,664
NANDI,NANDI CENTRAL,50-54,2007,2033,4040
NANDI,NANDI CENTRAL,55,371,313,684
NANDI,NANDI CENTRAL,56,354,398,752
NANDI,NANDI CENTRAL,57,298,416,714
NANDI,NANDI CENTRAL,58,370,384,754
NANDI,NANDI CENTRAL,59,372,429,801
NANDI,NANDI CENTRAL,55-59,1765,1940,3705
NANDI,NANDI CENTRAL,60,353,369,722
NANDI,NANDI CENTRAL,61,309,315,624
NANDI,NANDI CENTRAL,62,251,251,502
NANDI,NANDI CENTRAL,63,260,300,560
NANDI,NANDI CENTRAL,64,205,205,410
NANDI,NANDI CENTRAL,60-64,1378,1440,2818
NANDI,NANDI CENTRAL,65,305,295,600
NANDI,NANDI CENTRAL,66,174,168,342
NANDI,NANDI CENTRAL,67,292,299,591
NANDI,NANDI CENTRAL,68,131,138,269
NANDI,NANDI CENTRAL,69,187,214,401
NANDI,NANDI CENTRAL,65-69,1089,1114,2203
NANDI,NANDI CENTRAL,70,185,228,413
NANDI,NANDI CENTRAL,71,158,165,323
NANDI,NANDI CENTRAL,72,136,118,254
NANDI,NANDI CENTRAL,73,108,97,205
NANDI,NANDI CENTRAL,74,85,159,244
NANDI,NANDI CENTRAL,70-74,672,767,1439
NANDI,NANDI CENTRAL,75,112,130,242
NANDI,NANDI CENTRAL,76,102,143,245
NANDI,NANDI CENTRAL,77,87,101,188
NANDI,NANDI CENTRAL,78,53,69,122
NANDI,NANDI CENTRAL,79,61,124,185
NANDI,NANDI CENTRAL,75-79,415,567,982
NANDI,NANDI CENTRAL,80,88,102,190
NANDI,NANDI CENTRAL,81,42,49,91
NANDI,NANDI CENTRAL,82,45,28,73
NANDI,NANDI CENTRAL,83,58,71,129
NANDI,NANDI CENTRAL,84,40,62,102
NANDI,NANDI CENTRAL,80-84,273,312,585
NANDI,NANDI CENTRAL,85,48,46,94
NANDI,NANDI CENTRAL,86,29,43,72
NANDI,NANDI CENTRAL,87,31,33,64
NANDI,NANDI CENTRAL,88,13,22,35
NANDI,NANDI CENTRAL,89,29,76,105
NANDI,NANDI CENTRAL,85-89,150,220,370
NANDI,NANDI CENTRAL,90,24,33,57
NANDI,NANDI CENTRAL,91,13,20,33
NANDI,NANDI CENTRAL,92,11,20,31
NANDI,NANDI CENTRAL,93,18,19,37
NANDI,NANDI CENTRAL,94,13,20,33
NANDI,NANDI CENTRAL,90-94,79,112,191
NANDI,NANDI CENTRAL,95,23,23,46
NANDI,NANDI CENTRAL,96,8,4,12
NANDI,NANDI CENTRAL,97,11,12,23
NANDI,NANDI CENTRAL,98,7,10,17
NANDI,NANDI CENTRAL,99,4,17,21
NANDI,NANDI CENTRAL,95-99,53,66,119
NANDI,NANDI CENTRAL,100+,12,38,50
NANDI,NANDI CENTRAL,Not Stated,-,-,-
NANDI,NANDI EAST,Total,59899,59271,119170
NANDI,NANDI EAST,0,1352,1289,2641
NANDI,NANDI EAST,1,1373,1347,2720
NANDI,NANDI EAST,2,1402,1417,2819
NANDI,NANDI EAST,3,1516,1486,3002
NANDI,NANDI EAST,4,1583,1604,3187
NANDI,NANDI EAST,0 - 4,7226,7143,14369
NANDI,NANDI EAST,5,1568,1514,3082
NANDI,NANDI EAST,6,1524,1535,3059
NANDI,NANDI EAST,7,1559,1457,3016
NANDI,NANDI EAST,8,1448,1515,2963
NANDI,NANDI EAST,9,1690,1656,3346
NANDI,NANDI EAST,05-Sep,7789,7677,15466
NANDI,NANDI EAST,10,1652,1575,3227
NANDI,NANDI EAST,11,1600,1676,3276
NANDI,NANDI EAST,12,1772,1675,3447
NANDI,NANDI EAST,13,1654,1802,3456
NANDI,NANDI EAST,14,1577,1625,3202
NANDI,NANDI EAST,Oct-14,8255,8353,16608
NANDI,NANDI EAST,15,1567,1550,3117
NANDI,NANDI EAST,16,1441,1438,2879
NANDI,NANDI EAST,17,1485,1450,2935
NANDI,NANDI EAST,18,1128,1105,2233
NANDI,NANDI EAST,19,1307,1332,2639
NANDI,NANDI EAST,15-19,6928,6875,13803
NANDI,NANDI EAST,20,1047,1104,2151
NANDI,NANDI EAST,21,1065,1141,2206
NANDI,NANDI EAST,22,1051,1106,2157
NANDI,NANDI EAST,23,1035,1255,2290
NANDI,NANDI EAST,24,1004,1092,2096
NANDI,NANDI EAST,20-24,5202,5698,10900
NANDI,NANDI EAST,25,1064,1183,2247
NANDI,NANDI EAST,26,923,1006,1929
NANDI,NANDI EAST,27,921,1056,1977
NANDI,NANDI EAST,28,767,852,1619
NANDI,NANDI EAST,29,910,941,1851
NANDI,NANDI EAST,25-29,4585,5038,9623
NANDI,NANDI EAST,30,927,1130,2057
NANDI,NANDI EAST,31,852,975,1827
NANDI,NANDI EAST,32,1035,1129,2164
NANDI,NANDI EAST,33,875,1019,1894
NANDI,NANDI EAST,34,760,835,1595
NANDI,NANDI EAST,30-34,4449,5088,9537
NANDI,NANDI EAST,35,989,956,1945
NANDI,NANDI EAST,36,732,497,1229
NANDI,NANDI EAST,37,756,585,1341
NANDI,NANDI EAST,38,534,410,944
NANDI,NANDI EAST,39,689,525,1214
NANDI,NANDI EAST,35-39,3700,2973,6673
NANDI,NANDI EAST,40,681,584,1265
NANDI,NANDI EAST,41,781,630,1411
NANDI,NANDI EAST,42,670,565,1235
NANDI,NANDI EAST,43,666,596,1262
NANDI,NANDI EAST,44,533,464,997
NANDI,NANDI EAST,40-44,3331,2839,6170
NANDI,NANDI EAST,45,725,568,1293
NANDI,NANDI EAST,46,628,468,1096
NANDI,NANDI EAST,47,584,490,1074
NANDI,NANDI EAST,48,355,289,644
NANDI,NANDI EAST,49,491,387,878
NANDI,NANDI EAST,45-49,2783,2202,4985
NANDI,NANDI EAST,50,381,349,730
NANDI,NANDI EAST,51,385,298,683
NANDI,NANDI EAST,52,321,280,601
NANDI,NANDI EAST,53,292,257,549
NANDI,NANDI EAST,54,295,257,552
NANDI,NANDI EAST,50-54,1674,1441,3115
NANDI,NANDI EAST,55,298,177,475
NANDI,NANDI EAST,56,230,207,437
NANDI,NANDI EAST,57,250,253,503
NANDI,NANDI EAST,58,255,320,575
NANDI,NANDI EAST,59,224,233,457
NANDI,NANDI EAST,55-59,1257,1190,2447
NANDI,NANDI EAST,60,253,225,478
NANDI,NANDI EAST,61,187,195,382
NANDI,NANDI EAST,62,193,126,319
NANDI,NANDI EAST,63,138,150,288
NANDI,NANDI EAST,64,107,109,216
NANDI,NANDI EAST,60-64,878,805,1683
NANDI,NANDI EAST,65,182,161,343
NANDI,NANDI EAST,66,94,92,186
NANDI,NANDI EAST,67,198,176,374
NANDI,NANDI EAST,68,68,78,146
NANDI,NANDI EAST,69,121,138,259
NANDI,NANDI EAST,65-69,663,645,1308
NANDI,NANDI EAST,70,103,144,247
NANDI,NANDI EAST,71,132,119,251
NANDI,NANDI EAST,72,75,70,145
NANDI,NANDI EAST,73,69,79,148
NANDI,NANDI EAST,74,61,79,140
NANDI,NANDI EAST,70-74,440,491,931
NANDI,NANDI EAST,75,73,81,154
NANDI,NANDI EAST,76,78,62,140
NANDI,NANDI EAST,77,71,71,142
NANDI,NANDI EAST,78,38,32,70
NANDI,NANDI EAST,79,60,84,144
NANDI,NANDI EAST,75-79,320,330,650
NANDI,NANDI EAST,80,60,76,136
NANDI,NANDI EAST,81,36,48,84
NANDI,NANDI EAST,82,39,33,72
NANDI,NANDI EAST,83,32,28,60
NANDI,NANDI EAST,84,30,45,75
NANDI,NANDI EAST,80-84,197,230,427
NANDI,NANDI EAST,85,22,17,39
NANDI,NANDI EAST,86,28,20,48
NANDI,NANDI EAST,87,29,23,52
NANDI,NANDI EAST,88,15,19,34
NANDI,NANDI EAST,89,40,56,96
NANDI,NANDI EAST,85-89,134,135,269
NANDI,NANDI EAST,90,12,20,32
NANDI,NANDI EAST,91,14,14,28
NANDI,NANDI EAST,92,6,6,12
NANDI,NANDI EAST,93,12,10,22
NANDI,NANDI EAST,94,6,12,18
NANDI,NANDI EAST,90-94,50,62,112
NANDI,NANDI EAST,95,16,21,37
NANDI,NANDI EAST,96,2,4,6
NANDI,NANDI EAST,97,5,5,10
NANDI,NANDI EAST,98,2,1,3
NANDI,NANDI EAST,99,8,9,17
NANDI,NANDI EAST,95-99,33,40,73
NANDI,NANDI EAST,100+,5,15,20
NANDI,NANDI EAST,Not Stated,-,1,1
NANDI,NANDI NORTH,Total,82512,83656,166168
NANDI,NANDI NORTH,0,1868,1830,3698
NANDI,NANDI NORTH,1,1989,1930,3919
NANDI,NANDI NORTH,2,1964,1995,3959
NANDI,NANDI NORTH,3,2101,2078,4179
NANDI,NANDI NORTH,4,2151,2125,4276
NANDI,NANDI NORTH,0 - 4,10073,9958,20031
NANDI,NANDI NORTH,5,2132,2090,4222
NANDI,NANDI NORTH,6,2177,2206,4383
NANDI,NANDI NORTH,7,2340,2348,4688
NANDI,NANDI NORTH,8,2216,2153,4369
NANDI,NANDI NORTH,9,2583,2461,5044
NANDI,NANDI NORTH,05-Sep,11448,11258,22706
NANDI,NANDI NORTH,10,2378,2190,4568
NANDI,NANDI NORTH,11,2295,2346,4641
NANDI,NANDI NORTH,12,2670,2508,5178
NANDI,NANDI NORTH,13,2605,2476,5081
NANDI,NANDI NORTH,14,2418,2358,4776
NANDI,NANDI NORTH,Oct-14,12366,11878,24244
NANDI,NANDI NORTH,15,2342,2260,4602
NANDI,NANDI NORTH,16,2293,2159,4452
NANDI,NANDI NORTH,17,2369,2155,4524
NANDI,NANDI NORTH,18,1707,1642,3349
NANDI,NANDI NORTH,19,2065,1835,3900
NANDI,NANDI NORTH,15-19,10776,10051,20827
NANDI,NANDI NORTH,20,1633,1630,3263
NANDI,NANDI NORTH,21,1488,1531,3019
NANDI,NANDI NORTH,22,1270,1408,2678
NANDI,NANDI NORTH,23,1299,1444,2743
NANDI,NANDI NORTH,24,1179,1277,2456
NANDI,NANDI NORTH,20-24,6869,7290,14159
NANDI,NANDI NORTH,25,1233,1314,2547
NANDI,NANDI NORTH,26,1021,1287,2308
NANDI,NANDI NORTH,27,1147,1237,2384
NANDI,NANDI NORTH,28,812,919,1731
NANDI,NANDI NORTH,29,993,1204,2197
NANDI,NANDI NORTH,25-29,5206,5961,11167
NANDI,NANDI NORTH,30,1163,1267,2430
NANDI,NANDI NORTH,31,933,1108,2041
NANDI,NANDI NORTH,32,1190,1446,2636
NANDI,NANDI NORTH,33,1135,1392,2527
NANDI,NANDI NORTH,34,922,1108,2030
NANDI,NANDI NORTH,30-34,5343,6321,11664
NANDI,NANDI NORTH,35,1198,1240,2438
NANDI,NANDI NORTH,36,794,759,1553
NANDI,NANDI NORTH,37,886,691,1577
NANDI,NANDI NORTH,38,566,454,1020
NANDI,NANDI NORTH,39,741,720,1461
NANDI,NANDI NORTH,35-39,4185,3864,8049
NANDI,NANDI NORTH,40,790,737,1527
NANDI,NANDI NORTH,41,877,759,1636
NANDI,NANDI NORTH,42,877,754,1631
NANDI,NANDI NORTH,43,724,777,1501
NANDI,NANDI NORTH,44,640,621,1261
NANDI,NANDI NORTH,40-44,3908,3648,7556
NANDI,NANDI NORTH,45,894,824,1718
NANDI,NANDI NORTH,46,680,720,1400
NANDI,NANDI NORTH,47,710,681,1391
NANDI,NANDI NORTH,48,413,454,867
NANDI,NANDI NORTH,49,582,647,1229
NANDI,NANDI NORTH,45-49,3279,3326,6605
NANDI,NANDI NORTH,50,537,604,1141
NANDI,NANDI NORTH,51,539,538,1077
NANDI,NANDI NORTH,52,413,450,863
NANDI,NANDI NORTH,53,349,380,729
NANDI,NANDI NORTH,54,372,372,744
NANDI,NANDI NORTH,50-54,2210,2344,4554
NANDI,NANDI NORTH,55,360,355,715
NANDI,NANDI NORTH,56,401,391,792
NANDI,NANDI NORTH,57,416,552,968
NANDI,NANDI NORTH,58,376,437,813
NANDI,NANDI NORTH,59,401,394,795
NANDI,NANDI NORTH,55-59,1954,2129,4083
NANDI,NANDI NORTH,60,436,383,819
NANDI,NANDI NORTH,61,345,316,661
NANDI,NANDI NORTH,62,266,262,528
NANDI,NANDI NORTH,63,251,291,542
NANDI,NANDI NORTH,64,194,243,437
NANDI,NANDI NORTH,60-64,1492,1495,2987
NANDI,NANDI NORTH,65,282,337,619
NANDI,NANDI NORTH,66,159,221,380
NANDI,NANDI NORTH,67,326,360,686
NANDI,NANDI NORTH,68,114,147,261
NANDI,NANDI NORTH,69,240,270,510
NANDI,NANDI NORTH,65-69,1121,1335,2456
NANDI,NANDI NORTH,70,220,315,535
NANDI,NANDI NORTH,71,200,221,421
NANDI,NANDI NORTH,72,178,162,340
NANDI,NANDI NORTH,73,152,167,319
NANDI,NANDI NORTH,74,135,138,273
NANDI,NANDI NORTH,70-74,885,1003,1888
NANDI,NANDI NORTH,75,143,177,320
NANDI,NANDI NORTH,76,144,177,321
NANDI,NANDI NORTH,77,164,151,315
NANDI,NANDI NORTH,78,66,73,139
NANDI,NANDI NORTH,79,118,147,265
NANDI,NANDI NORTH,75-79,635,725,1360
NANDI,NANDI NORTH,80,106,129,235
NANDI,NANDI NORTH,81,58,63,121
NANDI,NANDI NORTH,82,75,42,117
NANDI,NANDI NORTH,83,70,82,152
NANDI,NANDI NORTH,84,52,60,112
NANDI,NANDI NORTH,80-84,361,376,737
NANDI,NANDI NORTH,85,48,64,112
NANDI,NANDI NORTH,86,54,50,104
NANDI,NANDI NORTH,87,45,59,104
NANDI,NANDI NORTH,88,22,24,46
NANDI,NANDI NORTH,89,27,108,135
NANDI,NANDI NORTH,85-89,196,305,501
NANDI,NANDI NORTH,90,32,44,76
NANDI,NANDI NORTH,91,26,44,70
NANDI,NANDI NORTH,92,21,25,46
NANDI,NANDI NORTH,93,26,29,55
NANDI,NANDI NORTH,94,12,29,41
NANDI,NANDI NORTH,90-94,117,171,288
NANDI,NANDI NORTH,95,41,70,111
NANDI,NANDI NORTH,96,7,8,15
NANDI,NANDI NORTH,97,9,16,25
NANDI,NANDI NORTH,98,3,12,15
NANDI,NANDI NORTH,99,11,45,56
NANDI,NANDI NORTH,95-99,71,151,222
NANDI,NANDI NORTH,100+,17,66,83
NANDI,NANDI NORTH,Not Stated,-,1,1
NANDI,NANDI SOUTH,Total,85718,87029,172747
NANDI,NANDI SOUTH,0,1941,1871,3812
NANDI,NANDI SOUTH,1,1888,1971,3859
NANDI,NANDI SOUTH,2,2103,2008,4111
NANDI,NANDI SOUTH,3,2135,2141,4276
NANDI,NANDI SOUTH,4,2178,2026,4204
NANDI,NANDI SOUTH,0 - 4,10245,10017,20262
NANDI,NANDI SOUTH,5,2188,2097,4285
NANDI,NANDI SOUTH,6,2178,2301,4479
NANDI,NANDI SOUTH,7,2355,2301,4656
NANDI,NANDI SOUTH,8,2287,2239,4526
NANDI,NANDI SOUTH,9,2518,2527,5045
NANDI,NANDI SOUTH,05-Sep,11526,11465,22991
NANDI,NANDI SOUTH,10,2578,2395,4973
NANDI,NANDI SOUTH,11,2367,2519,4886
NANDI,NANDI SOUTH,12,2686,2528,5214
NANDI,NANDI SOUTH,13,2694,2530,5224
NANDI,NANDI SOUTH,14,2548,2432,4980
NANDI,NANDI SOUTH,Oct-14,12873,12404,25277
NANDI,NANDI SOUTH,15,2455,2453,4908
NANDI,NANDI SOUTH,16,2282,2215,4497
NANDI,NANDI SOUTH,17,2347,2269,4616
NANDI,NANDI SOUTH,18,1932,1789,3721
NANDI,NANDI SOUTH,19,2115,1885,4000
NANDI,NANDI SOUTH,15-19,11131,10611,21742
NANDI,NANDI SOUTH,20,1736,1736,3472
NANDI,NANDI SOUTH,21,1577,1534,3111
NANDI,NANDI SOUTH,22,1392,1547,2939
NANDI,NANDI SOUTH,23,1408,1576,2984
NANDI,NANDI SOUTH,24,1210,1310,2520
NANDI,NANDI SOUTH,20-24,7323,7703,15026
NANDI,NANDI SOUTH,25,1347,1470,2817
NANDI,NANDI SOUTH,26,1086,1316,2402
NANDI,NANDI SOUTH,27,1211,1301,2512
NANDI,NANDI SOUTH,28,905,1038,1943
NANDI,NANDI SOUTH,29,1082,1203,2285
NANDI,NANDI SOUTH,25-29,5631,6328,11959
NANDI,NANDI SOUTH,30,1228,1430,2658
NANDI,NANDI SOUTH,31,999,1109,2108
NANDI,NANDI SOUTH,32,1226,1392,2618
NANDI,NANDI SOUTH,33,1100,1299,2399
NANDI,NANDI SOUTH,34,955,1093,2048
NANDI,NANDI SOUTH,30-34,5508,6323,11831
NANDI,NANDI SOUTH,35,1259,1213,2472
NANDI,NANDI SOUTH,36,806,726,1532
NANDI,NANDI SOUTH,37,917,759,1676
NANDI,NANDI SOUTH,38,617,534,1151
NANDI,NANDI SOUTH,39,805,645,1450
NANDI,NANDI SOUTH,35-39,4404,3877,8281
NANDI,NANDI SOUTH,40,743,729,1472
NANDI,NANDI SOUTH,41,812,795,1607
NANDI,NANDI SOUTH,42,792,794,1586
NANDI,NANDI SOUTH,43,798,902,1700
NANDI,NANDI SOUTH,44,617,633,1250
NANDI,NANDI SOUTH,40-44,3762,3853,7615
NANDI,NANDI SOUTH,45,904,871,1775
NANDI,NANDI SOUTH,46,646,639,1285
NANDI,NANDI SOUTH,47,673,718,1391
NANDI,NANDI SOUTH,48,416,477,893
NANDI,NANDI SOUTH,49,589,669,1258
NANDI,NANDI SOUTH,45-49,3228,3374,6602
NANDI,NANDI SOUTH,50,558,595,1153
NANDI,NANDI SOUTH,51,536,549,1085
NANDI,NANDI SOUTH,52,399,454,853
NANDI,NANDI SOUTH,53,335,449,784
NANDI,NANDI SOUTH,54,424,423,847
NANDI,NANDI SOUTH,50-54,2252,2470,4722
NANDI,NANDI SOUTH,55,458,428,886
NANDI,NANDI SOUTH,56,417,457,874
NANDI,NANDI SOUTH,57,423,543,966
NANDI,NANDI SOUTH,58,402,466,868
NANDI,NANDI SOUTH,59,498,483,981
NANDI,NANDI SOUTH,55-59,2198,2377,4575
NANDI,NANDI SOUTH,60,487,528,1015
NANDI,NANDI SOUTH,61,416,369,785
NANDI,NANDI SOUTH,62,319,317,636
NANDI,NANDI SOUTH,63,310,341,651
NANDI,NANDI SOUTH,64,245,253,498
NANDI,NANDI SOUTH,60-64,1777,1808,3585
NANDI,NANDI SOUTH,65,379,443,822
NANDI,NANDI SOUTH,66,252,257,509
NANDI,NANDI SOUTH,67,373,365,738
NANDI,NANDI SOUTH,68,170,182,352
NANDI,NANDI SOUTH,69,260,320,580
NANDI,NANDI SOUTH,65-69,1434,1567,3001
NANDI,NANDI SOUTH,70,267,357,624
NANDI,NANDI SOUTH,71,234,243,477
NANDI,NANDI SOUTH,72,188,162,350
NANDI,NANDI SOUTH,73,148,137,285
NANDI,NANDI SOUTH,74,170,168,338
NANDI,NANDI SOUTH,70-74,1007,1067,2074
NANDI,NANDI SOUTH,75,163,153,316
NANDI,NANDI SOUTH,76,145,191,336
NANDI,NANDI SOUTH,77,140,148,288
NANDI,NANDI SOUTH,78,75,64,139
NANDI,NANDI SOUTH,79,95,166,261
NANDI,NANDI SOUTH,75-79,618,722,1340
NANDI,NANDI SOUTH,80,105,160,265
NANDI,NANDI SOUTH,81,76,92,168
NANDI,NANDI SOUTH,82,61,69,130
NANDI,NANDI SOUTH,83,88,74,162
NANDI,NANDI SOUTH,84,62,79,141
NANDI,NANDI SOUTH,80-84,392,474,866
NANDI,NANDI SOUTH,85,50,60,110
NANDI,NANDI SOUTH,86,44,59,103
NANDI,NANDI SOUTH,87,52,82,134
NANDI,NANDI SOUTH,88,24,26,50
NANDI,NANDI SOUTH,89,64,97,161
NANDI,NANDI SOUTH,85-89,234,324,558
NANDI,NANDI SOUTH,90,22,43,65
NANDI,NANDI SOUTH,91,22,25,47
NANDI,NANDI SOUTH,92,22,21,43
NANDI,NANDI SOUTH,93,16,11,27
NANDI,NANDI SOUTH,94,13,27,40
NANDI,NANDI SOUTH,90-94,95,127,222
NANDI,NANDI SOUTH,95,25,50,75
NANDI,NANDI SOUTH,96,8,5,13
NANDI,NANDI SOUTH,97,9,15,24
NANDI,NANDI SOUTH,98,6,9,15
NANDI,NANDI SOUTH,99,13,23,36
NANDI,NANDI SOUTH,95-99,61,102,163
NANDI,NANDI SOUTH,100+,19,36,55
NANDI,NANDI SOUTH,Not Stated,-,-,-
NANDI,TINDERET,Total,58890,57039,115929
NANDI,TINDERET,0,1381,1273,2654
NANDI,TINDERET,1,1463,1434,2897
NANDI,TINDERET,2,1490,1507,2997
NANDI,TINDERET,3,1565,1556,3121
NANDI,TINDERET,4,1651,1577,3228
NANDI,TINDERET,0 - 4,7550,7347,14897
NANDI,TINDERET,5,1672,1619,3291
NANDI,TINDERET,6,1612,1579,3191
NANDI,TINDERET,7,1695,1590,3285
NANDI,TINDERET,8,1701,1576,3277
NANDI,TINDERET,9,1848,1823,3671
NANDI,TINDERET,05-Sep,8528,8187,16715
NANDI,TINDERET,10,1710,1750,3460
NANDI,TINDERET,11,1707,1767,3474
NANDI,TINDERET,12,1845,1825,3670
NANDI,TINDERET,13,1793,1759,3552
NANDI,TINDERET,14,1771,1665,3436
NANDI,TINDERET,Oct-14,8826,8766,17592
NANDI,TINDERET,15,1806,1657,3463
NANDI,TINDERET,16,1583,1422,3005
NANDI,TINDERET,17,1529,1438,2967
NANDI,TINDERET,18,1131,1124,2255
NANDI,TINDERET,19,1445,1301,2746
NANDI,TINDERET,15-19,7494,6942,14436
NANDI,TINDERET,20,1136,1121,2257
NANDI,TINDERET,21,1140,1102,2242
NANDI,TINDERET,22,1007,1013,2020
NANDI,TINDERET,23,1035,1155,2190
NANDI,TINDERET,24,897,960,1857
NANDI,TINDERET,20-24,5215,5351,10566
NANDI,TINDERET,25,994,1002,1996
NANDI,TINDERET,26,823,886,1709
NANDI,TINDERET,27,825,916,1741
NANDI,TINDERET,28,585,710,1295
NANDI,TINDERET,29,770,864,1634
NANDI,TINDERET,25-29,3997,4378,8375
NANDI,TINDERET,30,815,884,1699
NANDI,TINDERET,31,794,807,1601
NANDI,TINDERET,32,875,964,1839
NANDI,TINDERET,33,820,870,1690
NANDI,TINDERET,34,741,714,1455
NANDI,TINDERET,30-34,4045,4239,8284
NANDI,TINDERET,35,831,795,1626
NANDI,TINDERET,36,598,394,992
NANDI,TINDERET,37,600,448,1048
NANDI,TINDERET,38,425,294,719
NANDI,TINDERET,39,482,345,827
NANDI,TINDERET,35-39,2936,2276,5212
NANDI,TINDERET,40,500,427,927
NANDI,TINDERET,41,626,499,1125
NANDI,TINDERET,42,540,454,994
NANDI,TINDERET,43,481,468,949
NANDI,TINDERET,44,436,352,788
NANDI,TINDERET,40-44,2583,2200,4783
NANDI,TINDERET,45,607,531,1138
NANDI,TINDERET,46,455,368,823
NANDI,TINDERET,47,470,417,887
NANDI,TINDERET,48,273,246,519
NANDI,TINDERET,49,396,333,729
NANDI,TINDERET,45-49,2201,1895,4096
NANDI,TINDERET,50,355,312,667
NANDI,TINDERET,51,315,332,647
NANDI,TINDERET,52,259,239,498
NANDI,TINDERET,53,205,202,407
NANDI,TINDERET,54,235,213,448
NANDI,TINDERET,50-54,1369,1298,2667
NANDI,TINDERET,55,297,212,509
NANDI,TINDERET,56,213,184,397
NANDI,TINDERET,57,198,261,459
NANDI,TINDERET,58,251,371,622
NANDI,TINDERET,59,238,244,482
NANDI,TINDERET,55-59,1197,1272,2469
NANDI,TINDERET,60,246,262,508
NANDI,TINDERET,61,225,214,439
NANDI,TINDERET,62,183,161,344
NANDI,TINDERET,63,192,164,356
NANDI,TINDERET,64,130,125,255
NANDI,TINDERET,60-64,976,926,1902
NANDI,TINDERET,65,164,187,351
NANDI,TINDERET,66,111,103,214
NANDI,TINDERET,67,214,208,422
NANDI,TINDERET,68,84,78,162
NANDI,TINDERET,69,144,148,292
NANDI,TINDERET,65-69,717,724,1441
NANDI,TINDERET,70,169,150,319
NANDI,TINDERET,71,158,98,256
NANDI,TINDERET,72,96,75,171
NANDI,TINDERET,73,76,64,140
NANDI,TINDERET,74,70,74,144
NANDI,TINDERET,70-74,569,461,1030
NANDI,TINDERET,75,70,72,142
NANDI,TINDERET,76,56,58,114
NANDI,TINDERET,77,79,62,141
NANDI,TINDERET,78,35,40,75
NANDI,TINDERET,79,59,91,150
NANDI,TINDERET,75-79,299,323,622
NANDI,TINDERET,80,53,70,123
NANDI,TINDERET,81,26,26,52
NANDI,TINDERET,82,26,19,45
NANDI,TINDERET,83,29,32,61
NANDI,TINDERET,84,27,41,68
NANDI,TINDERET,80-84,161,188,349
NANDI,TINDERET,85,25,28,53
NANDI,TINDERET,86,26,22,48
NANDI,TINDERET,87,25,20,45
NANDI,TINDERET,88,15,8,23
NANDI,TINDERET,89,31,46,77
NANDI,TINDERET,85-89,122,124,246
NANDI,TINDERET,90,17,30,47
NANDI,TINDERET,91,10,14,24
NANDI,TINDERET,92,8,9,17
NANDI,TINDERET,93,4,8,12
NANDI,TINDERET,94,10,12,22
NANDI,TINDERET,90-94,49,73,122
NANDI,TINDERET,95,13,16,29
NANDI,TINDERET,96,7,9,16
NANDI,TINDERET,97,11,4,15
NANDI,TINDERET,98,3,1,4
NANDI,TINDERET,99,9,10,19
NANDI,TINDERET,95-99,43,40,83
NANDI,TINDERET,100+,13,29,42
NANDI,TINDERET,Not Stated,-,-,-
NAROK,ALL,Total,579042,578805,1157847
NAROK,ALL,0,16272,16257,32529
NAROK,ALL,1,17399,17038,34437
NAROK,ALL,2,18876,18696,37572
NAROK,ALL,3,20419,20420,40839
NAROK,ALL,4,21445,21074,42519
NAROK,ALL,0 - 4,94411,93485,187896
NAROK,ALL,5,21324,20563,41887
NAROK,ALL,6,21289,20931,42220
NAROK,ALL,7,19564,19491,39055
NAROK,ALL,8,19753,19293,39046
NAROK,ALL,9,18591,18238,36829
NAROK,ALL,05-Sep,100521,98516,199037
NAROK,ALL,10,22039,21166,43205
NAROK,ALL,11,15701,15991,31692
NAROK,ALL,12,20230,18589,38819
NAROK,ALL,13,17151,16901,34052
NAROK,ALL,14,15932,15717,31649
NAROK,ALL,Oct-14,91053,88364,179417
NAROK,ALL,15,16300,15334,31634
NAROK,ALL,16,13253,12322,25575
NAROK,ALL,17,12879,11086,23965
NAROK,ALL,18,11034,9980,21014
NAROK,ALL,19,11317,11318,22635
NAROK,ALL,15-19,64783,60040,124823
NAROK,ALL,20,11643,13467,25110
NAROK,ALL,21,8724,10043,18767
NAROK,ALL,22,9454,10773,20227
NAROK,ALL,23,9059,10059,19118
NAROK,ALL,24,8408,8983,17391
NAROK,ALL,20-24,47288,53325,100613
NAROK,ALL,25,10358,11304,21662
NAROK,ALL,26,7627,8620,16247
NAROK,ALL,27,7937,8916,16853
NAROK,ALL,28,6693,7880,14573
NAROK,ALL,29,6353,7267,13620
NAROK,ALL,25-29,38968,43987,82955
NAROK,ALL,30,10428,11695,22123
NAROK,ALL,31,5708,6426,12134
NAROK,ALL,32,7786,8306,16092
NAROK,ALL,33,5875,6510,12385
NAROK,ALL,34,5420,5148,10568
NAROK,ALL,30-34,35217,38085,73302
NAROK,ALL,35,8926,8364,17290
NAROK,ALL,36,4434,3826,8260
NAROK,ALL,37,4934,4243,9177
NAROK,ALL,38,3604,3231,6835
NAROK,ALL,39,3815,3310,7125
NAROK,ALL,35-39,25713,22974,48687
NAROK,ALL,40,6221,5752,11973
NAROK,ALL,41,4945,4751,9696
NAROK,ALL,42,4514,4163,8677
NAROK,ALL,43,3416,3409,6825
NAROK,ALL,44,2553,2491,5044
NAROK,ALL,40-44,21649,20566,42215
NAROK,ALL,45,5905,5278,11183
NAROK,ALL,46,3430,3148,6578
NAROK,ALL,47,3683,3676,7359
NAROK,ALL,48,2308,1969,4277
NAROK,ALL,49,2635,2575,5210
NAROK,ALL,45-49,17961,16646,34607
NAROK,ALL,50,4240,4431,8671
NAROK,ALL,51,2260,2132,4392
NAROK,ALL,52,2123,1869,3992
NAROK,ALL,53,1519,1334,2853
NAROK,ALL,54,1910,1684,3594
NAROK,ALL,50-54,12052,11450,23502
NAROK,ALL,55,2058,1970,4028
NAROK,ALL,56,1892,1797,3689
NAROK,ALL,57,1560,1600,3160
NAROK,ALL,58,1769,2221,3990
NAROK,ALL,59,1610,1876,3486
NAROK,ALL,55-59,8889,9464,18353
NAROK,ALL,60,2613,2849,5462
NAROK,ALL,61,1232,1386,2618
NAROK,ALL,62,1148,1074,2222
NAROK,ALL,63,1104,1276,2380
NAROK,ALL,64,861,830,1691
NAROK,ALL,60-64,6958,7415,14373
NAROK,ALL,65,1640,1625,3265
NAROK,ALL,66,664,515,1179
NAROK,ALL,67,1228,1008,2236
NAROK,ALL,68,553,540,1093
NAROK,ALL,69,908,962,1870
NAROK,ALL,65-69,4993,4650,9643
NAROK,ALL,70,1426,1874,3300
NAROK,ALL,71,727,685,1412
NAROK,ALL,72,630,552,1182
NAROK,ALL,73,526,472,998
NAROK,ALL,74,549,612,1161
NAROK,ALL,70-74,3858,4195,8053
NAROK,ALL,75,624,684,1308
NAROK,ALL,76,361,338,699
NAROK,ALL,77,373,355,728
NAROK,ALL,78,284,248,532
NAROK,ALL,79,423,525,948
NAROK,ALL,75-79,2065,2150,4215
NAROK,ALL,80,578,849,1427
NAROK,ALL,81,218,219,437
NAROK,ALL,82,191,164,355
NAROK,ALL,83,163,163,326
NAROK,ALL,84,183,271,454
NAROK,ALL,80-84,1333,1666,2999
NAROK,ALL,85,198,228,426
NAROK,ALL,86,94,116,210
NAROK,ALL,87,131,157,288
NAROK,ALL,88,72,76,148
NAROK,ALL,89,185,287,472
NAROK,ALL,85-89,680,864,1544
NAROK,ALL,90,129,248,377
NAROK,ALL,91,48,56,104
NAROK,ALL,92,55,49,104
NAROK,ALL,93,39,43,82
NAROK,ALL,94,55,59,114
NAROK,ALL,90-94,326,455,781
NAROK,ALL,95,80,104,184
NAROK,ALL,96,20,34,54
NAROK,ALL,97,35,27,62
NAROK,ALL,98,21,30,51
NAROK,ALL,99,43,65,108
NAROK,ALL,95-99,199,260,459
NAROK,ALL,100+,118,244,362
NAROK,ALL,Not Stated,7,4,11
NAROK,NAROK EAST,Total,58699,56617,115316
NAROK,NAROK EAST,0,1592,1554,3146
NAROK,NAROK EAST,1,1706,1654,3360
NAROK,NAROK EAST,2,1903,1829,3732
NAROK,NAROK EAST,3,2082,2022,4104
NAROK,NAROK EAST,4,2085,2061,4146
NAROK,NAROK EAST,0 - 4,9368,9120,18488
NAROK,NAROK EAST,5,2220,2112,4332
NAROK,NAROK EAST,6,2209,2017,4226
NAROK,NAROK EAST,7,2020,1954,3974
NAROK,NAROK EAST,8,2052,1987,4039
NAROK,NAROK EAST,9,1826,1789,3615
NAROK,NAROK EAST,05-Sep,10327,9859,20186
NAROK,NAROK EAST,10,2413,2176,4589
NAROK,NAROK EAST,11,1411,1484,2895
NAROK,NAROK EAST,12,2133,1851,3984
NAROK,NAROK EAST,13,1686,1703,3389
NAROK,NAROK EAST,14,1624,1542,3166
NAROK,NAROK EAST,Oct-14,9267,8756,18023
NAROK,NAROK EAST,15,1632,1530,3162
NAROK,NAROK EAST,16,1330,1249,2579
NAROK,NAROK EAST,17,1262,1102,2364
NAROK,NAROK EAST,18,1113,979,2092
NAROK,NAROK EAST,19,1028,985,2013
NAROK,NAROK EAST,15-19,6365,5845,12210
NAROK,NAROK EAST,20,1225,1380,2605
NAROK,NAROK EAST,21,867,870,1737
NAROK,NAROK EAST,22,931,1017,1948
NAROK,NAROK EAST,23,807,874,1681
NAROK,NAROK EAST,24,757,788,1545
NAROK,NAROK EAST,20-24,4587,4929,9516
NAROK,NAROK EAST,25,1084,1162,2246
NAROK,NAROK EAST,26,688,730,1418
NAROK,NAROK EAST,27,730,813,1543
NAROK,NAROK EAST,28,706,810,1516
NAROK,NAROK EAST,29,545,588,1133
NAROK,NAROK EAST,25-29,3753,4103,7856
NAROK,NAROK EAST,30,1113,1229,2342
NAROK,NAROK EAST,31,479,482,961
NAROK,NAROK EAST,32,785,746,1531
NAROK,NAROK EAST,33,566,589,1155
NAROK,NAROK EAST,34,556,497,1053
NAROK,NAROK EAST,30-34,3499,3543,7042
NAROK,NAROK EAST,35,1112,1061,2173
NAROK,NAROK EAST,36,417,367,784
NAROK,NAROK EAST,37,490,422,912
NAROK,NAROK EAST,38,436,344,780
NAROK,NAROK EAST,39,396,306,702
NAROK,NAROK EAST,35-39,2851,2500,5351
NAROK,NAROK EAST,40,852,692,1544
NAROK,NAROK EAST,41,488,439,927
NAROK,NAROK EAST,42,488,405,893
NAROK,NAROK EAST,43,350,293,643
NAROK,NAROK EAST,44,226,210,436
NAROK,NAROK EAST,40-44,2404,2039,4443
NAROK,NAROK EAST,45,621,561,1182
NAROK,NAROK EAST,46,350,301,651
NAROK,NAROK EAST,47,323,292,615
NAROK,NAROK EAST,48,247,183,430
NAROK,NAROK EAST,49,231,205,436
NAROK,NAROK EAST,45-49,1772,1542,3314
NAROK,NAROK EAST,50,494,487,981
NAROK,NAROK EAST,51,237,197,434
NAROK,NAROK EAST,52,268,230,498
NAROK,NAROK EAST,53,185,137,322
NAROK,NAROK EAST,54,228,204,432
NAROK,NAROK EAST,50-54,1412,1255,2667
NAROK,NAROK EAST,55,242,257,499
NAROK,NAROK EAST,56,249,210,459
NAROK,NAROK EAST,57,145,139,284
NAROK,NAROK EAST,58,132,107,239
NAROK,NAROK EAST,59,156,180,336
NAROK,NAROK EAST,55-59,924,893,1817
NAROK,NAROK EAST,60,336,300,636
NAROK,NAROK EAST,61,118,131,249
NAROK,NAROK EAST,62,104,95,199
NAROK,NAROK EAST,63,95,117,212
NAROK,NAROK EAST,64,80,79,159
NAROK,NAROK EAST,60-64,733,722,1455
NAROK,NAROK EAST,65,177,126,303
NAROK,NAROK EAST,66,46,50,96
NAROK,NAROK EAST,67,106,111,217
NAROK,NAROK EAST,68,64,69,133
NAROK,NAROK EAST,69,90,98,188
NAROK,NAROK EAST,65-69,483,454,937
NAROK,NAROK EAST,70,195,216,411
NAROK,NAROK EAST,71,80,58,138
NAROK,NAROK EAST,72,64,55,119
NAROK,NAROK EAST,73,44,56,100
NAROK,NAROK EAST,74,60,65,125
NAROK,NAROK EAST,70-74,443,450,893
NAROK,NAROK EAST,75,66,79,145
NAROK,NAROK EAST,76,40,45,85
NAROK,NAROK EAST,77,37,33,70
NAROK,NAROK EAST,78,25,27,52
NAROK,NAROK EAST,79,51,51,102
NAROK,NAROK EAST,75-79,219,235,454
NAROK,NAROK EAST,80,74,112,186
NAROK,NAROK EAST,81,27,20,47
NAROK,NAROK EAST,82,16,13,29
NAROK,NAROK EAST,83,17,15,32
NAROK,NAROK EAST,84,16,30,46
NAROK,NAROK EAST,80-84,150,190,340
NAROK,NAROK EAST,85,27,24,51
NAROK,NAROK EAST,86,9,6,15
NAROK,NAROK EAST,87,5,18,23
NAROK,NAROK EAST,88,6,4,10
NAROK,NAROK EAST,89,19,24,43
NAROK,NAROK EAST,85-89,66,76,142
NAROK,NAROK EAST,90,19,25,44
NAROK,NAROK EAST,91,3,7,10
NAROK,NAROK EAST,92,5,8,13
NAROK,NAROK EAST,93,6,6,12
NAROK,NAROK EAST,94,1,4,5
NAROK,NAROK EAST,90-94,34,50,84
NAROK,NAROK EAST,95,10,6,16
NAROK,NAROK EAST,96,1,2,3
NAROK,NAROK EAST,97,3,2,5
NAROK,NAROK EAST,98,-,3,3
NAROK,NAROK EAST,99,7,8,15
NAROK,NAROK EAST,95-99,21,21,42
NAROK,NAROK EAST,100+,21,35,56
NAROK,NAROK EAST,Not Stated,-,-,-
NAROK,NAROK NORTH,Total,128024,123829,251853
NAROK,NAROK NORTH,0,3496,3437,6933
NAROK,NAROK NORTH,1,3825,3860,7685
NAROK,NAROK NORTH,2,4001,3899,7900
NAROK,NAROK NORTH,3,4213,4098,8311
NAROK,NAROK NORTH,4,4346,4216,8562
NAROK,NAROK NORTH,0 - 4,19881,19510,39391
NAROK,NAROK NORTH,5,4126,3966,8092
NAROK,NAROK NORTH,6,4160,4061,8221
NAROK,NAROK NORTH,7,3939,3756,7695
NAROK,NAROK NORTH,8,3754,3763,7517
NAROK,NAROK NORTH,9,3698,3626,7324
NAROK,NAROK NORTH,05-Sep,19677,19172,38849
NAROK,NAROK NORTH,10,4270,4141,8411
NAROK,NAROK NORTH,11,3173,3229,6402
NAROK,NAROK NORTH,12,4001,3590,7591
NAROK,NAROK NORTH,13,3390,3443,6833
NAROK,NAROK NORTH,14,3145,3174,6319
NAROK,NAROK NORTH,Oct-14,17979,17577,35556
NAROK,NAROK NORTH,15,3129,3039,6168
NAROK,NAROK NORTH,16,2534,2657,5191
NAROK,NAROK NORTH,17,2789,2454,5243
NAROK,NAROK NORTH,18,2288,2086,4374
NAROK,NAROK NORTH,19,2350,2483,4833
NAROK,NAROK NORTH,15-19,13090,12719,25809
NAROK,NAROK NORTH,20,2617,2954,5571
NAROK,NAROK NORTH,21,2115,2376,4491
NAROK,NAROK NORTH,22,2352,2739,5091
NAROK,NAROK NORTH,23,2300,2468,4768
NAROK,NAROK NORTH,24,2167,2356,4523
NAROK,NAROK NORTH,20-24,11551,12893,24444
NAROK,NAROK NORTH,25,2639,2645,5284
NAROK,NAROK NORTH,26,2084,2096,4180
NAROK,NAROK NORTH,27,2129,2187,4316
NAROK,NAROK NORTH,28,1766,1855,3621
NAROK,NAROK NORTH,29,1692,1709,3401
NAROK,NAROK NORTH,25-29,10310,10492,20802
NAROK,NAROK NORTH,30,2587,2611,5198
NAROK,NAROK NORTH,31,1537,1378,2915
NAROK,NAROK NORTH,32,2066,2035,4101
NAROK,NAROK NORTH,33,1663,1608,3271
NAROK,NAROK NORTH,34,1586,1275,2861
NAROK,NAROK NORTH,30-34,9439,8907,18346
NAROK,NAROK NORTH,35,2212,1889,4101
NAROK,NAROK NORTH,36,1275,1046,2321
NAROK,NAROK NORTH,37,1286,1121,2407
NAROK,NAROK NORTH,38,1068,914,1982
NAROK,NAROK NORTH,39,1082,919,2001
NAROK,NAROK NORTH,35-39,6923,5889,12812
NAROK,NAROK NORTH,40,1579,1390,2969
NAROK,NAROK NORTH,41,1377,1276,2653
NAROK,NAROK NORTH,42,1154,892,2046
NAROK,NAROK NORTH,43,839,727,1566
NAROK,NAROK NORTH,44,611,512,1123
NAROK,NAROK NORTH,40-44,5560,4797,10357
NAROK,NAROK NORTH,45,1448,1033,2481
NAROK,NAROK NORTH,46,841,690,1531
NAROK,NAROK NORTH,47,878,710,1588
NAROK,NAROK NORTH,48,572,450,1022
NAROK,NAROK NORTH,49,669,520,1189
NAROK,NAROK NORTH,45-49,4408,3403,7811
NAROK,NAROK NORTH,50,999,983,1982
NAROK,NAROK NORTH,51,600,448,1048
NAROK,NAROK NORTH,52,549,424,973
NAROK,NAROK NORTH,53,376,289,665
NAROK,NAROK NORTH,54,507,446,953
NAROK,NAROK NORTH,50-54,3031,2590,5621
NAROK,NAROK NORTH,55,506,460,966
NAROK,NAROK NORTH,56,489,430,919
NAROK,NAROK NORTH,57,401,330,731
NAROK,NAROK NORTH,58,331,294,625
NAROK,NAROK NORTH,59,352,362,714
NAROK,NAROK NORTH,55-59,2079,1876,3955
NAROK,NAROK NORTH,60,515,545,1060
NAROK,NAROK NORTH,61,246,247,493
NAROK,NAROK NORTH,62,218,190,408
NAROK,NAROK NORTH,63,232,236,468
NAROK,NAROK NORTH,64,188,151,339
NAROK,NAROK NORTH,60-64,1399,1369,2768
NAROK,NAROK NORTH,65,313,282,595
NAROK,NAROK NORTH,66,157,105,262
NAROK,NAROK NORTH,67,272,184,456
NAROK,NAROK NORTH,68,103,93,196
NAROK,NAROK NORTH,69,200,181,381
NAROK,NAROK NORTH,65-69,1045,845,1890
NAROK,NAROK NORTH,70,262,372,634
NAROK,NAROK NORTH,71,129,118,247
NAROK,NAROK NORTH,72,128,102,230
NAROK,NAROK NORTH,73,114,93,207
NAROK,NAROK NORTH,74,105,138,243
NAROK,NAROK NORTH,70-74,738,823,1561
NAROK,NAROK NORTH,75,125,121,246
NAROK,NAROK NORTH,76,72,80,152
NAROK,NAROK NORTH,77,85,55,140
NAROK,NAROK NORTH,78,60,41,101
NAROK,NAROK NORTH,79,89,70,159
NAROK,NAROK NORTH,75-79,431,367,798
NAROK,NAROK NORTH,80,104,167,271
NAROK,NAROK NORTH,81,42,28,70
NAROK,NAROK NORTH,82,41,29,70
NAROK,NAROK NORTH,83,20,23,43
NAROK,NAROK NORTH,84,37,39,76
NAROK,NAROK NORTH,80-84,244,286,530
NAROK,NAROK NORTH,85,38,47,85
NAROK,NAROK NORTH,86,13,27,40
NAROK,NAROK NORTH,87,18,21,39
NAROK,NAROK NORTH,88,13,8,21
NAROK,NAROK NORTH,89,26,38,64
NAROK,NAROK NORTH,85-89,108,141,249
NAROK,NAROK NORTH,90,28,50,78
NAROK,NAROK NORTH,91,8,7,15
NAROK,NAROK NORTH,92,20,10,30
NAROK,NAROK NORTH,93,6,11,17
NAROK,NAROK NORTH,94,10,8,18
NAROK,NAROK NORTH,90-94,72,86,158
NAROK,NAROK NORTH,95,13,15,28
NAROK,NAROK NORTH,96,1,7,8
NAROK,NAROK NORTH,97,7,7,14
NAROK,NAROK NORTH,98,5,6,11
NAROK,NAROK NORTH,99,7,12,19
NAROK,NAROK NORTH,95-99,33,47,80
NAROK,NAROK NORTH,100+,25,39,64
NAROK,NAROK NORTH,Not Stated,1,1,2
NAROK,NAROK SOUTH,Total,118441,120029,238470
NAROK,NAROK SOUTH,0,3431,3455,6886
NAROK,NAROK SOUTH,1,3780,3772,7552
NAROK,NAROK SOUTH,2,4215,4159,8374
NAROK,NAROK SOUTH,3,4529,4686,9215
NAROK,NAROK SOUTH,4,4632,4648,9280
NAROK,NAROK SOUTH,0 - 4,20587,20720,41307
NAROK,NAROK SOUTH,5,4699,4603,9302
NAROK,NAROK SOUTH,6,4661,4625,9286
NAROK,NAROK SOUTH,7,4183,4253,8436
NAROK,NAROK SOUTH,8,4301,4182,8483
NAROK,NAROK SOUTH,9,3957,3866,7823
NAROK,NAROK SOUTH,05-Sep,21801,21529,43330
NAROK,NAROK SOUTH,10,4833,4561,9394
NAROK,NAROK SOUTH,11,3222,3321,6543
NAROK,NAROK SOUTH,12,4333,3977,8310
NAROK,NAROK SOUTH,13,3538,3355,6893
NAROK,NAROK SOUTH,14,3300,3198,6498
NAROK,NAROK SOUTH,Oct-14,19226,18412,37638
NAROK,NAROK SOUTH,15,3486,3108,6594
NAROK,NAROK SOUTH,16,2811,2375,5186
NAROK,NAROK SOUTH,17,2534,2225,4759
NAROK,NAROK SOUTH,18,2211,2044,4255
NAROK,NAROK SOUTH,19,2296,2235,4531
NAROK,NAROK SOUTH,15-19,13338,11987,25325
NAROK,NAROK SOUTH,20,2381,2756,5137
NAROK,NAROK SOUTH,21,1627,1912,3539
NAROK,NAROK SOUTH,22,1806,2037,3843
NAROK,NAROK SOUTH,23,1634,1907,3541
NAROK,NAROK SOUTH,24,1630,1708,3338
NAROK,NAROK SOUTH,20-24,9078,10320,19398
NAROK,NAROK SOUTH,25,1873,2190,4063
NAROK,NAROK SOUTH,26,1416,1731,3147
NAROK,NAROK SOUTH,27,1438,1640,3078
NAROK,NAROK SOUTH,28,1185,1442,2627
NAROK,NAROK SOUTH,29,1132,1264,2396
NAROK,NAROK SOUTH,25-29,7044,8267,15311
NAROK,NAROK SOUTH,30,1964,2239,4203
NAROK,NAROK SOUTH,31,985,1215,2200
NAROK,NAROK SOUTH,32,1411,1651,3062
NAROK,NAROK SOUTH,33,1086,1316,2402
NAROK,NAROK SOUTH,34,1096,1050,2146
NAROK,NAROK SOUTH,30-34,6542,7471,14013
NAROK,NAROK SOUTH,35,1774,1748,3522
NAROK,NAROK SOUTH,36,793,684,1477
NAROK,NAROK SOUTH,37,841,781,1622
NAROK,NAROK SOUTH,38,595,617,1212
NAROK,NAROK SOUTH,39,679,675,1354
NAROK,NAROK SOUTH,35-39,4682,4505,9187
NAROK,NAROK SOUTH,40,1137,1192,2329
NAROK,NAROK SOUTH,41,882,964,1846
NAROK,NAROK SOUTH,42,807,828,1635
NAROK,NAROK SOUTH,43,652,664,1316
NAROK,NAROK SOUTH,44,493,510,1003
NAROK,NAROK SOUTH,40-44,3971,4158,8129
NAROK,NAROK SOUTH,45,1063,1126,2189
NAROK,NAROK SOUTH,46,585,602,1187
NAROK,NAROK SOUTH,47,644,736,1380
NAROK,NAROK SOUTH,48,430,427,857
NAROK,NAROK SOUTH,49,504,583,1087
NAROK,NAROK SOUTH,45-49,3226,3474,6700
NAROK,NAROK SOUTH,50,876,1006,1882
NAROK,NAROK SOUTH,51,420,495,915
NAROK,NAROK SOUTH,52,413,406,819
NAROK,NAROK SOUTH,53,287,319,606
NAROK,NAROK SOUTH,54,402,356,758
NAROK,NAROK SOUTH,50-54,2398,2582,4980
NAROK,NAROK SOUTH,55,425,394,819
NAROK,NAROK SOUTH,56,382,383,765
NAROK,NAROK SOUTH,57,297,327,624
NAROK,NAROK SOUTH,58,431,527,958
NAROK,NAROK SOUTH,59,356,334,690
NAROK,NAROK SOUTH,55-59,1891,1965,3856
NAROK,NAROK SOUTH,60,585,625,1210
NAROK,NAROK SOUTH,61,307,298,605
NAROK,NAROK SOUTH,62,239,233,472
NAROK,NAROK SOUTH,63,255,237,492
NAROK,NAROK SOUTH,64,177,184,361
NAROK,NAROK SOUTH,60-64,1563,1577,3140
NAROK,NAROK SOUTH,65,401,413,814
NAROK,NAROK SOUTH,66,163,111,274
NAROK,NAROK SOUTH,67,297,227,524
NAROK,NAROK SOUTH,68,136,110,246
NAROK,NAROK SOUTH,69,198,197,395
NAROK,NAROK SOUTH,65-69,1195,1058,2253
NAROK,NAROK SOUTH,70,343,448,791
NAROK,NAROK SOUTH,71,166,141,307
NAROK,NAROK SOUTH,72,146,94,240
NAROK,NAROK SOUTH,73,113,101,214
NAROK,NAROK SOUTH,74,118,105,223
NAROK,NAROK SOUTH,70-74,886,889,1775
NAROK,NAROK SOUTH,75,158,153,311
NAROK,NAROK SOUTH,76,74,72,146
NAROK,NAROK SOUTH,77,69,92,161
NAROK,NAROK SOUTH,78,60,54,114
NAROK,NAROK SOUTH,79,88,100,188
NAROK,NAROK SOUTH,75-79,449,471,920
NAROK,NAROK SOUTH,80,148,191,339
NAROK,NAROK SOUTH,81,42,41,83
NAROK,NAROK SOUTH,82,46,24,70
NAROK,NAROK SOUTH,83,41,27,68
NAROK,NAROK SOUTH,84,30,36,66
NAROK,NAROK SOUTH,80-84,307,319,626
NAROK,NAROK SOUTH,85,46,56,102
NAROK,NAROK SOUTH,86,21,25,46
NAROK,NAROK SOUTH,87,30,30,60
NAROK,NAROK SOUTH,88,13,10,23
NAROK,NAROK SOUTH,89,39,46,85
NAROK,NAROK SOUTH,85-89,149,167,316
NAROK,NAROK SOUTH,90,25,43,68
NAROK,NAROK SOUTH,91,13,4,17
NAROK,NAROK SOUTH,92,6,6,12
NAROK,NAROK SOUTH,93,6,4,10
NAROK,NAROK SOUTH,94,8,11,19
NAROK,NAROK SOUTH,90-94,58,68,126
NAROK,NAROK SOUTH,95,16,21,37
NAROK,NAROK SOUTH,96,1,3,4
NAROK,NAROK SOUTH,97,4,4,8
NAROK,NAROK SOUTH,98,3,9,12
NAROK,NAROK SOUTH,99,5,11,16
NAROK,NAROK SOUTH,95-99,29,48,77
NAROK,NAROK SOUTH,100+,19,40,59
NAROK,NAROK SOUTH,Not Stated,2,2,4
NAROK,NAROK WEST,Total,97085,98198,195283
NAROK,NAROK WEST,0,2779,2803,5582
NAROK,NAROK WEST,1,3060,2916,5976
NAROK,NAROK WEST,2,3308,3413,6721
NAROK,NAROK WEST,3,3754,3645,7399
NAROK,NAROK WEST,4,4022,3840,7862
NAROK,NAROK WEST,0 - 4,16923,16617,33540
NAROK,NAROK WEST,5,3993,3828,7821
NAROK,NAROK WEST,6,3936,3952,7888
NAROK,NAROK WEST,7,3520,3429,6949
NAROK,NAROK WEST,8,3728,3534,7262
NAROK,NAROK WEST,9,3019,2983,6002
NAROK,NAROK WEST,05-Sep,18196,17726,35922
NAROK,NAROK WEST,10,4099,3931,8030
NAROK,NAROK WEST,11,2400,2533,4933
NAROK,NAROK WEST,12,3439,3191,6630
NAROK,NAROK WEST,13,2826,2561,5387
NAROK,NAROK WEST,14,2561,2355,4916
NAROK,NAROK WEST,Oct-14,15325,14571,29896
NAROK,NAROK WEST,15,2790,2532,5322
NAROK,NAROK WEST,16,2059,1892,3951
NAROK,NAROK WEST,17,1890,1532,3422
NAROK,NAROK WEST,18,1846,1644,3490
NAROK,NAROK WEST,19,1723,1710,3433
NAROK,NAROK WEST,15-19,10308,9310,19618
NAROK,NAROK WEST,20,2110,2502,4612
NAROK,NAROK WEST,21,1361,1662,3023
NAROK,NAROK WEST,22,1526,1713,3239
NAROK,NAROK WEST,23,1482,1632,3114
NAROK,NAROK WEST,24,1381,1519,2900
NAROK,NAROK WEST,20-24,7860,9028,16888
NAROK,NAROK WEST,25,1764,2151,3915
NAROK,NAROK WEST,26,1238,1459,2697
NAROK,NAROK WEST,27,1221,1423,2644
NAROK,NAROK WEST,28,1154,1429,2583
NAROK,NAROK WEST,29,1059,1242,2301
NAROK,NAROK WEST,25-29,6436,7704,14140
NAROK,NAROK WEST,30,1994,2246,4240
NAROK,NAROK WEST,31,792,936,1728
NAROK,NAROK WEST,32,1151,1265,2416
NAROK,NAROK WEST,33,896,1032,1928
NAROK,NAROK WEST,34,848,811,1659
NAROK,NAROK WEST,30-34,5681,6290,11971
NAROK,NAROK WEST,35,1543,1606,3149
NAROK,NAROK WEST,36,648,639,1287
NAROK,NAROK WEST,37,637,572,1209
NAROK,NAROK WEST,38,560,545,1105
NAROK,NAROK WEST,39,472,406,878
NAROK,NAROK WEST,35-39,3860,3768,7628
NAROK,NAROK WEST,40,1033,1151,2184
NAROK,NAROK WEST,41,759,759,1518
NAROK,NAROK WEST,42,634,569,1203
NAROK,NAROK WEST,43,518,594,1112
NAROK,NAROK WEST,44,370,393,763
NAROK,NAROK WEST,40-44,3314,3466,6780
NAROK,NAROK WEST,45,956,894,1850
NAROK,NAROK WEST,46,499,464,963
NAROK,NAROK WEST,47,533,513,1046
NAROK,NAROK WEST,48,389,310,699
NAROK,NAROK WEST,49,416,373,789
NAROK,NAROK WEST,45-49,2793,2554,5347
NAROK,NAROK WEST,50,767,845,1612
NAROK,NAROK WEST,51,277,281,558
NAROK,NAROK WEST,52,321,260,581
NAROK,NAROK WEST,53,232,222,454
NAROK,NAROK WEST,54,274,228,502
NAROK,NAROK WEST,50-54,1871,1836,3707
NAROK,NAROK WEST,55,301,358,659
NAROK,NAROK WEST,56,265,279,544
NAROK,NAROK WEST,57,182,215,397
NAROK,NAROK WEST,58,259,354,613
NAROK,NAROK WEST,59,188,282,470
NAROK,NAROK WEST,55-59,1195,1488,2683
NAROK,NAROK WEST,60,513,552,1065
NAROK,NAROK WEST,61,158,188,346
NAROK,NAROK WEST,62,176,176,352
NAROK,NAROK WEST,63,159,222,381
NAROK,NAROK WEST,64,143,140,283
NAROK,NAROK WEST,60-64,1149,1278,2427
NAROK,NAROK WEST,65,258,297,555
NAROK,NAROK WEST,66,89,73,162
NAROK,NAROK WEST,67,185,143,328
NAROK,NAROK WEST,68,98,85,183
NAROK,NAROK WEST,69,138,148,286
NAROK,NAROK WEST,65-69,768,746,1514
NAROK,NAROK WEST,70,286,383,669
NAROK,NAROK WEST,71,89,104,193
NAROK,NAROK WEST,72,95,99,194
NAROK,NAROK WEST,73,82,87,169
NAROK,NAROK WEST,74,81,94,175
NAROK,NAROK WEST,70-74,633,767,1400
NAROK,NAROK WEST,75,99,140,239
NAROK,NAROK WEST,76,63,65,128
NAROK,NAROK WEST,77,60,58,118
NAROK,NAROK WEST,78,45,48,93
NAROK,NAROK WEST,79,67,97,164
NAROK,NAROK WEST,75-79,334,408,742
NAROK,NAROK WEST,80,114,170,284
NAROK,NAROK WEST,81,30,28,58
NAROK,NAROK WEST,82,24,31,55
NAROK,NAROK WEST,83,25,29,54
NAROK,NAROK WEST,84,24,47,71
NAROK,NAROK WEST,80-84,217,305,522
NAROK,NAROK WEST,85,28,28,56
NAROK,NAROK WEST,86,20,22,42
NAROK,NAROK WEST,87,18,25,43
NAROK,NAROK WEST,88,17,22,39
NAROK,NAROK WEST,89,28,46,74
NAROK,NAROK WEST,85-89,111,143,254
NAROK,NAROK WEST,90,22,50,72
NAROK,NAROK WEST,91,5,8,13
NAROK,NAROK WEST,92,6,11,17
NAROK,NAROK WEST,93,7,7,14
NAROK,NAROK WEST,94,8,12,20
NAROK,NAROK WEST,90-94,48,88,136
NAROK,NAROK WEST,95,10,20,30
NAROK,NAROK WEST,96,5,3,8
NAROK,NAROK WEST,97,7,6,13
NAROK,NAROK WEST,98,6,6,12
NAROK,NAROK WEST,99,7,7,14
NAROK,NAROK WEST,95-99,35,42,77
NAROK,NAROK WEST,100+,26,62,88
NAROK,NAROK WEST,Not Stated,2,1,3
NAROK,TRANS MARA EAST,Total,54545,56637,111182
NAROK,TRANS MARA EAST,0,1399,1361,2760
NAROK,TRANS MARA EAST,1,1385,1361,2746
NAROK,TRANS MARA EAST,2,1591,1565,3156
NAROK,TRANS MARA EAST,3,1729,1768,3497
NAROK,TRANS MARA EAST,4,2032,1919,3951
NAROK,TRANS MARA EAST,0 - 4,8136,7974,16110
NAROK,TRANS MARA EAST,5,2005,1903,3908
NAROK,TRANS MARA EAST,6,2033,1919,3952
NAROK,TRANS MARA EAST,7,1934,1899,3833
NAROK,TRANS MARA EAST,8,1941,1870,3811
NAROK,TRANS MARA EAST,9,2155,2007,4162
NAROK,TRANS MARA EAST,05-Sep,10068,9598,19666
NAROK,TRANS MARA EAST,10,1987,2073,4060
NAROK,TRANS MARA EAST,11,1942,1894,3836
NAROK,TRANS MARA EAST,12,2074,1957,4031
NAROK,TRANS MARA EAST,13,1926,1930,3856
NAROK,TRANS MARA EAST,14,1784,1820,3604
NAROK,TRANS MARA EAST,Oct-14,9713,9674,19387
NAROK,TRANS MARA EAST,15,1801,1695,3496
NAROK,TRANS MARA EAST,16,1528,1409,2937
NAROK,TRANS MARA EAST,17,1437,1232,2669
NAROK,TRANS MARA EAST,18,1072,1030,2102
NAROK,TRANS MARA EAST,19,1302,1252,2554
NAROK,TRANS MARA EAST,15-19,7140,6618,13758
NAROK,TRANS MARA EAST,20,883,1038,1921
NAROK,TRANS MARA EAST,21,786,964,1750
NAROK,TRANS MARA EAST,22,786,915,1701
NAROK,TRANS MARA EAST,23,804,961,1765
NAROK,TRANS MARA EAST,24,714,727,1441
NAROK,TRANS MARA EAST,20-24,3973,4605,8578
NAROK,TRANS MARA EAST,25,757,868,1625
NAROK,TRANS MARA EAST,26,597,805,1402
NAROK,TRANS MARA EAST,27,630,895,1525
NAROK,TRANS MARA EAST,28,486,675,1161
NAROK,TRANS MARA EAST,29,579,825,1404
NAROK,TRANS MARA EAST,25-29,3049,4068,7117
NAROK,TRANS MARA EAST,30,773,1082,1855
NAROK,TRANS MARA EAST,31,604,811,1415
NAROK,TRANS MARA EAST,32,657,819,1476
NAROK,TRANS MARA EAST,33,557,613,1170
NAROK,TRANS MARA EAST,34,374,464,838
NAROK,TRANS MARA EAST,30-34,2965,3789,6754
NAROK,TRANS MARA EAST,35,618,547,1165
NAROK,TRANS MARA EAST,36,349,284,633
NAROK,TRANS MARA EAST,37,524,408,932
NAROK,TRANS MARA EAST,38,220,217,437
NAROK,TRANS MARA EAST,39,376,311,687
NAROK,TRANS MARA EAST,35-39,2087,1767,3854
NAROK,TRANS MARA EAST,40,385,354,739
NAROK,TRANS MARA EAST,41,431,423,854
NAROK,TRANS MARA EAST,42,341,384,725
NAROK,TRANS MARA EAST,43,297,339,636
NAROK,TRANS MARA EAST,44,311,336,647
NAROK,TRANS MARA EAST,40-44,1765,1836,3601
NAROK,TRANS MARA EAST,45,523,513,1036
NAROK,TRANS MARA EAST,46,333,331,664
NAROK,TRANS MARA EAST,47,392,429,821
NAROK,TRANS MARA EAST,48,186,184,370
NAROK,TRANS MARA EAST,49,258,360,618
NAROK,TRANS MARA EAST,45-49,1692,1817,3509
NAROK,TRANS MARA EAST,50,305,344,649
NAROK,TRANS MARA EAST,51,224,224,448
NAROK,TRANS MARA EAST,52,163,155,318
NAROK,TRANS MARA EAST,53,122,133,255
NAROK,TRANS MARA EAST,54,121,131,252
NAROK,TRANS MARA EAST,50-54,935,987,1922
NAROK,TRANS MARA EAST,55,123,144,267
NAROK,TRANS MARA EAST,56,103,140,243
NAROK,TRANS MARA EAST,57,139,198,337
NAROK,TRANS MARA EAST,58,283,520,803
NAROK,TRANS MARA EAST,59,170,245,415
NAROK,TRANS MARA EAST,55-59,818,1247,2065
NAROK,TRANS MARA EAST,60,182,273,455
NAROK,TRANS MARA EAST,61,112,202,314
NAROK,TRANS MARA EAST,62,122,128,250
NAROK,TRANS MARA EAST,63,116,165,281
NAROK,TRANS MARA EAST,64,99,103,202
NAROK,TRANS MARA EAST,60-64,631,871,1502
NAROK,TRANS MARA EAST,65,164,201,365
NAROK,TRANS MARA EAST,66,78,70,148
NAROK,TRANS MARA EAST,67,137,135,272
NAROK,TRANS MARA EAST,68,54,73,127
NAROK,TRANS MARA EAST,69,119,127,246
NAROK,TRANS MARA EAST,65-69,552,606,1158
NAROK,TRANS MARA EAST,70,116,169,285
NAROK,TRANS MARA EAST,71,120,85,205
NAROK,TRANS MARA EAST,72,71,74,145
NAROK,TRANS MARA EAST,73,66,56,122
NAROK,TRANS MARA EAST,74,55,80,135
NAROK,TRANS MARA EAST,70-74,428,464,892
NAROK,TRANS MARA EAST,75,75,69,144
NAROK,TRANS MARA EAST,76,39,38,77
NAROK,TRANS MARA EAST,77,46,45,91
NAROK,TRANS MARA EAST,78,46,27,73
NAROK,TRANS MARA EAST,79,42,83,125
NAROK,TRANS MARA EAST,75-79,248,262,510
NAROK,TRANS MARA EAST,80,45,69,114
NAROK,TRANS MARA EAST,81,24,31,55
NAROK,TRANS MARA EAST,82,27,31,58
NAROK,TRANS MARA EAST,83,18,35,53
NAROK,TRANS MARA EAST,84,31,48,79
NAROK,TRANS MARA EAST,80-84,145,214,359
NAROK,TRANS MARA EAST,85,27,21,48
NAROK,TRANS MARA EAST,86,18,13,31
NAROK,TRANS MARA EAST,87,30,26,56
NAROK,TRANS MARA EAST,88,9,13,22
NAROK,TRANS MARA EAST,89,28,47,75
NAROK,TRANS MARA EAST,85-89,112,120,232
NAROK,TRANS MARA EAST,90,15,29,44
NAROK,TRANS MARA EAST,91,8,16,24
NAROK,TRANS MARA EAST,92,6,8,14
NAROK,TRANS MARA EAST,93,3,4,7
NAROK,TRANS MARA EAST,94,15,15,30
NAROK,TRANS MARA EAST,90-94,47,72,119
NAROK,TRANS MARA EAST,95,11,14,25
NAROK,TRANS MARA EAST,96,4,5,9
NAROK,TRANS MARA EAST,97,6,2,8
NAROK,TRANS MARA EAST,98,4,1,5
NAROK,TRANS MARA EAST,99,6,6,12
NAROK,TRANS MARA EAST,95-99,31,28,59
NAROK,TRANS MARA EAST,100+,9,20,29
NAROK,TRANS MARA EAST,Not Stated,1,-,1
NAROK,TRANS MARA WEST,Total,122220,123491,245711
NAROK,TRANS MARA WEST,0,3575,3647,7222
NAROK,TRANS MARA WEST,1,3643,3475,7118
NAROK,TRANS MARA WEST,2,3858,3831,7689
NAROK,TRANS MARA WEST,3,4112,4201,8313
NAROK,TRANS MARA WEST,4,4328,4390,8718
NAROK,TRANS MARA WEST,0 - 4,19516,19544,39060
NAROK,TRANS MARA WEST,5,4281,4151,8432
NAROK,TRANS MARA WEST,6,4290,4357,8647
NAROK,TRANS MARA WEST,7,3968,4200,8168
NAROK,TRANS MARA WEST,8,3977,3957,7934
NAROK,TRANS MARA WEST,9,3936,3967,7903
NAROK,TRANS MARA WEST,05-Sep,20452,20632,41084
NAROK,TRANS MARA WEST,10,4437,4284,8721
NAROK,TRANS MARA WEST,11,3553,3530,7083
NAROK,TRANS MARA WEST,12,4250,4023,8273
NAROK,TRANS MARA WEST,13,3785,3909,7694
NAROK,TRANS MARA WEST,14,3518,3628,7146
NAROK,TRANS MARA WEST,Oct-14,19543,19374,38917
NAROK,TRANS MARA WEST,15,3462,3430,6892
NAROK,TRANS MARA WEST,16,2991,2740,5731
NAROK,TRANS MARA WEST,17,2967,2541,5508
NAROK,TRANS MARA WEST,18,2504,2197,4701
NAROK,TRANS MARA WEST,19,2618,2653,5271
NAROK,TRANS MARA WEST,15-19,14542,13561,28103
NAROK,TRANS MARA WEST,20,2427,2837,5264
NAROK,TRANS MARA WEST,21,1968,2259,4227
NAROK,TRANS MARA WEST,22,2053,2352,4405
NAROK,TRANS MARA WEST,23,2032,2217,4249
NAROK,TRANS MARA WEST,24,1758,1883,3641
NAROK,TRANS MARA WEST,20-24,10238,11548,21786
NAROK,TRANS MARA WEST,25,2240,2288,4528
NAROK,TRANS MARA WEST,26,1604,1799,3403
NAROK,TRANS MARA WEST,27,1787,1958,3745
NAROK,TRANS MARA WEST,28,1393,1669,3062
NAROK,TRANS MARA WEST,29,1343,1639,2982
NAROK,TRANS MARA WEST,25-29,8367,9353,17720
NAROK,TRANS MARA WEST,30,1995,2286,4281
NAROK,TRANS MARA WEST,31,1310,1604,2914
NAROK,TRANS MARA WEST,32,1716,1790,3506
NAROK,TRANS MARA WEST,33,1107,1352,2459
NAROK,TRANS MARA WEST,34,960,1051,2011
NAROK,TRANS MARA WEST,30-34,7088,8083,15171
NAROK,TRANS MARA WEST,35,1667,1513,3180
NAROK,TRANS MARA WEST,36,950,806,1756
NAROK,TRANS MARA WEST,37,1154,939,2093
NAROK,TRANS MARA WEST,38,724,594,1318
NAROK,TRANS MARA WEST,39,809,693,1502
NAROK,TRANS MARA WEST,35-39,5304,4545,9849
NAROK,TRANS MARA WEST,40,1234,973,2207
NAROK,TRANS MARA WEST,41,1008,890,1898
NAROK,TRANS MARA WEST,42,1090,1085,2175
NAROK,TRANS MARA WEST,43,759,792,1551
NAROK,TRANS MARA WEST,44,542,530,1072
NAROK,TRANS MARA WEST,40-44,4633,4270,8903
NAROK,TRANS MARA WEST,45,1294,1151,2445
NAROK,TRANS MARA WEST,46,821,760,1581
NAROK,TRANS MARA WEST,47,912,996,1908
NAROK,TRANS MARA WEST,48,482,415,897
NAROK,TRANS MARA WEST,49,555,534,1089
NAROK,TRANS MARA WEST,45-49,4064,3856,7920
NAROK,TRANS MARA WEST,50,799,766,1565
NAROK,TRANS MARA WEST,51,502,487,989
NAROK,TRANS MARA WEST,52,409,394,803
NAROK,TRANS MARA WEST,53,316,234,550
NAROK,TRANS MARA WEST,54,378,319,697
NAROK,TRANS MARA WEST,50-54,2404,2200,4604
NAROK,TRANS MARA WEST,55,461,357,818
NAROK,TRANS MARA WEST,56,404,355,759
NAROK,TRANS MARA WEST,57,396,391,787
NAROK,TRANS MARA WEST,58,333,419,752
NAROK,TRANS MARA WEST,59,388,473,861
NAROK,TRANS MARA WEST,55-59,1982,1995,3977
NAROK,TRANS MARA WEST,60,482,554,1036
NAROK,TRANS MARA WEST,61,291,320,611
NAROK,TRANS MARA WEST,62,289,252,541
NAROK,TRANS MARA WEST,63,247,299,546
NAROK,TRANS MARA WEST,64,174,173,347
NAROK,TRANS MARA WEST,60-64,1483,1598,3081
NAROK,TRANS MARA WEST,65,327,306,633
NAROK,TRANS MARA WEST,66,131,106,237
NAROK,TRANS MARA WEST,67,231,208,439
NAROK,TRANS MARA WEST,68,98,110,208
NAROK,TRANS MARA WEST,69,163,211,374
NAROK,TRANS MARA WEST,65-69,950,941,1891
NAROK,TRANS MARA WEST,70,224,286,510
NAROK,TRANS MARA WEST,71,143,179,322
NAROK,TRANS MARA WEST,72,126,128,254
NAROK,TRANS MARA WEST,73,107,79,186
NAROK,TRANS MARA WEST,74,130,130,260
NAROK,TRANS MARA WEST,70-74,730,802,1532
NAROK,TRANS MARA WEST,75,101,122,223
NAROK,TRANS MARA WEST,76,73,38,111
NAROK,TRANS MARA WEST,77,76,72,148
NAROK,TRANS MARA WEST,78,48,51,99
NAROK,TRANS MARA WEST,79,86,124,210
NAROK,TRANS MARA WEST,75-79,384,407,791
NAROK,TRANS MARA WEST,80,93,140,233
NAROK,TRANS MARA WEST,81,53,71,124
NAROK,TRANS MARA WEST,82,37,36,73
NAROK,TRANS MARA WEST,83,42,34,76
NAROK,TRANS MARA WEST,84,45,71,116
NAROK,TRANS MARA WEST,80-84,270,352,622
NAROK,TRANS MARA WEST,85,32,52,84
NAROK,TRANS MARA WEST,86,13,23,36
NAROK,TRANS MARA WEST,87,30,37,67
NAROK,TRANS MARA WEST,88,14,19,33
NAROK,TRANS MARA WEST,89,45,86,131
NAROK,TRANS MARA WEST,85-89,134,217,351
NAROK,TRANS MARA WEST,90,20,51,71
NAROK,TRANS MARA WEST,91,11,14,25
NAROK,TRANS MARA WEST,92,12,6,18
NAROK,TRANS MARA WEST,93,11,11,22
NAROK,TRANS MARA WEST,94,13,9,22
NAROK,TRANS MARA WEST,90-94,67,91,158
NAROK,TRANS MARA WEST,95,20,28,48
NAROK,TRANS MARA WEST,96,8,14,22
NAROK,TRANS MARA WEST,97,8,6,14
NAROK,TRANS MARA WEST,98,3,5,8
NAROK,TRANS MARA WEST,99,11,21,32
NAROK,TRANS MARA WEST,95-99,50,74,124
NAROK,TRANS MARA WEST,100+,18,48,66
NAROK,TRANS MARA WEST,Not Stated,1,-,1
NAROK,MAU FOREST,Total,28,4,32
NAROK,MAU FOREST,0,-,-,-
NAROK,MAU FOREST,1,-,-,-
NAROK,MAU FOREST,2,-,-,-
NAROK,MAU FOREST,3,-,-,-
NAROK,MAU FOREST,4,-,-,-
NAROK,MAU FOREST,0 - 4,-,-,-
NAROK,MAU FOREST,5,-,-,-
NAROK,MAU FOREST,6,-,-,-
NAROK,MAU FOREST,7,-,-,-
NAROK,MAU FOREST,8,-,-,-
NAROK,MAU FOREST,9,-,-,-
NAROK,MAU FOREST,05-Sep,-,-,-
NAROK,MAU FOREST,10,-,-,-
NAROK,MAU FOREST,11,-,-,-
NAROK,MAU FOREST,12,-,-,-
NAROK,MAU FOREST,13,-,-,-
NAROK,MAU FOREST,14,-,-,-
NAROK,MAU FOREST,Oct-14,-,-,-
NAROK,MAU FOREST,15,-,-,-
NAROK,MAU FOREST,16,-,-,-
NAROK,MAU FOREST,17,-,-,-
NAROK,MAU FOREST,18,-,-,-
NAROK,MAU FOREST,19,-,-,-
NAROK,MAU FOREST,15-19,-,-,-
NAROK,MAU FOREST,20,-,-,-
NAROK,MAU FOREST,21,-,-,-
NAROK,MAU FOREST,22,-,-,-
NAROK,MAU FOREST,23,-,-,-
NAROK,MAU FOREST,24,1,2,3
NAROK,MAU FOREST,20-24,1,2,3
NAROK,MAU FOREST,25,1,-,1
NAROK,MAU FOREST,26,-,-,-
NAROK,MAU FOREST,27,2,-,2
NAROK,MAU FOREST,28,3,-,3
NAROK,MAU FOREST,29,3,-,3
NAROK,MAU FOREST,25-29,9,-,9
NAROK,MAU FOREST,30,2,2,4
NAROK,MAU FOREST,31,1,-,1
NAROK,MAU FOREST,32,-,-,-
NAROK,MAU FOREST,33,-,-,-
NAROK,MAU FOREST,34,-,-,-
NAROK,MAU FOREST,30-34,3,2,5
NAROK,MAU FOREST,35,-,-,-
NAROK,MAU FOREST,36,2,-,2
NAROK,MAU FOREST,37,2,-,2
NAROK,MAU FOREST,38,1,-,1
NAROK,MAU FOREST,39,1,-,1
NAROK,MAU FOREST,35-39,6,-,6
NAROK,MAU FOREST,40,1,-,1
NAROK,MAU FOREST,41,-,-,-
NAROK,MAU FOREST,42,-,-,-
NAROK,MAU FOREST,43,1,-,1
NAROK,MAU FOREST,44,-,-,-
NAROK,MAU FOREST,40-44,2,-,2
NAROK,MAU FOREST,45,-,-,-
NAROK,MAU FOREST,46,1,-,1
NAROK,MAU FOREST,47,1,-,1
NAROK,MAU FOREST,48,2,-,2
NAROK,MAU FOREST,49,2,-,2
NAROK,MAU FOREST,45-49,6,-,6
NAROK,MAU FOREST,50,-,-,-
NAROK,MAU FOREST,51,-,-,-
NAROK,MAU FOREST,52,-,-,-
NAROK,MAU FOREST,53,1,-,1
NAROK,MAU FOREST,54,-,-,-
NAROK,MAU FOREST,50-54,1,-,1
NAROK,MAU FOREST,55,-,-,-
NAROK,MAU FOREST,56,-,-,-
NAROK,MAU FOREST,57,-,-,-
NAROK,MAU FOREST,58,-,-,-
NAROK,MAU FOREST,59,-,-,-
NAROK,MAU FOREST,55-59,-,-,-
NAROK,MAU FOREST,60,-,-,-
NAROK,MAU FOREST,61,-,-,-
NAROK,MAU FOREST,62,-,-,-
NAROK,MAU FOREST,63,-,-,-
NAROK,MAU FOREST,64,-,-,-
NAROK,MAU FOREST,60-64,-,-,-
NAROK,MAU FOREST,65,-,-,-
NAROK,MAU FOREST,66,-,-,-
NAROK,MAU FOREST,67,-,-,-
NAROK,MAU FOREST,68,-,-,-
NAROK,MAU FOREST,69,-,-,-
NAROK,MAU FOREST,65-69,-,-,-
NAROK,MAU FOREST,70,-,-,-
NAROK,MAU FOREST,71,-,-,-
NAROK,MAU FOREST,72,-,-,-
NAROK,MAU FOREST,73,-,-,-
NAROK,MAU FOREST,74,-,-,-
NAROK,MAU FOREST,70-74,-,-,-
NAROK,MAU FOREST,75,-,-,-
NAROK,MAU FOREST,76,-,-,-
NAROK,MAU FOREST,77,-,-,-
NAROK,MAU FOREST,78,-,-,-
NAROK,MAU FOREST,79,-,-,-
NAROK,MAU FOREST,75-79,-,-,-
NAROK,MAU FOREST,80,-,-,-
NAROK,MAU FOREST,81,-,-,-
NAROK,MAU FOREST,82,-,-,-
NAROK,MAU FOREST,83,-,-,-
NAROK,MAU FOREST,84,-,-,-
NAROK,MAU FOREST,80-84,-,-,-
NAROK,MAU FOREST,85,-,-,-
NAROK,MAU FOREST,86,-,-,-
NAROK,MAU FOREST,87,-,-,-
NAROK,MAU FOREST,88,-,-,-
NAROK,MAU FOREST,89,-,-,-
NAROK,MAU FOREST,85-89,-,-,-
NAROK,MAU FOREST,90,-,-,-
NAROK,MAU FOREST,91,-,-,-
NAROK,MAU FOREST,92,-,-,-
NAROK,MAU FOREST,93,-,-,-
NAROK,MAU FOREST,94,-,-,-
NAROK,MAU FOREST,90-94,-,-,-
NAROK,MAU FOREST,95,-,-,-
NAROK,MAU FOREST,96,-,-,-
NAROK,MAU FOREST,97,-,-,-
NAROK,MAU FOREST,98,-,-,-
NAROK,MAU FOREST,99,-,-,-
NAROK,MAU FOREST,95-99,-,-,-
NAROK,MAU FOREST,100+,-,-,-
NAROK,MAU FOREST,Not Stated,-,-,-
NYAMIRA,ALL,Total,290907,314656,605563
NYAMIRA,ALL,0,5736,5898,11634
NYAMIRA,ALL,1,6071,6115,12186
NYAMIRA,ALL,2,6340,6246,12586
NYAMIRA,ALL,3,6779,6911,13690
NYAMIRA,ALL,4,7271,7087,14358
NYAMIRA,ALL,0 - 4,32197,32257,64454
NYAMIRA,ALL,5,7344,7261,14605
NYAMIRA,ALL,6,7722,7746,15468
NYAMIRA,ALL,7,8030,7787,15817
NYAMIRA,ALL,8,7674,7613,15287
NYAMIRA,ALL,9,8834,8746,17580
NYAMIRA,ALL,05-Sep,39604,39153,78757
NYAMIRA,ALL,10,9855,9588,19443
NYAMIRA,ALL,11,8384,8728,17112
NYAMIRA,ALL,12,10520,9892,20412
NYAMIRA,ALL,13,9575,9574,19149
NYAMIRA,ALL,14,8892,8485,17377
NYAMIRA,ALL,Oct-14,47226,46267,93493
NYAMIRA,ALL,15,8422,8317,16739
NYAMIRA,ALL,16,7673,7509,15182
NYAMIRA,ALL,17,7420,7477,14897
NYAMIRA,ALL,18,5836,5739,11575
NYAMIRA,ALL,19,6075,5925,12000
NYAMIRA,ALL,15-19,35426,34967,70393
NYAMIRA,ALL,20,4846,5396,10242
NYAMIRA,ALL,21,3958,4705,8663
NYAMIRA,ALL,22,3789,4657,8446
NYAMIRA,ALL,23,3751,4930,8681
NYAMIRA,ALL,24,3588,4686,8274
NYAMIRA,ALL,20-24,19932,24374,44306
NYAMIRA,ALL,25,4519,5782,10301
NYAMIRA,ALL,26,3267,4698,7965
NYAMIRA,ALL,27,3630,5050,8680
NYAMIRA,ALL,28,3022,4071,7093
NYAMIRA,ALL,29,3124,4535,7659
NYAMIRA,ALL,25-29,17562,24136,41698
NYAMIRA,ALL,30,4649,6873,11522
NYAMIRA,ALL,31,3352,5200,8552
NYAMIRA,ALL,32,3985,5892,9877
NYAMIRA,ALL,33,3359,4828,8187
NYAMIRA,ALL,34,3153,4255,7408
NYAMIRA,ALL,30-34,18498,27048,45546
NYAMIRA,ALL,35,4454,5076,9530
NYAMIRA,ALL,36,2842,2790,5632
NYAMIRA,ALL,37,2927,2806,5733
NYAMIRA,ALL,38,2267,2278,4545
NYAMIRA,ALL,39,2710,2625,5335
NYAMIRA,ALL,35-39,15200,15575,30775
NYAMIRA,ALL,40,3412,3688,7100
NYAMIRA,ALL,41,3598,3462,7060
NYAMIRA,ALL,42,2619,2753,5372
NYAMIRA,ALL,43,2504,2756,5260
NYAMIRA,ALL,44,1951,2160,4111
NYAMIRA,ALL,40-44,14084,14819,28903
NYAMIRA,ALL,45,3516,3799,7315
NYAMIRA,ALL,46,2213,2656,4869
NYAMIRA,ALL,47,2445,2802,5247
NYAMIRA,ALL,48,1541,1661,3202
NYAMIRA,ALL,49,1811,2209,4020
NYAMIRA,ALL,45-49,11526,13127,24653
NYAMIRA,ALL,50,2354,2692,5046
NYAMIRA,ALL,51,1879,1782,3661
NYAMIRA,ALL,52,1371,1244,2615
NYAMIRA,ALL,53,1211,971,2182
NYAMIRA,ALL,54,1413,1170,2583
NYAMIRA,ALL,50-54,8228,7859,16087
NYAMIRA,ALL,55,1757,1543,3300
NYAMIRA,ALL,56,2040,2086,4126
NYAMIRA,ALL,57,2312,2705,5017
NYAMIRA,ALL,58,1497,1612,3109
NYAMIRA,ALL,59,2255,2321,4576
NYAMIRA,ALL,55-59,9861,10267,20128
NYAMIRA,ALL,60,2417,2658,5075
NYAMIRA,ALL,61,1886,1897,3783
NYAMIRA,ALL,62,1277,1213,2490
NYAMIRA,ALL,63,1342,1444,2786
NYAMIRA,ALL,64,891,986,1877
NYAMIRA,ALL,60-64,7813,8198,16011
NYAMIRA,ALL,65,1440,1756,3196
NYAMIRA,ALL,66,720,748,1468
NYAMIRA,ALL,67,1318,1289,2607
NYAMIRA,ALL,68,605,658,1263
NYAMIRA,ALL,69,1019,1316,2335
NYAMIRA,ALL,65-69,5102,5767,10869
NYAMIRA,ALL,70,1288,1850,3138
NYAMIRA,ALL,71,983,992,1975
NYAMIRA,ALL,72,634,604,1238
NYAMIRA,ALL,73,571,486,1057
NYAMIRA,ALL,74,552,694,1246
NYAMIRA,ALL,70-74,4028,4626,8654
NYAMIRA,ALL,75,501,649,1150
NYAMIRA,ALL,76,295,300,595
NYAMIRA,ALL,77,456,468,924
NYAMIRA,ALL,78,278,258,536
NYAMIRA,ALL,79,395,664,1059
NYAMIRA,ALL,75-79,1925,2339,4264
NYAMIRA,ALL,80,419,788,1207
NYAMIRA,ALL,81,284,366,650
NYAMIRA,ALL,82,204,175,379
NYAMIRA,ALL,83,248,235,483
NYAMIRA,ALL,84,230,339,569
NYAMIRA,ALL,80-84,1385,1903,3288
NYAMIRA,ALL,85,201,311,512
NYAMIRA,ALL,86,128,142,270
NYAMIRA,ALL,87,181,207,388
NYAMIRA,ALL,88,113,69,182
NYAMIRA,ALL,89,158,388,546
NYAMIRA,ALL,85-89,781,1117,1898
NYAMIRA,ALL,90,106,235,341
NYAMIRA,ALL,91,71,91,162
NYAMIRA,ALL,92,49,55,104
NYAMIRA,ALL,93,35,43,78
NYAMIRA,ALL,94,42,60,102
NYAMIRA,ALL,90-94,303,484,787
NYAMIRA,ALL,95,71,87,158
NYAMIRA,ALL,96,14,32,46
NYAMIRA,ALL,97,30,24,54
NYAMIRA,ALL,98,24,27,51
NYAMIRA,ALL,99,31,73,104
NYAMIRA,ALL,95-99,170,243,413
NYAMIRA,ALL,100+,55,127,182
NYAMIRA,ALL,Not Stated,1,3,4
NYAMIRA,BORABU,Total,36736,36431,73167
NYAMIRA,BORABU,0,585,597,1182
NYAMIRA,BORABU,1,671,688,1359
NYAMIRA,BORABU,2,772,709,1481
NYAMIRA,BORABU,3,799,823,1622
NYAMIRA,BORABU,4,826,739,1565
NYAMIRA,BORABU,0 - 4,3653,3556,7209
NYAMIRA,BORABU,5,852,809,1661
NYAMIRA,BORABU,6,936,888,1824
NYAMIRA,BORABU,7,928,921,1849
NYAMIRA,BORABU,8,892,909,1801
NYAMIRA,BORABU,9,1014,970,1984
NYAMIRA,BORABU,05-Sep,4622,4497,9119
NYAMIRA,BORABU,10,1170,1143,2313
NYAMIRA,BORABU,11,956,962,1918
NYAMIRA,BORABU,12,1274,1101,2375
NYAMIRA,BORABU,13,1147,1089,2236
NYAMIRA,BORABU,14,1096,973,2069
NYAMIRA,BORABU,Oct-14,5643,5268,10911
NYAMIRA,BORABU,15,1002,1031,2033
NYAMIRA,BORABU,16,930,849,1779
NYAMIRA,BORABU,17,913,890,1803
NYAMIRA,BORABU,18,682,666,1348
NYAMIRA,BORABU,19,762,649,1411
NYAMIRA,BORABU,15-19,4289,4085,8374
NYAMIRA,BORABU,20,611,630,1241
NYAMIRA,BORABU,21,553,518,1071
NYAMIRA,BORABU,22,479,489,968
NYAMIRA,BORABU,23,474,572,1046
NYAMIRA,BORABU,24,451,500,951
NYAMIRA,BORABU,20-24,2568,2709,5277
NYAMIRA,BORABU,25,563,678,1241
NYAMIRA,BORABU,26,408,557,965
NYAMIRA,BORABU,27,417,539,956
NYAMIRA,BORABU,28,364,455,819
NYAMIRA,BORABU,29,387,479,866
NYAMIRA,BORABU,25-29,2139,2708,4847
NYAMIRA,BORABU,30,613,773,1386
NYAMIRA,BORABU,31,412,554,966
NYAMIRA,BORABU,32,521,650,1171
NYAMIRA,BORABU,33,474,561,1035
NYAMIRA,BORABU,34,401,585,986
NYAMIRA,BORABU,30-34,2421,3123,5544
NYAMIRA,BORABU,35,612,746,1358
NYAMIRA,BORABU,36,393,389,782
NYAMIRA,BORABU,37,401,399,800
NYAMIRA,BORABU,38,329,328,657
NYAMIRA,BORABU,39,440,360,800
NYAMIRA,BORABU,35-39,2175,2222,4397
NYAMIRA,BORABU,40,545,515,1060
NYAMIRA,BORABU,41,510,429,939
NYAMIRA,BORABU,42,426,338,764
NYAMIRA,BORABU,43,428,377,805
NYAMIRA,BORABU,44,318,306,624
NYAMIRA,BORABU,40-44,2227,1965,4192
NYAMIRA,BORABU,45,557,462,1019
NYAMIRA,BORABU,46,340,338,678
NYAMIRA,BORABU,47,366,364,730
NYAMIRA,BORABU,48,255,234,489
NYAMIRA,BORABU,49,283,305,588
NYAMIRA,BORABU,45-49,1801,1703,3504
NYAMIRA,BORABU,50,395,362,757
NYAMIRA,BORABU,51,313,230,543
NYAMIRA,BORABU,52,240,171,411
NYAMIRA,BORABU,53,220,136,356
NYAMIRA,BORABU,54,250,181,431
NYAMIRA,BORABU,50-54,1418,1080,2498
NYAMIRA,BORABU,55,269,172,441
NYAMIRA,BORABU,56,271,226,497
NYAMIRA,BORABU,57,319,318,637
NYAMIRA,BORABU,58,210,182,392
NYAMIRA,BORABU,59,282,226,508
NYAMIRA,BORABU,55-59,1351,1124,2475
NYAMIRA,BORABU,60,283,257,540
NYAMIRA,BORABU,61,197,164,361
NYAMIRA,BORABU,62,181,108,289
NYAMIRA,BORABU,63,188,137,325
NYAMIRA,BORABU,64,110,107,217
NYAMIRA,BORABU,60-64,959,773,1732
NYAMIRA,BORABU,65,162,159,321
NYAMIRA,BORABU,66,93,68,161
NYAMIRA,BORABU,67,150,99,249
NYAMIRA,BORABU,68,77,69,146
NYAMIRA,BORABU,69,100,108,208
NYAMIRA,BORABU,65-69,582,503,1085
NYAMIRA,BORABU,70,119,167,286
NYAMIRA,BORABU,71,109,92,201
NYAMIRA,BORABU,72,48,59,107
NYAMIRA,BORABU,73,53,42,95
NYAMIRA,BORABU,74,46,69,115
NYAMIRA,BORABU,70-74,375,429,804
NYAMIRA,BORABU,75,44,72,116
NYAMIRA,BORABU,76,30,38,68
NYAMIRA,BORABU,77,31,55,86
NYAMIRA,BORABU,78,29,31,60
NYAMIRA,BORABU,79,31,59,90
NYAMIRA,BORABU,75-79,165,255,420
NYAMIRA,BORABU,80,50,64,114
NYAMIRA,BORABU,81,21,47,68
NYAMIRA,BORABU,82,16,29,45
NYAMIRA,BORABU,83,32,29,61
NYAMIRA,BORABU,84,26,40,66
NYAMIRA,BORABU,80-84,145,209,354
NYAMIRA,BORABU,85,28,34,62
NYAMIRA,BORABU,86,19,18,37
NYAMIRA,BORABU,87,30,34,64
NYAMIRA,BORABU,88,13,6,19
NYAMIRA,BORABU,89,29,42,71
NYAMIRA,BORABU,85-89,119,134,253
NYAMIRA,BORABU,90,12,29,41
NYAMIRA,BORABU,91,11,11,22
NYAMIRA,BORABU,92,10,3,13
NYAMIRA,BORABU,93,11,1,12
NYAMIRA,BORABU,94,4,4,8
NYAMIRA,BORABU,90-94,48,48,96
NYAMIRA,BORABU,95,9,12,21
NYAMIRA,BORABU,96,1,7,8
NYAMIRA,BORABU,97,6,2,8
NYAMIRA,BORABU,98,7,1,8
NYAMIRA,BORABU,99,3,8,11
NYAMIRA,BORABU,95-99,26,30,56
NYAMIRA,BORABU,100+,10,10,20
NYAMIRA,BORABU,Not Stated,-,-,-
NYAMIRA,MANGA,Total,44868,49339,94207
NYAMIRA,MANGA,0,910,919,1829
NYAMIRA,MANGA,1,954,927,1881
NYAMIRA,MANGA,2,940,1002,1942
NYAMIRA,MANGA,3,1030,1023,2053
NYAMIRA,MANGA,4,1108,1053,2161
NYAMIRA,MANGA,0 - 4,4942,4924,9866
NYAMIRA,MANGA,5,1076,1097,2173
NYAMIRA,MANGA,6,1122,1182,2304
NYAMIRA,MANGA,7,1174,1195,2369
NYAMIRA,MANGA,8,1078,1122,2200
NYAMIRA,MANGA,9,1347,1393,2740
NYAMIRA,MANGA,05-Sep,5797,5989,11786
NYAMIRA,MANGA,10,1476,1384,2860
NYAMIRA,MANGA,11,1326,1352,2678
NYAMIRA,MANGA,12,1541,1518,3059
NYAMIRA,MANGA,13,1534,1536,3070
NYAMIRA,MANGA,14,1396,1268,2664
NYAMIRA,MANGA,Oct-14,7273,7058,14331
NYAMIRA,MANGA,15,1324,1278,2602
NYAMIRA,MANGA,16,1200,1168,2368
NYAMIRA,MANGA,17,1102,1153,2255
NYAMIRA,MANGA,18,904,898,1802
NYAMIRA,MANGA,19,991,917,1908
NYAMIRA,MANGA,15-19,5521,5414,10935
NYAMIRA,MANGA,20,734,822,1556
NYAMIRA,MANGA,21,585,751,1336
NYAMIRA,MANGA,22,581,726,1307
NYAMIRA,MANGA,23,599,741,1340
NYAMIRA,MANGA,24,554,702,1256
NYAMIRA,MANGA,20-24,3053,3742,6795
NYAMIRA,MANGA,25,726,862,1588
NYAMIRA,MANGA,26,507,785,1292
NYAMIRA,MANGA,27,608,841,1449
NYAMIRA,MANGA,28,450,683,1133
NYAMIRA,MANGA,29,489,743,1232
NYAMIRA,MANGA,25-29,2780,3914,6694
NYAMIRA,MANGA,30,749,1112,1861
NYAMIRA,MANGA,31,495,833,1328
NYAMIRA,MANGA,32,615,975,1590
NYAMIRA,MANGA,33,515,794,1309
NYAMIRA,MANGA,34,501,660,1161
NYAMIRA,MANGA,30-34,2875,4374,7249
NYAMIRA,MANGA,35,729,780,1509
NYAMIRA,MANGA,36,454,453,907
NYAMIRA,MANGA,37,468,444,912
NYAMIRA,MANGA,38,352,363,715
NYAMIRA,MANGA,39,408,418,826
NYAMIRA,MANGA,35-39,2411,2458,4869
NYAMIRA,MANGA,40,506,585,1091
NYAMIRA,MANGA,41,538,537,1075
NYAMIRA,MANGA,42,426,404,830
NYAMIRA,MANGA,43,419,396,815
NYAMIRA,MANGA,44,284,346,630
NYAMIRA,MANGA,40-44,2173,2268,4441
NYAMIRA,MANGA,45,496,581,1077
NYAMIRA,MANGA,46,342,387,729
NYAMIRA,MANGA,47,375,443,818
NYAMIRA,MANGA,48,221,258,479
NYAMIRA,MANGA,49,277,332,609
NYAMIRA,MANGA,45-49,1711,2001,3712
NYAMIRA,MANGA,50,368,393,761
NYAMIRA,MANGA,51,277,282,559
NYAMIRA,MANGA,52,211,196,407
NYAMIRA,MANGA,53,161,151,312
NYAMIRA,MANGA,54,218,190,408
NYAMIRA,MANGA,50-54,1235,1212,2447
NYAMIRA,MANGA,55,302,279,581
NYAMIRA,MANGA,56,281,323,604
NYAMIRA,MANGA,57,376,512,888
NYAMIRA,MANGA,58,237,267,504
NYAMIRA,MANGA,59,325,424,749
NYAMIRA,MANGA,55-59,1521,1805,3326
NYAMIRA,MANGA,60,396,442,838
NYAMIRA,MANGA,61,329,342,671
NYAMIRA,MANGA,62,222,188,410
NYAMIRA,MANGA,63,226,267,493
NYAMIRA,MANGA,64,157,160,317
NYAMIRA,MANGA,60-64,1330,1399,2729
NYAMIRA,MANGA,65,260,288,548
NYAMIRA,MANGA,66,107,112,219
NYAMIRA,MANGA,67,216,224,440
NYAMIRA,MANGA,68,100,105,205
NYAMIRA,MANGA,69,183,189,372
NYAMIRA,MANGA,65-69,866,918,1784
NYAMIRA,MANGA,70,196,303,499
NYAMIRA,MANGA,71,149,159,308
NYAMIRA,MANGA,72,107,100,207
NYAMIRA,MANGA,73,94,82,176
NYAMIRA,MANGA,74,95,119,214
NYAMIRA,MANGA,70-74,641,763,1404
NYAMIRA,MANGA,75,72,114,186
NYAMIRA,MANGA,76,51,56,107
NYAMIRA,MANGA,77,90,87,177
NYAMIRA,MANGA,78,40,45,85
NYAMIRA,MANGA,79,68,120,188
NYAMIRA,MANGA,75-79,321,422,743
NYAMIRA,MANGA,80,75,147,222
NYAMIRA,MANGA,81,50,63,113
NYAMIRA,MANGA,82,37,35,72
NYAMIRA,MANGA,83,32,39,71
NYAMIRA,MANGA,84,34,60,94
NYAMIRA,MANGA,80-84,228,344,572
NYAMIRA,MANGA,85,30,62,92
NYAMIRA,MANGA,86,27,23,50
NYAMIRA,MANGA,87,21,31,52
NYAMIRA,MANGA,88,20,13,33
NYAMIRA,MANGA,89,26,69,95
NYAMIRA,MANGA,85-89,124,198,322
NYAMIRA,MANGA,90,19,43,62
NYAMIRA,MANGA,91,8,8,16
NYAMIRA,MANGA,92,5,8,13
NYAMIRA,MANGA,93,2,6,8
NYAMIRA,MANGA,94,3,11,14
NYAMIRA,MANGA,90-94,37,76,113
NYAMIRA,MANGA,95,11,16,27
NYAMIRA,MANGA,96,3,6,9
NYAMIRA,MANGA,97,1,4,5
NYAMIRA,MANGA,98,2,2,4
NYAMIRA,MANGA,99,3,11,14
NYAMIRA,MANGA,95-99,20,39,59
NYAMIRA,MANGA,100+,9,20,29
NYAMIRA,MANGA,Not Stated,-,1,1
NYAMIRA,MASABA NORTH,Total,52884,58974,111858
NYAMIRA,MASABA NORTH,0,1082,1088,2170
NYAMIRA,MASABA NORTH,1,1068,1114,2182
NYAMIRA,MASABA NORTH,2,1117,1129,2246
NYAMIRA,MASABA NORTH,3,1190,1279,2469
NYAMIRA,MASABA NORTH,4,1259,1309,2568
NYAMIRA,MASABA NORTH,0 - 4,5716,5919,11635
NYAMIRA,MASABA NORTH,5,1285,1295,2580
NYAMIRA,MASABA NORTH,6,1341,1374,2715
NYAMIRA,MASABA NORTH,7,1448,1416,2864
NYAMIRA,MASABA NORTH,8,1371,1385,2756
NYAMIRA,MASABA NORTH,9,1678,1648,3326
NYAMIRA,MASABA NORTH,05-Sep,7123,7118,14241
NYAMIRA,MASABA NORTH,10,1713,1705,3418
NYAMIRA,MASABA NORTH,11,1552,1626,3178
NYAMIRA,MASABA NORTH,12,1946,1896,3842
NYAMIRA,MASABA NORTH,13,1733,1736,3469
NYAMIRA,MASABA NORTH,14,1647,1553,3200
NYAMIRA,MASABA NORTH,Oct-14,8591,8516,17107
NYAMIRA,MASABA NORTH,15,1590,1534,3124
NYAMIRA,MASABA NORTH,16,1445,1434,2879
NYAMIRA,MASABA NORTH,17,1391,1457,2848
NYAMIRA,MASABA NORTH,18,1100,1057,2157
NYAMIRA,MASABA NORTH,19,1099,1201,2300
NYAMIRA,MASABA NORTH,15-19,6625,6683,13308
NYAMIRA,MASABA NORTH,20,923,981,1904
NYAMIRA,MASABA NORTH,21,757,871,1628
NYAMIRA,MASABA NORTH,22,712,808,1520
NYAMIRA,MASABA NORTH,23,730,909,1639
NYAMIRA,MASABA NORTH,24,666,840,1506
NYAMIRA,MASABA NORTH,20-24,3788,4409,8197
NYAMIRA,MASABA NORTH,25,837,1036,1873
NYAMIRA,MASABA NORTH,26,575,825,1400
NYAMIRA,MASABA NORTH,27,599,905,1504
NYAMIRA,MASABA NORTH,28,510,707,1217
NYAMIRA,MASABA NORTH,29,575,807,1382
NYAMIRA,MASABA NORTH,25-29,3096,4280,7376
NYAMIRA,MASABA NORTH,30,829,1297,2126
NYAMIRA,MASABA NORTH,31,602,954,1556
NYAMIRA,MASABA NORTH,32,702,1143,1845
NYAMIRA,MASABA NORTH,33,619,926,1545
NYAMIRA,MASABA NORTH,34,570,758,1328
NYAMIRA,MASABA NORTH,30-34,3322,5078,8400
NYAMIRA,MASABA NORTH,35,773,886,1659
NYAMIRA,MASABA NORTH,36,513,495,1008
NYAMIRA,MASABA NORTH,37,568,501,1069
NYAMIRA,MASABA NORTH,38,419,436,855
NYAMIRA,MASABA NORTH,39,470,476,946
NYAMIRA,MASABA NORTH,35-39,2743,2794,5537
NYAMIRA,MASABA NORTH,40,591,722,1313
NYAMIRA,MASABA NORTH,41,648,700,1348
NYAMIRA,MASABA NORTH,42,449,545,994
NYAMIRA,MASABA NORTH,43,470,565,1035
NYAMIRA,MASABA NORTH,44,396,442,838
NYAMIRA,MASABA NORTH,40-44,2554,2974,5528
NYAMIRA,MASABA NORTH,45,620,703,1323
NYAMIRA,MASABA NORTH,46,386,545,931
NYAMIRA,MASABA NORTH,47,449,515,964
NYAMIRA,MASABA NORTH,48,256,306,562
NYAMIRA,MASABA NORTH,49,325,366,691
NYAMIRA,MASABA NORTH,45-49,2036,2435,4471
NYAMIRA,MASABA NORTH,50,433,528,961
NYAMIRA,MASABA NORTH,51,359,348,707
NYAMIRA,MASABA NORTH,52,245,258,503
NYAMIRA,MASABA NORTH,53,216,208,424
NYAMIRA,MASABA NORTH,54,223,227,450
NYAMIRA,MASABA NORTH,50-54,1476,1569,3045
NYAMIRA,MASABA NORTH,55,292,286,578
NYAMIRA,MASABA NORTH,56,370,385,755
NYAMIRA,MASABA NORTH,57,430,572,1002
NYAMIRA,MASABA NORTH,58,252,315,567
NYAMIRA,MASABA NORTH,59,406,435,841
NYAMIRA,MASABA NORTH,55-59,1750,1993,3743
NYAMIRA,MASABA NORTH,60,444,513,957
NYAMIRA,MASABA NORTH,61,342,431,773
NYAMIRA,MASABA NORTH,62,220,242,462
NYAMIRA,MASABA NORTH,63,241,307,548
NYAMIRA,MASABA NORTH,64,152,182,334
NYAMIRA,MASABA NORTH,60-64,1399,1675,3074
NYAMIRA,MASABA NORTH,65,256,362,618
NYAMIRA,MASABA NORTH,66,135,152,287
NYAMIRA,MASABA NORTH,67,242,234,476
NYAMIRA,MASABA NORTH,68,105,124,229
NYAMIRA,MASABA NORTH,69,196,311,507
NYAMIRA,MASABA NORTH,65-69,934,1183,2117
NYAMIRA,MASABA NORTH,70,243,399,642
NYAMIRA,MASABA NORTH,71,222,227,449
NYAMIRA,MASABA NORTH,72,124,143,267
NYAMIRA,MASABA NORTH,73,113,115,228
NYAMIRA,MASABA NORTH,74,116,145,261
NYAMIRA,MASABA NORTH,70-74,818,1029,1847
NYAMIRA,MASABA NORTH,75,101,151,252
NYAMIRA,MASABA NORTH,76,56,75,131
NYAMIRA,MASABA NORTH,77,87,94,181
NYAMIRA,MASABA NORTH,78,52,52,104
NYAMIRA,MASABA NORTH,79,75,161,236
NYAMIRA,MASABA NORTH,75-79,371,533,904
NYAMIRA,MASABA NORTH,80,79,157,236
NYAMIRA,MASABA NORTH,81,75,73,148
NYAMIRA,MASABA NORTH,82,41,24,65
NYAMIRA,MASABA NORTH,83,59,47,106
NYAMIRA,MASABA NORTH,84,43,75,118
NYAMIRA,MASABA NORTH,80-84,297,376,673
NYAMIRA,MASABA NORTH,85,36,58,94
NYAMIRA,MASABA NORTH,86,31,37,68
NYAMIRA,MASABA NORTH,87,39,50,89
NYAMIRA,MASABA NORTH,88,26,20,46
NYAMIRA,MASABA NORTH,89,24,68,92
NYAMIRA,MASABA NORTH,85-89,156,233,389
NYAMIRA,MASABA NORTH,90,22,37,59
NYAMIRA,MASABA NORTH,91,12,16,28
NYAMIRA,MASABA NORTH,92,10,12,22
NYAMIRA,MASABA NORTH,93,4,11,15
NYAMIRA,MASABA NORTH,94,6,22,28
NYAMIRA,MASABA NORTH,90-94,54,98,152
NYAMIRA,MASABA NORTH,95,11,18,29
NYAMIRA,MASABA NORTH,96,2,5,7
NYAMIRA,MASABA NORTH,97,3,8,11
NYAMIRA,MASABA NORTH,98,4,7,11
NYAMIRA,MASABA NORTH,99,7,18,25
NYAMIRA,MASABA NORTH,95-99,27,56,83
NYAMIRA,MASABA NORTH,100+,7,23,30
NYAMIRA,MASABA NORTH,Not Stated,1,-,1
NYAMIRA,NYAMIRA NORTH,Total,80314,86947,167261
NYAMIRA,NYAMIRA NORTH,0,1567,1610,3177
NYAMIRA,NYAMIRA NORTH,1,1652,1759,3411
NYAMIRA,NYAMIRA NORTH,2,1844,1768,3612
NYAMIRA,NYAMIRA NORTH,3,1996,1904,3900
NYAMIRA,NYAMIRA NORTH,4,2004,2009,4013
NYAMIRA,NYAMIRA NORTH,0 - 4,9063,9050,18113
NYAMIRA,NYAMIRA NORTH,5,2161,2161,4322
NYAMIRA,NYAMIRA NORTH,6,2282,2193,4475
NYAMIRA,NYAMIRA NORTH,7,2353,2220,4573
NYAMIRA,NYAMIRA NORTH,8,2287,2191,4478
NYAMIRA,NYAMIRA NORTH,9,2515,2453,4968
NYAMIRA,NYAMIRA NORTH,05-Sep,11598,11218,22816
NYAMIRA,NYAMIRA NORTH,10,2936,2822,5758
NYAMIRA,NYAMIRA NORTH,11,2414,2479,4893
NYAMIRA,NYAMIRA NORTH,12,3019,2851,5870
NYAMIRA,NYAMIRA NORTH,13,2776,2736,5512
NYAMIRA,NYAMIRA NORTH,14,2499,2440,4939
NYAMIRA,NYAMIRA NORTH,Oct-14,13644,13328,26972
NYAMIRA,NYAMIRA NORTH,15,2358,2331,4689
NYAMIRA,NYAMIRA NORTH,16,2074,2120,4194
NYAMIRA,NYAMIRA NORTH,17,2035,2038,4073
NYAMIRA,NYAMIRA NORTH,18,1595,1612,3207
NYAMIRA,NYAMIRA NORTH,19,1614,1599,3213
NYAMIRA,NYAMIRA NORTH,15-19,9676,9700,19376
NYAMIRA,NYAMIRA NORTH,20,1305,1518,2823
NYAMIRA,NYAMIRA NORTH,21,1056,1311,2367
NYAMIRA,NYAMIRA NORTH,22,1017,1338,2355
NYAMIRA,NYAMIRA NORTH,23,963,1363,2326
NYAMIRA,NYAMIRA NORTH,24,991,1352,2343
NYAMIRA,NYAMIRA NORTH,20-24,5332,6882,12214
NYAMIRA,NYAMIRA NORTH,25,1164,1638,2802
NYAMIRA,NYAMIRA NORTH,26,868,1264,2132
NYAMIRA,NYAMIRA NORTH,27,969,1474,2443
NYAMIRA,NYAMIRA NORTH,28,821,1108,1929
NYAMIRA,NYAMIRA NORTH,29,879,1252,2131
NYAMIRA,NYAMIRA NORTH,25-29,4701,6736,11437
NYAMIRA,NYAMIRA NORTH,30,1202,1918,3120
NYAMIRA,NYAMIRA NORTH,31,952,1480,2432
NYAMIRA,NYAMIRA NORTH,32,1109,1600,2709
NYAMIRA,NYAMIRA NORTH,33,905,1320,2225
NYAMIRA,NYAMIRA NORTH,34,858,1146,2004
NYAMIRA,NYAMIRA NORTH,30-34,5026,7464,12490
NYAMIRA,NYAMIRA NORTH,35,1170,1274,2444
NYAMIRA,NYAMIRA NORTH,36,746,715,1461
NYAMIRA,NYAMIRA NORTH,37,752,685,1437
NYAMIRA,NYAMIRA NORTH,38,558,574,1132
NYAMIRA,NYAMIRA NORTH,39,699,661,1360
NYAMIRA,NYAMIRA NORTH,35-39,3925,3909,7834
NYAMIRA,NYAMIRA NORTH,40,885,974,1859
NYAMIRA,NYAMIRA NORTH,41,1033,1001,2034
NYAMIRA,NYAMIRA NORTH,42,683,790,1473
NYAMIRA,NYAMIRA NORTH,43,617,774,1391
NYAMIRA,NYAMIRA NORTH,44,474,524,998
NYAMIRA,NYAMIRA NORTH,40-44,3692,4063,7755
NYAMIRA,NYAMIRA NORTH,45,944,1031,1975
NYAMIRA,NYAMIRA NORTH,46,627,712,1339
NYAMIRA,NYAMIRA NORTH,47,644,737,1381
NYAMIRA,NYAMIRA NORTH,48,404,453,857
NYAMIRA,NYAMIRA NORTH,49,491,627,1118
NYAMIRA,NYAMIRA NORTH,45-49,3110,3560,6670
NYAMIRA,NYAMIRA NORTH,50,579,693,1272
NYAMIRA,NYAMIRA NORTH,51,467,417,884
NYAMIRA,NYAMIRA NORTH,52,371,332,703
NYAMIRA,NYAMIRA NORTH,53,310,233,543
NYAMIRA,NYAMIRA NORTH,54,369,276,645
NYAMIRA,NYAMIRA NORTH,50-54,2096,1951,4047
NYAMIRA,NYAMIRA NORTH,55,475,398,873
NYAMIRA,NYAMIRA NORTH,56,564,553,1117
NYAMIRA,NYAMIRA NORTH,57,571,606,1177
NYAMIRA,NYAMIRA NORTH,58,400,426,826
NYAMIRA,NYAMIRA NORTH,59,613,597,1210
NYAMIRA,NYAMIRA NORTH,55-59,2623,2580,5203
NYAMIRA,NYAMIRA NORTH,60,661,731,1392
NYAMIRA,NYAMIRA NORTH,61,527,453,980
NYAMIRA,NYAMIRA NORTH,62,331,338,669
NYAMIRA,NYAMIRA NORTH,63,381,348,729
NYAMIRA,NYAMIRA NORTH,64,239,271,510
NYAMIRA,NYAMIRA NORTH,60-64,2139,2141,4280
NYAMIRA,NYAMIRA NORTH,65,404,504,908
NYAMIRA,NYAMIRA NORTH,66,210,211,421
NYAMIRA,NYAMIRA NORTH,67,336,373,709
NYAMIRA,NYAMIRA NORTH,68,149,177,326
NYAMIRA,NYAMIRA NORTH,69,261,341,602
NYAMIRA,NYAMIRA NORTH,65-69,1360,1606,2966
NYAMIRA,NYAMIRA NORTH,70,375,491,866
NYAMIRA,NYAMIRA NORTH,71,260,266,526
NYAMIRA,NYAMIRA NORTH,72,169,153,322
NYAMIRA,NYAMIRA NORTH,73,141,126,267
NYAMIRA,NYAMIRA NORTH,74,149,174,323
NYAMIRA,NYAMIRA NORTH,70-74,1094,1210,2304
NYAMIRA,NYAMIRA NORTH,75,141,153,294
NYAMIRA,NYAMIRA NORTH,76,77,62,139
NYAMIRA,NYAMIRA NORTH,77,131,102,233
NYAMIRA,NYAMIRA NORTH,78,85,61,146
NYAMIRA,NYAMIRA NORTH,79,99,166,265
NYAMIRA,NYAMIRA NORTH,75-79,533,544,1077
NYAMIRA,NYAMIRA NORTH,80,100,206,306
NYAMIRA,NYAMIRA NORTH,81,76,97,173
NYAMIRA,NYAMIRA NORTH,82,56,46,102
NYAMIRA,NYAMIRA NORTH,83,57,51,108
NYAMIRA,NYAMIRA NORTH,84,73,76,149
NYAMIRA,NYAMIRA NORTH,80-84,362,476,838
NYAMIRA,NYAMIRA NORTH,85,38,70,108
NYAMIRA,NYAMIRA NORTH,86,27,36,63
NYAMIRA,NYAMIRA NORTH,87,49,50,99
NYAMIRA,NYAMIRA NORTH,88,26,17,43
NYAMIRA,NYAMIRA NORTH,89,44,118,162
NYAMIRA,NYAMIRA NORTH,85-89,184,291,475
NYAMIRA,NYAMIRA NORTH,90,32,67,99
NYAMIRA,NYAMIRA NORTH,91,19,26,45
NYAMIRA,NYAMIRA NORTH,92,11,13,24
NYAMIRA,NYAMIRA NORTH,93,10,16,26
NYAMIRA,NYAMIRA NORTH,94,16,11,27
NYAMIRA,NYAMIRA NORTH,90-94,88,133,221
NYAMIRA,NYAMIRA NORTH,95,23,23,46
NYAMIRA,NYAMIRA NORTH,96,4,6,10
NYAMIRA,NYAMIRA NORTH,97,11,6,17
NYAMIRA,NYAMIRA NORTH,98,8,9,17
NYAMIRA,NYAMIRA NORTH,99,6,21,27
NYAMIRA,NYAMIRA NORTH,95-99,52,65,117
NYAMIRA,NYAMIRA NORTH,100+,16,40,56
NYAMIRA,NYAMIRA NORTH,Not Stated,-,-,-
NYAMIRA,NYAMIRA SOUTH,Total,76105,82965,159070
NYAMIRA,NYAMIRA SOUTH,0,1592,1684,3276
NYAMIRA,NYAMIRA SOUTH,1,1726,1627,3353
NYAMIRA,NYAMIRA SOUTH,2,1667,1638,3305
NYAMIRA,NYAMIRA SOUTH,3,1764,1882,3646
NYAMIRA,NYAMIRA SOUTH,4,2074,1977,4051
NYAMIRA,NYAMIRA SOUTH,0 - 4,8823,8808,17631
NYAMIRA,NYAMIRA SOUTH,5,1970,1899,3869
NYAMIRA,NYAMIRA SOUTH,6,2041,2109,4150
NYAMIRA,NYAMIRA SOUTH,7,2127,2035,4162
NYAMIRA,NYAMIRA SOUTH,8,2046,2006,4052
NYAMIRA,NYAMIRA SOUTH,9,2280,2282,4562
NYAMIRA,NYAMIRA SOUTH,05-Sep,10464,10331,20795
NYAMIRA,NYAMIRA SOUTH,10,2560,2534,5094
NYAMIRA,NYAMIRA SOUTH,11,2136,2309,4445
NYAMIRA,NYAMIRA SOUTH,12,2740,2526,5266
NYAMIRA,NYAMIRA SOUTH,13,2385,2477,4862
NYAMIRA,NYAMIRA SOUTH,14,2254,2251,4505
NYAMIRA,NYAMIRA SOUTH,Oct-14,12075,12097,24172
NYAMIRA,NYAMIRA SOUTH,15,2148,2143,4291
NYAMIRA,NYAMIRA SOUTH,16,2024,1938,3962
NYAMIRA,NYAMIRA SOUTH,17,1979,1939,3918
NYAMIRA,NYAMIRA SOUTH,18,1555,1506,3061
NYAMIRA,NYAMIRA SOUTH,19,1609,1559,3168
NYAMIRA,NYAMIRA SOUTH,15-19,9315,9085,18400
NYAMIRA,NYAMIRA SOUTH,20,1273,1445,2718
NYAMIRA,NYAMIRA SOUTH,21,1007,1254,2261
NYAMIRA,NYAMIRA SOUTH,22,1000,1296,2296
NYAMIRA,NYAMIRA SOUTH,23,985,1345,2330
NYAMIRA,NYAMIRA SOUTH,24,926,1292,2218
NYAMIRA,NYAMIRA SOUTH,20-24,5191,6632,11823
NYAMIRA,NYAMIRA SOUTH,25,1229,1568,2797
NYAMIRA,NYAMIRA SOUTH,26,909,1267,2176
NYAMIRA,NYAMIRA SOUTH,27,1037,1291,2328
NYAMIRA,NYAMIRA SOUTH,28,877,1118,1995
NYAMIRA,NYAMIRA SOUTH,29,794,1254,2048
NYAMIRA,NYAMIRA SOUTH,25-29,4846,6498,11344
NYAMIRA,NYAMIRA SOUTH,30,1256,1773,3029
NYAMIRA,NYAMIRA SOUTH,31,891,1379,2270
NYAMIRA,NYAMIRA SOUTH,32,1038,1524,2562
NYAMIRA,NYAMIRA SOUTH,33,846,1227,2073
NYAMIRA,NYAMIRA SOUTH,34,823,1106,1929
NYAMIRA,NYAMIRA SOUTH,30-34,4854,7009,11863
NYAMIRA,NYAMIRA SOUTH,35,1170,1390,2560
NYAMIRA,NYAMIRA SOUTH,36,736,738,1474
NYAMIRA,NYAMIRA SOUTH,37,738,777,1515
NYAMIRA,NYAMIRA SOUTH,38,609,577,1186
NYAMIRA,NYAMIRA SOUTH,39,693,710,1403
NYAMIRA,NYAMIRA SOUTH,35-39,3946,4192,8138
NYAMIRA,NYAMIRA SOUTH,40,885,892,1777
NYAMIRA,NYAMIRA SOUTH,41,869,795,1664
NYAMIRA,NYAMIRA SOUTH,42,635,676,1311
NYAMIRA,NYAMIRA SOUTH,43,570,644,1214
NYAMIRA,NYAMIRA SOUTH,44,479,542,1021
NYAMIRA,NYAMIRA SOUTH,40-44,3438,3549,6987
NYAMIRA,NYAMIRA SOUTH,45,899,1022,1921
NYAMIRA,NYAMIRA SOUTH,46,518,674,1192
NYAMIRA,NYAMIRA SOUTH,47,611,743,1354
NYAMIRA,NYAMIRA SOUTH,48,405,410,815
NYAMIRA,NYAMIRA SOUTH,49,435,579,1014
NYAMIRA,NYAMIRA SOUTH,45-49,2868,3428,6296
NYAMIRA,NYAMIRA SOUTH,50,579,716,1295
NYAMIRA,NYAMIRA SOUTH,51,463,505,968
NYAMIRA,NYAMIRA SOUTH,52,304,287,591
NYAMIRA,NYAMIRA SOUTH,53,304,243,547
NYAMIRA,NYAMIRA SOUTH,54,353,296,649
NYAMIRA,NYAMIRA SOUTH,50-54,2003,2047,4050
NYAMIRA,NYAMIRA SOUTH,55,419,408,827
NYAMIRA,NYAMIRA SOUTH,56,554,599,1153
NYAMIRA,NYAMIRA SOUTH,57,616,697,1313
NYAMIRA,NYAMIRA SOUTH,58,398,422,820
NYAMIRA,NYAMIRA SOUTH,59,629,639,1268
NYAMIRA,NYAMIRA SOUTH,55-59,2616,2765,5381
NYAMIRA,NYAMIRA SOUTH,60,633,715,1348
NYAMIRA,NYAMIRA SOUTH,61,491,507,998
NYAMIRA,NYAMIRA SOUTH,62,323,337,660
NYAMIRA,NYAMIRA SOUTH,63,306,385,691
NYAMIRA,NYAMIRA SOUTH,64,233,266,499
NYAMIRA,NYAMIRA SOUTH,60-64,1986,2210,4196
NYAMIRA,NYAMIRA SOUTH,65,358,443,801
NYAMIRA,NYAMIRA SOUTH,66,175,205,380
NYAMIRA,NYAMIRA SOUTH,67,374,359,733
NYAMIRA,NYAMIRA SOUTH,68,174,183,357
NYAMIRA,NYAMIRA SOUTH,69,279,367,646
NYAMIRA,NYAMIRA SOUTH,65-69,1360,1557,2917
NYAMIRA,NYAMIRA SOUTH,70,355,490,845
NYAMIRA,NYAMIRA SOUTH,71,243,248,491
NYAMIRA,NYAMIRA SOUTH,72,186,149,335
NYAMIRA,NYAMIRA SOUTH,73,170,121,291
NYAMIRA,NYAMIRA SOUTH,74,146,187,333
NYAMIRA,NYAMIRA SOUTH,70-74,1100,1195,2295
NYAMIRA,NYAMIRA SOUTH,75,143,159,302
NYAMIRA,NYAMIRA SOUTH,76,81,69,150
NYAMIRA,NYAMIRA SOUTH,77,117,130,247
NYAMIRA,NYAMIRA SOUTH,78,72,69,141
NYAMIRA,NYAMIRA SOUTH,79,122,158,280
NYAMIRA,NYAMIRA SOUTH,75-79,535,585,1120
NYAMIRA,NYAMIRA SOUTH,80,115,214,329
NYAMIRA,NYAMIRA SOUTH,81,62,86,148
NYAMIRA,NYAMIRA SOUTH,82,54,41,95
NYAMIRA,NYAMIRA SOUTH,83,68,69,137
NYAMIRA,NYAMIRA SOUTH,84,54,88,142
NYAMIRA,NYAMIRA SOUTH,80-84,353,498,851
NYAMIRA,NYAMIRA SOUTH,85,69,87,156
NYAMIRA,NYAMIRA SOUTH,86,24,28,52
NYAMIRA,NYAMIRA SOUTH,87,42,42,84
NYAMIRA,NYAMIRA SOUTH,88,28,13,41
NYAMIRA,NYAMIRA SOUTH,89,35,91,126
NYAMIRA,NYAMIRA SOUTH,85-89,198,261,459
NYAMIRA,NYAMIRA SOUTH,90,21,59,80
NYAMIRA,NYAMIRA SOUTH,91,21,30,51
NYAMIRA,NYAMIRA SOUTH,92,13,19,32
NYAMIRA,NYAMIRA SOUTH,93,8,9,17
NYAMIRA,NYAMIRA SOUTH,94,13,12,25
NYAMIRA,NYAMIRA SOUTH,90-94,76,129,205
NYAMIRA,NYAMIRA SOUTH,95,17,18,35
NYAMIRA,NYAMIRA SOUTH,96,4,8,12
NYAMIRA,NYAMIRA SOUTH,97,9,4,13
NYAMIRA,NYAMIRA SOUTH,98,3,8,11
NYAMIRA,NYAMIRA SOUTH,99,12,15,27
NYAMIRA,NYAMIRA SOUTH,95-99,45,53,98
NYAMIRA,NYAMIRA SOUTH,100+,13,34,47
NYAMIRA,NYAMIRA SOUTH,Not Stated,-,2,2
NYANDARUA,ALL,Total,315022,323247,638269
NYANDARUA,ALL,0,6857,6971,13828
NYANDARUA,ALL,1,6896,6743,13639
NYANDARUA,ALL,2,7097,6885,13982
NYANDARUA,ALL,3,7177,7052,14229
NYANDARUA,ALL,4,7329,6981,14310
NYANDARUA,ALL,0 - 4,35356,34632,69988
NYANDARUA,ALL,5,7314,6902,14216
NYANDARUA,ALL,6,7198,7228,14426
NYANDARUA,ALL,7,7697,7348,15045
NYANDARUA,ALL,8,7388,7315,14703
NYANDARUA,ALL,9,8366,8147,16513
NYANDARUA,ALL,05-Sep,37963,36940,74903
NYANDARUA,ALL,10,8235,7758,15993
NYANDARUA,ALL,11,7676,7591,15267
NYANDARUA,ALL,12,8723,8116,16839
NYANDARUA,ALL,13,8862,8483,17345
NYANDARUA,ALL,14,9044,8385,17429
NYANDARUA,ALL,Oct-14,42540,40333,82873
NYANDARUA,ALL,15,8703,8040,16743
NYANDARUA,ALL,16,8462,8105,16567
NYANDARUA,ALL,17,8732,7871,16603
NYANDARUA,ALL,18,6789,6084,12873
NYANDARUA,ALL,19,6747,6035,12782
NYANDARUA,ALL,15-19,39433,36135,75568
NYANDARUA,ALL,20,5476,5218,10694
NYANDARUA,ALL,21,5152,4941,10093
NYANDARUA,ALL,22,4890,4687,9577
NYANDARUA,ALL,23,4584,4907,9491
NYANDARUA,ALL,24,4117,4491,8608
NYANDARUA,ALL,20-24,24219,24244,48463
NYANDARUA,ALL,25,4482,4373,8855
NYANDARUA,ALL,26,3541,3977,7518
NYANDARUA,ALL,27,3722,4026,7748
NYANDARUA,ALL,28,3355,3681,7036
NYANDARUA,ALL,29,3737,4032,7769
NYANDARUA,ALL,25-29,18837,20089,38926
NYANDARUA,ALL,30,4466,5129,9595
NYANDARUA,ALL,31,3529,3736,7265
NYANDARUA,ALL,32,4255,4982,9237
NYANDARUA,ALL,33,3656,4432,8088
NYANDARUA,ALL,34,3716,4130,7846
NYANDARUA,ALL,30-34,19622,22409,42031
NYANDARUA,ALL,35,5064,5363,10427
NYANDARUA,ALL,36,3518,3977,7495
NYANDARUA,ALL,37,3666,3818,7484
NYANDARUA,ALL,38,3025,3502,6527
NYANDARUA,ALL,39,3475,3816,7291
NYANDARUA,ALL,35-39,18748,20476,39224
NYANDARUA,ALL,40,4035,4282,8317
NYANDARUA,ALL,41,3761,3963,7724
NYANDARUA,ALL,42,3510,3800,7310
NYANDARUA,ALL,43,3049,3404,6453
NYANDARUA,ALL,44,2550,2740,5290
NYANDARUA,ALL,40-44,16905,18189,35094
NYANDARUA,ALL,45,3853,4141,7994
NYANDARUA,ALL,46,2979,3340,6319
NYANDARUA,ALL,47,3341,3488,6829
NYANDARUA,ALL,48,2443,2732,5175
NYANDARUA,ALL,49,2852,3060,5912
NYANDARUA,ALL,45-49,15468,16761,32229
NYANDARUA,ALL,50,3110,3458,6568
NYANDARUA,ALL,51,2529,2702,5231
NYANDARUA,ALL,52,2825,2928,5753
NYANDARUA,ALL,53,2018,2283,4301
NYANDARUA,ALL,54,2320,2561,4881
NYANDARUA,ALL,50-54,12802,13932,26734
NYANDARUA,ALL,55,2563,2605,5168
NYANDARUA,ALL,56,2537,2527,5064
NYANDARUA,ALL,57,1960,2424,4384
NYANDARUA,ALL,58,1829,1882,3711
NYANDARUA,ALL,59,1862,2067,3929
NYANDARUA,ALL,55-59,10751,11505,22256
NYANDARUA,ALL,60,2037,2150,4187
NYANDARUA,ALL,61,1489,1644,3133
NYANDARUA,ALL,62,1436,1359,2795
NYANDARUA,ALL,63,1131,1140,2271
NYANDARUA,ALL,64,766,900,1666
NYANDARUA,ALL,60-64,6859,7193,14052
NYANDARUA,ALL,65,1363,1308,2671
NYANDARUA,ALL,66,919,963,1882
NYANDARUA,ALL,67,1503,1664,3167
NYANDARUA,ALL,68,607,801,1408
NYANDARUA,ALL,69,976,1215,2191
NYANDARUA,ALL,65-69,5368,5951,11319
NYANDARUA,ALL,70,1265,1606,2871
NYANDARUA,ALL,71,893,1091,1984
NYANDARUA,ALL,72,852,966,1818
NYANDARUA,ALL,73,668,800,1468
NYANDARUA,ALL,74,656,881,1537
NYANDARUA,ALL,70-74,4334,5344,9678
NYANDARUA,ALL,75,574,886,1460
NYANDARUA,ALL,76,747,1596,2343
NYANDARUA,ALL,77,474,664,1138
NYANDARUA,ALL,78,302,466,768
NYANDARUA,ALL,79,388,617,1005
NYANDARUA,ALL,75-79,2485,4229,6714
NYANDARUA,ALL,80,527,768,1295
NYANDARUA,ALL,81,289,426,715
NYANDARUA,ALL,82,262,317,579
NYANDARUA,ALL,83,372,321,693
NYANDARUA,ALL,84,321,417,738
NYANDARUA,ALL,80-84,1771,2249,4020
NYANDARUA,ALL,85,248,352,600
NYANDARUA,ALL,86,167,296,463
NYANDARUA,ALL,87,177,248,425
NYANDARUA,ALL,88,105,133,238
NYANDARUA,ALL,89,188,355,543
NYANDARUA,ALL,85-89,885,1384,2269
NYANDARUA,ALL,90,129,223,352
NYANDARUA,ALL,91,144,181,325
NYANDARUA,ALL,92,56,104,160
NYANDARUA,ALL,93,49,72,121
NYANDARUA,ALL,94,29,104,133
NYANDARUA,ALL,90-94,407,684,1091
NYANDARUA,ALL,95,48,116,164
NYANDARUA,ALL,96,28,64,92
NYANDARUA,ALL,97,47,78,125
NYANDARUA,ALL,98,27,40,67
NYANDARUA,ALL,99,42,75,117
NYANDARUA,ALL,95-99,192,373,565
NYANDARUA,ALL,100+,73,194,267
NYANDARUA,ALL,Not Stated,4,1,5
NYANDARUA,KINANGOP,Total,54727,56679,111406
NYANDARUA,KINANGOP,0,1252,1246,2498
NYANDARUA,KINANGOP,1,1220,1189,2409
NYANDARUA,KINANGOP,2,1236,1189,2425
NYANDARUA,KINANGOP,3,1321,1288,2609
NYANDARUA,KINANGOP,4,1262,1246,2508
NYANDARUA,KINANGOP,0 - 4,6291,6158,12449
NYANDARUA,KINANGOP,5,1280,1226,2506
NYANDARUA,KINANGOP,6,1254,1217,2471
NYANDARUA,KINANGOP,7,1378,1306,2684
NYANDARUA,KINANGOP,8,1236,1344,2580
NYANDARUA,KINANGOP,9,1505,1449,2954
NYANDARUA,KINANGOP,05-Sep,6653,6542,13195
NYANDARUA,KINANGOP,10,1466,1389,2855
NYANDARUA,KINANGOP,11,1368,1302,2670
NYANDARUA,KINANGOP,12,1540,1402,2942
NYANDARUA,KINANGOP,13,1591,1510,3101
NYANDARUA,KINANGOP,14,1554,1510,3064
NYANDARUA,KINANGOP,Oct-14,7519,7113,14632
NYANDARUA,KINANGOP,15,1529,1426,2955
NYANDARUA,KINANGOP,16,1460,1461,2921
NYANDARUA,KINANGOP,17,1510,1355,2865
NYANDARUA,KINANGOP,18,1161,1124,2285
NYANDARUA,KINANGOP,19,1150,1029,2179
NYANDARUA,KINANGOP,15-19,6810,6395,13205
NYANDARUA,KINANGOP,20,932,879,1811
NYANDARUA,KINANGOP,21,926,855,1781
NYANDARUA,KINANGOP,22,850,793,1643
NYANDARUA,KINANGOP,23,759,825,1584
NYANDARUA,KINANGOP,24,667,820,1487
NYANDARUA,KINANGOP,20-24,4134,4172,8306
NYANDARUA,KINANGOP,25,775,757,1532
NYANDARUA,KINANGOP,26,648,714,1362
NYANDARUA,KINANGOP,27,695,792,1487
NYANDARUA,KINANGOP,28,606,657,1263
NYANDARUA,KINANGOP,29,662,732,1394
NYANDARUA,KINANGOP,25-29,3386,3652,7038
NYANDARUA,KINANGOP,30,786,915,1701
NYANDARUA,KINANGOP,31,663,686,1349
NYANDARUA,KINANGOP,32,797,927,1724
NYANDARUA,KINANGOP,33,710,766,1476
NYANDARUA,KINANGOP,34,677,742,1419
NYANDARUA,KINANGOP,30-34,3633,4036,7669
NYANDARUA,KINANGOP,35,869,999,1868
NYANDARUA,KINANGOP,36,608,723,1331
NYANDARUA,KINANGOP,37,602,690,1292
NYANDARUA,KINANGOP,38,559,684,1243
NYANDARUA,KINANGOP,39,573,685,1258
NYANDARUA,KINANGOP,35-39,3211,3781,6992
NYANDARUA,KINANGOP,40,681,743,1424
NYANDARUA,KINANGOP,41,673,747,1420
NYANDARUA,KINANGOP,42,633,648,1281
NYANDARUA,KINANGOP,43,535,612,1147
NYANDARUA,KINANGOP,44,434,477,911
NYANDARUA,KINANGOP,40-44,2956,3227,6183
NYANDARUA,KINANGOP,45,676,718,1394
NYANDARUA,KINANGOP,46,543,600,1143
NYANDARUA,KINANGOP,47,588,641,1229
NYANDARUA,KINANGOP,48,427,515,942
NYANDARUA,KINANGOP,49,536,585,1121
NYANDARUA,KINANGOP,45-49,2770,3059,5829
NYANDARUA,KINANGOP,50,566,618,1184
NYANDARUA,KINANGOP,51,413,460,873
NYANDARUA,KINANGOP,52,540,541,1081
NYANDARUA,KINANGOP,53,360,420,780
NYANDARUA,KINANGOP,54,411,427,838
NYANDARUA,KINANGOP,50-54,2290,2466,4756
NYANDARUA,KINANGOP,55,444,452,896
NYANDARUA,KINANGOP,56,453,417,870
NYANDARUA,KINANGOP,57,322,410,732
NYANDARUA,KINANGOP,58,242,277,519
NYANDARUA,KINANGOP,59,298,327,625
NYANDARUA,KINANGOP,55-59,1759,1883,3642
NYANDARUA,KINANGOP,60,314,337,651
NYANDARUA,KINANGOP,61,209,264,473
NYANDARUA,KINANGOP,62,232,207,439
NYANDARUA,KINANGOP,63,175,150,325
NYANDARUA,KINANGOP,64,126,149,275
NYANDARUA,KINANGOP,60-64,1056,1107,2163
NYANDARUA,KINANGOP,65,213,198,411
NYANDARUA,KINANGOP,66,149,159,308
NYANDARUA,KINANGOP,67,222,270,492
NYANDARUA,KINANGOP,68,102,139,241
NYANDARUA,KINANGOP,69,149,200,349
NYANDARUA,KINANGOP,65-69,835,966,1801
NYANDARUA,KINANGOP,70,210,220,430
NYANDARUA,KINANGOP,71,126,153,279
NYANDARUA,KINANGOP,72,127,152,279
NYANDARUA,KINANGOP,73,95,132,227
NYANDARUA,KINANGOP,74,56,135,191
NYANDARUA,KINANGOP,70-74,614,792,1406
NYANDARUA,KINANGOP,75,71,122,193
NYANDARUA,KINANGOP,76,98,244,342
NYANDARUA,KINANGOP,77,71,111,182
NYANDARUA,KINANGOP,78,34,67,101
NYANDARUA,KINANGOP,79,59,100,159
NYANDARUA,KINANGOP,75-79,333,644,977
NYANDARUA,KINANGOP,80,85,105,190
NYANDARUA,KINANGOP,81,43,70,113
NYANDARUA,KINANGOP,82,28,51,79
NYANDARUA,KINANGOP,83,46,40,86
NYANDARUA,KINANGOP,84,52,59,111
NYANDARUA,KINANGOP,80-84,254,325,579
NYANDARUA,KINANGOP,85,44,59,103
NYANDARUA,KINANGOP,86,25,42,67
NYANDARUA,KINANGOP,87,30,25,55
NYANDARUA,KINANGOP,88,19,10,29
NYANDARUA,KINANGOP,89,27,53,80
NYANDARUA,KINANGOP,85-89,145,189,334
NYANDARUA,KINANGOP,90,12,33,45
NYANDARUA,KINANGOP,91,12,18,30
NYANDARUA,KINANGOP,92,6,16,22
NYANDARUA,KINANGOP,93,8,8,16
NYANDARUA,KINANGOP,94,4,14,18
NYANDARUA,KINANGOP,90-94,42,89,131
NYANDARUA,KINANGOP,95,5,19,24
NYANDARUA,KINANGOP,96,5,11,16
NYANDARUA,KINANGOP,97,10,10,20
NYANDARUA,KINANGOP,98,3,7,10
NYANDARUA,KINANGOP,99,7,7,14
NYANDARUA,KINANGOP,95-99,30,54,84
NYANDARUA,KINANGOP,100+,4,29,33
NYANDARUA,KINANGOP,Not Stated,2,-,2
NYANDARUA,NYANDARUA SOUTH,Total,46157,47708,93865
NYANDARUA,NYANDARUA SOUTH,0,1006,1006,2012
NYANDARUA,NYANDARUA SOUTH,1,987,974,1961
NYANDARUA,NYANDARUA SOUTH,2,1047,1044,2091
NYANDARUA,NYANDARUA SOUTH,3,1017,978,1995
NYANDARUA,NYANDARUA SOUTH,4,1082,1099,2181
NYANDARUA,NYANDARUA SOUTH,0 - 4,5139,5101,10240
NYANDARUA,NYANDARUA SOUTH,5,1055,1004,2059
NYANDARUA,NYANDARUA SOUTH,6,1071,1069,2140
NYANDARUA,NYANDARUA SOUTH,7,1109,1071,2180
NYANDARUA,NYANDARUA SOUTH,8,1130,1040,2170
NYANDARUA,NYANDARUA SOUTH,9,1221,1154,2375
NYANDARUA,NYANDARUA SOUTH,05-Sep,5586,5338,10924
NYANDARUA,NYANDARUA SOUTH,10,1240,1158,2398
NYANDARUA,NYANDARUA SOUTH,11,1124,1159,2283
NYANDARUA,NYANDARUA SOUTH,12,1237,1187,2424
NYANDARUA,NYANDARUA SOUTH,13,1310,1267,2577
NYANDARUA,NYANDARUA SOUTH,14,1334,1272,2606
NYANDARUA,NYANDARUA SOUTH,Oct-14,6245,6043,12288
NYANDARUA,NYANDARUA SOUTH,15,1302,1215,2517
NYANDARUA,NYANDARUA SOUTH,16,1269,1241,2510
NYANDARUA,NYANDARUA SOUTH,17,1276,1199,2475
NYANDARUA,NYANDARUA SOUTH,18,1064,936,2000
NYANDARUA,NYANDARUA SOUTH,19,1041,901,1942
NYANDARUA,NYANDARUA SOUTH,15-19,5952,5492,11444
NYANDARUA,NYANDARUA SOUTH,20,803,804,1607
NYANDARUA,NYANDARUA SOUTH,21,727,795,1522
NYANDARUA,NYANDARUA SOUTH,22,733,698,1431
NYANDARUA,NYANDARUA SOUTH,23,724,776,1500
NYANDARUA,NYANDARUA SOUTH,24,646,758,1404
NYANDARUA,NYANDARUA SOUTH,20-24,3633,3831,7464
NYANDARUA,NYANDARUA SOUTH,25,698,676,1374
NYANDARUA,NYANDARUA SOUTH,26,571,617,1188
NYANDARUA,NYANDARUA SOUTH,27,563,590,1153
NYANDARUA,NYANDARUA SOUTH,28,490,561,1051
NYANDARUA,NYANDARUA SOUTH,29,572,596,1168
NYANDARUA,NYANDARUA SOUTH,25-29,2894,3040,5934
NYANDARUA,NYANDARUA SOUTH,30,689,841,1530
NYANDARUA,NYANDARUA SOUTH,31,504,562,1066
NYANDARUA,NYANDARUA SOUTH,32,651,773,1424
NYANDARUA,NYANDARUA SOUTH,33,540,697,1237
NYANDARUA,NYANDARUA SOUTH,34,580,620,1200
NYANDARUA,NYANDARUA SOUTH,30-34,2964,3493,6457
NYANDARUA,NYANDARUA SOUTH,35,765,787,1552
NYANDARUA,NYANDARUA SOUTH,36,535,609,1144
NYANDARUA,NYANDARUA SOUTH,37,539,587,1126
NYANDARUA,NYANDARUA SOUTH,38,423,522,945
NYANDARUA,NYANDARUA SOUTH,39,511,562,1073
NYANDARUA,NYANDARUA SOUTH,35-39,2773,3067,5840
NYANDARUA,NYANDARUA SOUTH,40,614,669,1283
NYANDARUA,NYANDARUA SOUTH,41,534,606,1140
NYANDARUA,NYANDARUA SOUTH,42,568,583,1151
NYANDARUA,NYANDARUA SOUTH,43,464,510,974
NYANDARUA,NYANDARUA SOUTH,44,356,385,741
NYANDARUA,NYANDARUA SOUTH,40-44,2536,2753,5289
NYANDARUA,NYANDARUA SOUTH,45,575,664,1239
NYANDARUA,NYANDARUA SOUTH,46,432,533,965
NYANDARUA,NYANDARUA SOUTH,47,530,529,1059
NYANDARUA,NYANDARUA SOUTH,48,349,411,760
NYANDARUA,NYANDARUA SOUTH,49,410,407,817
NYANDARUA,NYANDARUA SOUTH,45-49,2296,2544,4840
NYANDARUA,NYANDARUA SOUTH,50,452,492,944
NYANDARUA,NYANDARUA SOUTH,51,364,394,758
NYANDARUA,NYANDARUA SOUTH,52,403,419,822
NYANDARUA,NYANDARUA SOUTH,53,283,321,604
NYANDARUA,NYANDARUA SOUTH,54,324,339,663
NYANDARUA,NYANDARUA SOUTH,50-54,1826,1965,3791
NYANDARUA,NYANDARUA SOUTH,55,371,325,696
NYANDARUA,NYANDARUA SOUTH,56,348,312,660
NYANDARUA,NYANDARUA SOUTH,57,276,316,592
NYANDARUA,NYANDARUA SOUTH,58,225,254,479
NYANDARUA,NYANDARUA SOUTH,59,263,279,542
NYANDARUA,NYANDARUA SOUTH,55-59,1483,1486,2969
NYANDARUA,NYANDARUA SOUTH,60,289,257,546
NYANDARUA,NYANDARUA SOUTH,61,192,205,397
NYANDARUA,NYANDARUA SOUTH,62,175,178,353
NYANDARUA,NYANDARUA SOUTH,63,146,158,304
NYANDARUA,NYANDARUA SOUTH,64,106,105,211
NYANDARUA,NYANDARUA SOUTH,60-64,908,903,1811
NYANDARUA,NYANDARUA SOUTH,65,177,150,327
NYANDARUA,NYANDARUA SOUTH,66,102,121,223
NYANDARUA,NYANDARUA SOUTH,67,161,214,375
NYANDARUA,NYANDARUA SOUTH,68,64,105,169
NYANDARUA,NYANDARUA SOUTH,69,99,159,258
NYANDARUA,NYANDARUA SOUTH,65-69,603,749,1352
NYANDARUA,NYANDARUA SOUTH,70,145,203,348
NYANDARUA,NYANDARUA SOUTH,71,125,152,277
NYANDARUA,NYANDARUA SOUTH,72,116,141,257
NYANDARUA,NYANDARUA SOUTH,73,90,101,191
NYANDARUA,NYANDARUA SOUTH,74,81,126,207
NYANDARUA,NYANDARUA SOUTH,70-74,557,723,1280
NYANDARUA,NYANDARUA SOUTH,75,71,117,188
NYANDARUA,NYANDARUA SOUTH,76,89,246,335
NYANDARUA,NYANDARUA SOUTH,77,55,94,149
NYANDARUA,NYANDARUA SOUTH,78,34,60,94
NYANDARUA,NYANDARUA SOUTH,79,54,89,143
NYANDARUA,NYANDARUA SOUTH,75-79,303,606,909
NYANDARUA,NYANDARUA SOUTH,80,78,95,173
NYANDARUA,NYANDARUA SOUTH,81,34,50,84
NYANDARUA,NYANDARUA SOUTH,82,42,46,88
NYANDARUA,NYANDARUA SOUTH,83,52,34,86
NYANDARUA,NYANDARUA SOUTH,84,47,45,92
NYANDARUA,NYANDARUA SOUTH,80-84,253,270,523
NYANDARUA,NYANDARUA SOUTH,85,31,45,76
NYANDARUA,NYANDARUA SOUTH,86,23,42,65
NYANDARUA,NYANDARUA SOUTH,87,18,34,52
NYANDARUA,NYANDARUA SOUTH,88,16,17,33
NYANDARUA,NYANDARUA SOUTH,89,25,34,59
NYANDARUA,NYANDARUA SOUTH,85-89,113,172,285
NYANDARUA,NYANDARUA SOUTH,90,21,18,39
NYANDARUA,NYANDARUA SOUTH,91,19,21,40
NYANDARUA,NYANDARUA SOUTH,92,8,14,22
NYANDARUA,NYANDARUA SOUTH,93,2,7,9
NYANDARUA,NYANDARUA SOUTH,94,6,17,23
NYANDARUA,NYANDARUA SOUTH,90-94,56,77,133
NYANDARUA,NYANDARUA SOUTH,95,5,13,18
NYANDARUA,NYANDARUA SOUTH,96,6,7,13
NYANDARUA,NYANDARUA SOUTH,97,6,6,12
NYANDARUA,NYANDARUA SOUTH,98,4,2,6
NYANDARUA,NYANDARUA SOUTH,99,3,8,11
NYANDARUA,NYANDARUA SOUTH,95-99,24,36,60
NYANDARUA,NYANDARUA SOUTH,100+,12,19,31
NYANDARUA,NYANDARUA SOUTH,Not Stated,1,-,1
NYANDARUA,MIRANGINE,Total,33447,33766,67213
NYANDARUA,MIRANGINE,0,703,765,1468
NYANDARUA,MIRANGINE,1,740,723,1463
NYANDARUA,MIRANGINE,2,726,734,1460
NYANDARUA,MIRANGINE,3,821,765,1586
NYANDARUA,MIRANGINE,4,806,728,1534
NYANDARUA,MIRANGINE,0 - 4,3796,3715,7511
NYANDARUA,MIRANGINE,5,762,737,1499
NYANDARUA,MIRANGINE,6,776,782,1558
NYANDARUA,MIRANGINE,7,820,796,1616
NYANDARUA,MIRANGINE,8,830,836,1666
NYANDARUA,MIRANGINE,9,941,909,1850
NYANDARUA,MIRANGINE,05-Sep,4129,4060,8189
NYANDARUA,MIRANGINE,10,854,850,1704
NYANDARUA,MIRANGINE,11,815,874,1689
NYANDARUA,MIRANGINE,12,1000,934,1934
NYANDARUA,MIRANGINE,13,989,936,1925
NYANDARUA,MIRANGINE,14,981,911,1892
NYANDARUA,MIRANGINE,Oct-14,4639,4505,9144
NYANDARUA,MIRANGINE,15,931,850,1781
NYANDARUA,MIRANGINE,16,927,907,1834
NYANDARUA,MIRANGINE,17,950,804,1754
NYANDARUA,MIRANGINE,18,764,640,1404
NYANDARUA,MIRANGINE,19,715,642,1357
NYANDARUA,MIRANGINE,15-19,4287,3843,8130
NYANDARUA,MIRANGINE,20,610,620,1230
NYANDARUA,MIRANGINE,21,643,631,1274
NYANDARUA,MIRANGINE,22,591,572,1163
NYANDARUA,MIRANGINE,23,544,587,1131
NYANDARUA,MIRANGINE,24,451,439,890
NYANDARUA,MIRANGINE,20-24,2839,2849,5688
NYANDARUA,MIRANGINE,25,507,442,949
NYANDARUA,MIRANGINE,26,364,404,768
NYANDARUA,MIRANGINE,27,414,381,795
NYANDARUA,MIRANGINE,28,342,345,687
NYANDARUA,MIRANGINE,29,382,415,797
NYANDARUA,MIRANGINE,25-29,2009,1987,3996
NYANDARUA,MIRANGINE,30,445,522,967
NYANDARUA,MIRANGINE,31,353,352,705
NYANDARUA,MIRANGINE,32,427,550,977
NYANDARUA,MIRANGINE,33,377,496,873
NYANDARUA,MIRANGINE,34,360,419,779
NYANDARUA,MIRANGINE,30-34,1962,2339,4301
NYANDARUA,MIRANGINE,35,512,551,1063
NYANDARUA,MIRANGINE,36,345,381,726
NYANDARUA,MIRANGINE,37,374,359,733
NYANDARUA,MIRANGINE,38,289,315,604
NYANDARUA,MIRANGINE,39,370,376,746
NYANDARUA,MIRANGINE,35-39,1890,1982,3872
NYANDARUA,MIRANGINE,40,398,379,777
NYANDARUA,MIRANGINE,41,375,368,743
NYANDARUA,MIRANGINE,42,370,370,740
NYANDARUA,MIRANGINE,43,351,323,674
NYANDARUA,MIRANGINE,44,240,253,493
NYANDARUA,MIRANGINE,40-44,1734,1693,3427
NYANDARUA,MIRANGINE,45,397,401,798
NYANDARUA,MIRANGINE,46,304,345,649
NYANDARUA,MIRANGINE,47,329,342,671
NYANDARUA,MIRANGINE,48,267,251,518
NYANDARUA,MIRANGINE,49,244,308,552
NYANDARUA,MIRANGINE,45-49,1541,1647,3188
NYANDARUA,MIRANGINE,50,264,309,573
NYANDARUA,MIRANGINE,51,261,268,529
NYANDARUA,MIRANGINE,52,307,291,598
NYANDARUA,MIRANGINE,53,214,204,418
NYANDARUA,MIRANGINE,54,256,238,494
NYANDARUA,MIRANGINE,50-54,1302,1310,2612
NYANDARUA,MIRANGINE,55,241,240,481
NYANDARUA,MIRANGINE,56,227,245,472
NYANDARUA,MIRANGINE,57,193,228,421
NYANDARUA,MIRANGINE,58,196,177,373
NYANDARUA,MIRANGINE,59,183,207,390
NYANDARUA,MIRANGINE,55-59,1040,1097,2137
NYANDARUA,MIRANGINE,60,192,221,413
NYANDARUA,MIRANGINE,61,170,163,333
NYANDARUA,MIRANGINE,62,160,127,287
NYANDARUA,MIRANGINE,63,109,123,232
NYANDARUA,MIRANGINE,64,67,84,151
NYANDARUA,MIRANGINE,60-64,698,718,1416
NYANDARUA,MIRANGINE,65,132,142,274
NYANDARUA,MIRANGINE,66,103,100,203
NYANDARUA,MIRANGINE,67,160,148,308
NYANDARUA,MIRANGINE,68,79,84,163
NYANDARUA,MIRANGINE,69,100,130,230
NYANDARUA,MIRANGINE,65-69,574,604,1178
NYANDARUA,MIRANGINE,70,111,155,266
NYANDARUA,MIRANGINE,71,95,117,212
NYANDARUA,MIRANGINE,72,79,102,181
NYANDARUA,MIRANGINE,73,75,82,157
NYANDARUA,MIRANGINE,74,89,101,190
NYANDARUA,MIRANGINE,70-74,449,557,1006
NYANDARUA,MIRANGINE,75,60,76,136
NYANDARUA,MIRANGINE,76,67,135,202
NYANDARUA,MIRANGINE,77,45,52,97
NYANDARUA,MIRANGINE,78,33,39,72
NYANDARUA,MIRANGINE,79,30,59,89
NYANDARUA,MIRANGINE,75-79,235,361,596
NYANDARUA,MIRANGINE,80,43,70,113
NYANDARUA,MIRANGINE,81,32,37,69
NYANDARUA,MIRANGINE,82,24,32,56
NYANDARUA,MIRANGINE,83,34,41,75
NYANDARUA,MIRANGINE,84,28,45,73
NYANDARUA,MIRANGINE,80-84,161,225,386
NYANDARUA,MIRANGINE,85,24,26,50
NYANDARUA,MIRANGINE,86,22,28,50
NYANDARUA,MIRANGINE,87,20,24,44
NYANDARUA,MIRANGINE,88,12,12,24
NYANDARUA,MIRANGINE,89,21,38,59
NYANDARUA,MIRANGINE,85-89,99,128,227
NYANDARUA,MIRANGINE,90,10,24,34
NYANDARUA,MIRANGINE,91,14,21,35
NYANDARUA,MIRANGINE,92,3,14,17
NYANDARUA,MIRANGINE,93,8,7,15
NYANDARUA,MIRANGINE,94,4,17,21
NYANDARUA,MIRANGINE,90-94,39,83,122
NYANDARUA,MIRANGINE,95,3,11,14
NYANDARUA,MIRANGINE,96,-,8,8
NYANDARUA,MIRANGINE,97,4,8,12
NYANDARUA,MIRANGINE,98,5,6,11
NYANDARUA,MIRANGINE,99,4,11,15
NYANDARUA,MIRANGINE,95-99,16,44,60
NYANDARUA,MIRANGINE,100+,7,19,26
NYANDARUA,MIRANGINE,Not Stated,1,-,1
NYANDARUA,KIPIPIRI,Total,46113,47740,93853
NYANDARUA,KIPIPIRI,0,935,953,1888
NYANDARUA,KIPIPIRI,1,987,970,1957
NYANDARUA,KIPIPIRI,2,947,1028,1975
NYANDARUA,KIPIPIRI,3,1051,1022,2073
NYANDARUA,KIPIPIRI,4,1054,995,2049
NYANDARUA,KIPIPIRI,0 - 4,4974,4968,9942
NYANDARUA,KIPIPIRI,5,1043,1020,2063
NYANDARUA,KIPIPIRI,6,1021,1062,2083
NYANDARUA,KIPIPIRI,7,1135,1108,2243
NYANDARUA,KIPIPIRI,8,1114,1097,2211
NYANDARUA,KIPIPIRI,9,1252,1246,2498
NYANDARUA,KIPIPIRI,05-Sep,5565,5533,11098
NYANDARUA,KIPIPIRI,10,1216,1179,2395
NYANDARUA,KIPIPIRI,11,1248,1179,2427
NYANDARUA,KIPIPIRI,12,1421,1264,2685
NYANDARUA,KIPIPIRI,13,1406,1395,2801
NYANDARUA,KIPIPIRI,14,1363,1305,2668
NYANDARUA,KIPIPIRI,Oct-14,6654,6322,12976
NYANDARUA,KIPIPIRI,15,1419,1315,2734
NYANDARUA,KIPIPIRI,16,1371,1317,2688
NYANDARUA,KIPIPIRI,17,1413,1300,2713
NYANDARUA,KIPIPIRI,18,1055,926,1981
NYANDARUA,KIPIPIRI,19,1066,962,2028
NYANDARUA,KIPIPIRI,15-19,6324,5820,12144
NYANDARUA,KIPIPIRI,20,869,731,1600
NYANDARUA,KIPIPIRI,21,750,620,1370
NYANDARUA,KIPIPIRI,22,640,641,1281
NYANDARUA,KIPIPIRI,23,610,645,1255
NYANDARUA,KIPIPIRI,24,578,573,1151
NYANDARUA,KIPIPIRI,20-24,3447,3210,6657
NYANDARUA,KIPIPIRI,25,575,551,1126
NYANDARUA,KIPIPIRI,26,461,487,948
NYANDARUA,KIPIPIRI,27,475,503,978
NYANDARUA,KIPIPIRI,28,437,456,893
NYANDARUA,KIPIPIRI,29,489,551,1040
NYANDARUA,KIPIPIRI,25-29,2437,2548,4985
NYANDARUA,KIPIPIRI,30,543,630,1173
NYANDARUA,KIPIPIRI,31,443,561,1004
NYANDARUA,KIPIPIRI,32,555,625,1180
NYANDARUA,KIPIPIRI,33,455,635,1090
NYANDARUA,KIPIPIRI,34,515,554,1069
NYANDARUA,KIPIPIRI,30-34,2511,3005,5516
NYANDARUA,KIPIPIRI,35,656,701,1357
NYANDARUA,KIPIPIRI,36,484,526,1010
NYANDARUA,KIPIPIRI,37,550,532,1082
NYANDARUA,KIPIPIRI,38,390,483,873
NYANDARUA,KIPIPIRI,39,480,524,1004
NYANDARUA,KIPIPIRI,35-39,2560,2766,5326
NYANDARUA,KIPIPIRI,40,498,553,1051
NYANDARUA,KIPIPIRI,41,536,566,1102
NYANDARUA,KIPIPIRI,42,496,549,1045
NYANDARUA,KIPIPIRI,43,422,492,914
NYANDARUA,KIPIPIRI,44,395,460,855
NYANDARUA,KIPIPIRI,40-44,2347,2620,4967
NYANDARUA,KIPIPIRI,45,530,623,1153
NYANDARUA,KIPIPIRI,46,410,520,930
NYANDARUA,KIPIPIRI,47,488,505,993
NYANDARUA,KIPIPIRI,48,357,385,742
NYANDARUA,KIPIPIRI,49,422,420,842
NYANDARUA,KIPIPIRI,45-49,2207,2453,4660
NYANDARUA,KIPIPIRI,50,449,537,986
NYANDARUA,KIPIPIRI,51,371,407,778
NYANDARUA,KIPIPIRI,52,390,416,806
NYANDARUA,KIPIPIRI,53,283,311,594
NYANDARUA,KIPIPIRI,54,324,400,724
NYANDARUA,KIPIPIRI,50-54,1817,2071,3888
NYANDARUA,KIPIPIRI,55,384,400,784
NYANDARUA,KIPIPIRI,56,375,376,751
NYANDARUA,KIPIPIRI,57,292,388,680
NYANDARUA,KIPIPIRI,58,289,274,563
NYANDARUA,KIPIPIRI,59,262,321,583
NYANDARUA,KIPIPIRI,55-59,1602,1759,3361
NYANDARUA,KIPIPIRI,60,293,320,613
NYANDARUA,KIPIPIRI,61,236,268,504
NYANDARUA,KIPIPIRI,62,206,201,407
NYANDARUA,KIPIPIRI,63,175,178,353
NYANDARUA,KIPIPIRI,64,113,147,260
NYANDARUA,KIPIPIRI,60-64,1023,1114,2137
NYANDARUA,KIPIPIRI,65,219,186,405
NYANDARUA,KIPIPIRI,66,144,150,294
NYANDARUA,KIPIPIRI,67,251,262,513
NYANDARUA,KIPIPIRI,68,94,136,230
NYANDARUA,KIPIPIRI,69,151,202,353
NYANDARUA,KIPIPIRI,65-69,859,936,1795
NYANDARUA,KIPIPIRI,70,193,263,456
NYANDARUA,KIPIPIRI,71,148,184,332
NYANDARUA,KIPIPIRI,72,123,168,291
NYANDARUA,KIPIPIRI,73,120,149,269
NYANDARUA,KIPIPIRI,74,109,140,249
NYANDARUA,KIPIPIRI,70-74,693,904,1597
NYANDARUA,KIPIPIRI,75,91,167,258
NYANDARUA,KIPIPIRI,76,132,310,442
NYANDARUA,KIPIPIRI,77,95,113,208
NYANDARUA,KIPIPIRI,78,66,97,163
NYANDARUA,KIPIPIRI,79,72,122,194
NYANDARUA,KIPIPIRI,75-79,456,809,1265
NYANDARUA,KIPIPIRI,80,79,130,209
NYANDARUA,KIPIPIRI,81,56,70,126
NYANDARUA,KIPIPIRI,82,47,49,96
NYANDARUA,KIPIPIRI,83,90,67,157
NYANDARUA,KIPIPIRI,84,56,74,130
NYANDARUA,KIPIPIRI,80-84,328,390,718
NYANDARUA,KIPIPIRI,85,39,56,95
NYANDARUA,KIPIPIRI,86,30,59,89
NYANDARUA,KIPIPIRI,87,33,59,92
NYANDARUA,KIPIPIRI,88,19,34,53
NYANDARUA,KIPIPIRI,89,33,66,99
NYANDARUA,KIPIPIRI,85-89,154,274,428
NYANDARUA,KIPIPIRI,90,33,46,79
NYANDARUA,KIPIPIRI,91,36,33,69
NYANDARUA,KIPIPIRI,92,16,19,35
NYANDARUA,KIPIPIRI,93,9,19,28
NYANDARUA,KIPIPIRI,94,4,13,17
NYANDARUA,KIPIPIRI,90-94,98,130,228
NYANDARUA,KIPIPIRI,95,9,25,34
NYANDARUA,KIPIPIRI,96,8,12,20
NYANDARUA,KIPIPIRI,97,10,17,27
NYANDARUA,KIPIPIRI,98,5,9,14
NYANDARUA,KIPIPIRI,99,9,10,19
NYANDARUA,KIPIPIRI,95-99,41,73,114
NYANDARUA,KIPIPIRI,100+,16,35,51
NYANDARUA,KIPIPIRI,Not Stated,-,-,-
NYANDARUA,NYANDARUA CENTRA,Total,37329,37931,75260
NYANDARUA,NYANDARUA CENTRA,0,874,927,1801
NYANDARUA,NYANDARUA CENTRA,1,890,866,1756
NYANDARUA,NYANDARUA CENTRA,2,886,843,1729
NYANDARUA,NYANDARUA CENTRA,3,881,833,1714
NYANDARUA,NYANDARUA CENTRA,4,842,788,1630
NYANDARUA,NYANDARUA CENTRA,0 - 4,4373,4257,8630
NYANDARUA,NYANDARUA CENTRA,5,887,808,1695
NYANDARUA,NYANDARUA CENTRA,6,910,867,1777
NYANDARUA,NYANDARUA CENTRA,7,908,824,1732
NYANDARUA,NYANDARUA CENTRA,8,850,821,1671
NYANDARUA,NYANDARUA CENTRA,9,990,942,1932
NYANDARUA,NYANDARUA CENTRA,05-Sep,4545,4262,8807
NYANDARUA,NYANDARUA CENTRA,10,938,880,1818
NYANDARUA,NYANDARUA CENTRA,11,876,829,1705
NYANDARUA,NYANDARUA CENTRA,12,957,949,1906
NYANDARUA,NYANDARUA CENTRA,13,996,987,1983
NYANDARUA,NYANDARUA CENTRA,14,1055,974,2029
NYANDARUA,NYANDARUA CENTRA,Oct-14,4822,4619,9441
NYANDARUA,NYANDARUA CENTRA,15,962,895,1857
NYANDARUA,NYANDARUA CENTRA,16,965,908,1873
NYANDARUA,NYANDARUA CENTRA,17,984,866,1850
NYANDARUA,NYANDARUA CENTRA,18,791,666,1457
NYANDARUA,NYANDARUA CENTRA,19,795,712,1507
NYANDARUA,NYANDARUA CENTRA,15-19,4497,4047,8544
NYANDARUA,NYANDARUA CENTRA,20,614,631,1245
NYANDARUA,NYANDARUA CENTRA,21,561,605,1166
NYANDARUA,NYANDARUA CENTRA,22,592,588,1180
NYANDARUA,NYANDARUA CENTRA,23,612,639,1251
NYANDARUA,NYANDARUA CENTRA,24,543,650,1193
NYANDARUA,NYANDARUA CENTRA,20-24,2922,3113,6035
NYANDARUA,NYANDARUA CENTRA,25,570,574,1144
NYANDARUA,NYANDARUA CENTRA,26,445,543,988
NYANDARUA,NYANDARUA CENTRA,27,499,487,986
NYANDARUA,NYANDARUA CENTRA,28,450,480,930
NYANDARUA,NYANDARUA CENTRA,29,484,521,1005
NYANDARUA,NYANDARUA CENTRA,25-29,2448,2605,5053
NYANDARUA,NYANDARUA CENTRA,30,582,615,1197
NYANDARUA,NYANDARUA CENTRA,31,479,489,968
NYANDARUA,NYANDARUA CENTRA,32,547,615,1162
NYANDARUA,NYANDARUA CENTRA,33,446,512,958
NYANDARUA,NYANDARUA CENTRA,34,465,533,998
NYANDARUA,NYANDARUA CENTRA,30-34,2519,2764,5283
NYANDARUA,NYANDARUA CENTRA,35,646,605,1251
NYANDARUA,NYANDARUA CENTRA,36,417,507,924
NYANDARUA,NYANDARUA CENTRA,37,437,435,872
NYANDARUA,NYANDARUA CENTRA,38,411,394,805
NYANDARUA,NYANDARUA CENTRA,39,364,442,806
NYANDARUA,NYANDARUA CENTRA,35-39,2275,2383,4658
NYANDARUA,NYANDARUA CENTRA,40,502,526,1028
NYANDARUA,NYANDARUA CENTRA,41,442,430,872
NYANDARUA,NYANDARUA CENTRA,42,391,468,859
NYANDARUA,NYANDARUA CENTRA,43,337,389,726
NYANDARUA,NYANDARUA CENTRA,44,293,305,598
NYANDARUA,NYANDARUA CENTRA,40-44,1965,2118,4083
NYANDARUA,NYANDARUA CENTRA,45,457,464,921
NYANDARUA,NYANDARUA CENTRA,46,357,348,705
NYANDARUA,NYANDARUA CENTRA,47,379,374,753
NYANDARUA,NYANDARUA CENTRA,48,269,279,548
NYANDARUA,NYANDARUA CENTRA,49,327,348,675
NYANDARUA,NYANDARUA CENTRA,45-49,1789,1813,3602
NYANDARUA,NYANDARUA CENTRA,50,320,411,731
NYANDARUA,NYANDARUA CENTRA,51,292,313,605
NYANDARUA,NYANDARUA CENTRA,52,298,315,613
NYANDARUA,NYANDARUA CENTRA,53,222,251,473
NYANDARUA,NYANDARUA CENTRA,54,238,315,553
NYANDARUA,NYANDARUA CENTRA,50-54,1370,1605,2975
NYANDARUA,NYANDARUA CENTRA,55,292,255,547
NYANDARUA,NYANDARUA CENTRA,56,298,269,567
NYANDARUA,NYANDARUA CENTRA,57,245,264,509
NYANDARUA,NYANDARUA CENTRA,58,221,222,443
NYANDARUA,NYANDARUA CENTRA,59,229,237,466
NYANDARUA,NYANDARUA CENTRA,55-59,1285,1247,2532
NYANDARUA,NYANDARUA CENTRA,60,229,250,479
NYANDARUA,NYANDARUA CENTRA,61,167,177,344
NYANDARUA,NYANDARUA CENTRA,62,162,161,323
NYANDARUA,NYANDARUA CENTRA,63,141,135,276
NYANDARUA,NYANDARUA CENTRA,64,95,81,176
NYANDARUA,NYANDARUA CENTRA,60-64,794,804,1598
NYANDARUA,NYANDARUA CENTRA,65,165,148,313
NYANDARUA,NYANDARUA CENTRA,66,121,112,233
NYANDARUA,NYANDARUA CENTRA,67,162,178,340
NYANDARUA,NYANDARUA CENTRA,68,70,93,163
NYANDARUA,NYANDARUA CENTRA,69,111,138,249
NYANDARUA,NYANDARUA CENTRA,65-69,629,669,1298
NYANDARUA,NYANDARUA CENTRA,70,151,178,329
NYANDARUA,NYANDARUA CENTRA,71,82,108,190
NYANDARUA,NYANDARUA CENTRA,72,94,105,199
NYANDARUA,NYANDARUA CENTRA,73,62,80,142
NYANDARUA,NYANDARUA CENTRA,74,72,95,167
NYANDARUA,NYANDARUA CENTRA,70-74,461,566,1027
NYANDARUA,NYANDARUA CENTRA,75,51,112,163
NYANDARUA,NYANDARUA CENTRA,76,78,157,235
NYANDARUA,NYANDARUA CENTRA,77,46,74,120
NYANDARUA,NYANDARUA CENTRA,78,29,54,83
NYANDARUA,NYANDARUA CENTRA,79,39,64,103
NYANDARUA,NYANDARUA CENTRA,75-79,243,461,704
NYANDARUA,NYANDARUA CENTRA,80,66,85,151
NYANDARUA,NYANDARUA CENTRA,81,29,60,89
NYANDARUA,NYANDARUA CENTRA,82,32,37,69
NYANDARUA,NYANDARUA CENTRA,83,45,38,83
NYANDARUA,NYANDARUA CENTRA,84,37,70,107
NYANDARUA,NYANDARUA CENTRA,80-84,209,290,499
NYANDARUA,NYANDARUA CENTRA,85,29,43,72
NYANDARUA,NYANDARUA CENTRA,86,15,31,46
NYANDARUA,NYANDARUA CENTRA,87,26,23,49
NYANDARUA,NYANDARUA CENTRA,88,11,17,28
NYANDARUA,NYANDARUA CENTRA,89,21,48,69
NYANDARUA,NYANDARUA CENTRA,85-89,102,162,264
NYANDARUA,NYANDARUA CENTRA,90,16,34,50
NYANDARUA,NYANDARUA CENTRA,91,16,12,28
NYANDARUA,NYANDARUA CENTRA,92,5,8,13
NYANDARUA,NYANDARUA CENTRA,93,5,10,15
NYANDARUA,NYANDARUA CENTRA,94,5,17,22
NYANDARUA,NYANDARUA CENTRA,90-94,47,81,128
NYANDARUA,NYANDARUA CENTRA,95,7,13,20
NYANDARUA,NYANDARUA CENTRA,96,2,8,10
NYANDARUA,NYANDARUA CENTRA,97,6,7,13
NYANDARUA,NYANDARUA CENTRA,98,4,3,7
NYANDARUA,NYANDARUA CENTRA,99,5,9,14
NYANDARUA,NYANDARUA CENTRA,95-99,24,40,64
NYANDARUA,NYANDARUA CENTRA,100+,10,24,34
NYANDARUA,NYANDARUA CENTRA,Not Stated,-,1,1
NYANDARUA,NYANDARUA WEST,Total,48752,49209,97961
NYANDARUA,NYANDARUA WEST,0,1091,1076,2167
NYANDARUA,NYANDARUA WEST,1,988,1044,2032
NYANDARUA,NYANDARUA WEST,2,1152,1025,2177
NYANDARUA,NYANDARUA WEST,3,1034,1084,2118
NYANDARUA,NYANDARUA WEST,4,1131,1073,2204
NYANDARUA,NYANDARUA WEST,0 - 4,5396,5302,10698
NYANDARUA,NYANDARUA WEST,5,1161,1025,2186
NYANDARUA,NYANDARUA WEST,6,1110,1104,2214
NYANDARUA,NYANDARUA WEST,7,1118,1128,2246
NYANDARUA,NYANDARUA WEST,8,1131,1046,2177
NYANDARUA,NYANDARUA WEST,9,1205,1206,2411
NYANDARUA,NYANDARUA WEST,05-Sep,5725,5509,11234
NYANDARUA,NYANDARUA WEST,10,1226,1099,2325
NYANDARUA,NYANDARUA WEST,11,1100,1071,2171
NYANDARUA,NYANDARUA WEST,12,1247,1128,2375
NYANDARUA,NYANDARUA WEST,13,1270,1154,2424
NYANDARUA,NYANDARUA WEST,14,1326,1111,2437
NYANDARUA,NYANDARUA WEST,Oct-14,6169,5563,11732
NYANDARUA,NYANDARUA WEST,15,1246,1107,2353
NYANDARUA,NYANDARUA WEST,16,1167,1087,2254
NYANDARUA,NYANDARUA WEST,17,1278,1169,2447
NYANDARUA,NYANDARUA WEST,18,952,891,1843
NYANDARUA,NYANDARUA WEST,19,1009,898,1907
NYANDARUA,NYANDARUA WEST,15-19,5652,5152,10804
NYANDARUA,NYANDARUA WEST,20,844,857,1701
NYANDARUA,NYANDARUA WEST,21,828,771,1599
NYANDARUA,NYANDARUA WEST,22,844,776,1620
NYANDARUA,NYANDARUA WEST,23,778,834,1612
NYANDARUA,NYANDARUA WEST,24,698,693,1391
NYANDARUA,NYANDARUA WEST,20-24,3992,3931,7923
NYANDARUA,NYANDARUA WEST,25,785,777,1562
NYANDARUA,NYANDARUA WEST,26,599,696,1295
NYANDARUA,NYANDARUA WEST,27,637,699,1336
NYANDARUA,NYANDARUA WEST,28,593,663,1256
NYANDARUA,NYANDARUA WEST,29,655,625,1280
NYANDARUA,NYANDARUA WEST,25-29,3269,3460,6729
NYANDARUA,NYANDARUA WEST,30,789,860,1649
NYANDARUA,NYANDARUA WEST,31,596,539,1135
NYANDARUA,NYANDARUA WEST,32,660,782,1442
NYANDARUA,NYANDARUA WEST,33,593,670,1263
NYANDARUA,NYANDARUA WEST,34,564,625,1189
NYANDARUA,NYANDARUA WEST,30-34,3202,3476,6678
NYANDARUA,NYANDARUA WEST,35,846,911,1757
NYANDARUA,NYANDARUA WEST,36,582,598,1180
NYANDARUA,NYANDARUA WEST,37,593,636,1229
NYANDARUA,NYANDARUA WEST,38,499,562,1061
NYANDARUA,NYANDARUA WEST,39,579,621,1200
NYANDARUA,NYANDARUA WEST,35-39,3099,3328,6427
NYANDARUA,NYANDARUA WEST,40,654,669,1323
NYANDARUA,NYANDARUA WEST,41,621,625,1246
NYANDARUA,NYANDARUA WEST,42,535,561,1096
NYANDARUA,NYANDARUA WEST,43,479,516,995
NYANDARUA,NYANDARUA WEST,44,425,425,850
NYANDARUA,NYANDARUA WEST,40-44,2714,2796,5510
NYANDARUA,NYANDARUA WEST,45,599,649,1248
NYANDARUA,NYANDARUA WEST,46,466,517,983
NYANDARUA,NYANDARUA WEST,47,489,539,1028
NYANDARUA,NYANDARUA WEST,48,376,456,832
NYANDARUA,NYANDARUA WEST,49,447,483,930
NYANDARUA,NYANDARUA WEST,45-49,2377,2644,5021
NYANDARUA,NYANDARUA WEST,50,518,524,1042
NYANDARUA,NYANDARUA WEST,51,392,382,774
NYANDARUA,NYANDARUA WEST,52,425,461,886
NYANDARUA,NYANDARUA WEST,53,299,375,674
NYANDARUA,NYANDARUA WEST,54,362,379,741
NYANDARUA,NYANDARUA WEST,50-54,1996,2121,4117
NYANDARUA,NYANDARUA WEST,55,404,437,841
NYANDARUA,NYANDARUA WEST,56,414,431,845
NYANDARUA,NYANDARUA WEST,57,276,358,634
NYANDARUA,NYANDARUA WEST,58,331,358,689
NYANDARUA,NYANDARUA WEST,59,305,313,618
NYANDARUA,NYANDARUA WEST,55-59,1730,1897,3627
NYANDARUA,NYANDARUA WEST,60,342,374,716
NYANDARUA,NYANDARUA WEST,61,258,246,504
NYANDARUA,NYANDARUA WEST,62,227,210,437
NYANDARUA,NYANDARUA WEST,63,190,184,374
NYANDARUA,NYANDARUA WEST,64,120,148,268
NYANDARUA,NYANDARUA WEST,60-64,1137,1162,2299
NYANDARUA,NYANDARUA WEST,65,221,215,436
NYANDARUA,NYANDARUA WEST,66,128,135,263
NYANDARUA,NYANDARUA WEST,67,244,254,498
NYANDARUA,NYANDARUA WEST,68,80,104,184
NYANDARUA,NYANDARUA WEST,69,163,169,332
NYANDARUA,NYANDARUA WEST,65-69,836,877,1713
NYANDARUA,NYANDARUA WEST,70,183,267,450
NYANDARUA,NYANDARUA WEST,71,124,157,281
NYANDARUA,NYANDARUA WEST,72,135,108,243
NYANDARUA,NYANDARUA WEST,73,91,112,203
NYANDARUA,NYANDARUA WEST,74,107,105,212
NYANDARUA,NYANDARUA WEST,70-74,640,749,1389
NYANDARUA,NYANDARUA WEST,75,91,116,207
NYANDARUA,NYANDARUA WEST,76,128,205,333
NYANDARUA,NYANDARUA WEST,77,65,84,149
NYANDARUA,NYANDARUA WEST,78,44,58,102
NYANDARUA,NYANDARUA WEST,79,51,84,135
NYANDARUA,NYANDARUA WEST,75-79,379,547,926
NYANDARUA,NYANDARUA WEST,80,73,114,187
NYANDARUA,NYANDARUA WEST,81,38,51,89
NYANDARUA,NYANDARUA WEST,82,35,51,86
NYANDARUA,NYANDARUA WEST,83,38,41,79
NYANDARUA,NYANDARUA WEST,84,52,56,108
NYANDARUA,NYANDARUA WEST,80-84,236,313,549
NYANDARUA,NYANDARUA WEST,85,38,57,95
NYANDARUA,NYANDARUA WEST,86,18,45,63
NYANDARUA,NYANDARUA WEST,87,23,26,49
NYANDARUA,NYANDARUA WEST,88,14,18,32
NYANDARUA,NYANDARUA WEST,89,31,48,79
NYANDARUA,NYANDARUA WEST,85-89,124,194,318
NYANDARUA,NYANDARUA WEST,90,13,33,46
NYANDARUA,NYANDARUA WEST,91,21,31,52
NYANDARUA,NYANDARUA WEST,92,7,16,23
NYANDARUA,NYANDARUA WEST,93,9,12,21
NYANDARUA,NYANDARUA WEST,94,2,12,14
NYANDARUA,NYANDARUA WEST,90-94,52,104,156
NYANDARUA,NYANDARUA WEST,95,8,12,20
NYANDARUA,NYANDARUA WEST,96,1,8,9
NYANDARUA,NYANDARUA WEST,97,2,10,12
NYANDARUA,NYANDARUA WEST,98,3,7,10
NYANDARUA,NYANDARUA WEST,99,3,14,17
NYANDARUA,NYANDARUA WEST,95-99,17,51,68
NYANDARUA,NYANDARUA WEST,100+,10,33,43
NYANDARUA,NYANDARUA WEST,Not Stated,-,-,-
NYANDARUA,NYANDARUA NORTH,Total,48486,50210,98696
NYANDARUA,NYANDARUA NORTH,0,996,998,1994
NYANDARUA,NYANDARUA NORTH,1,1084,977,2061
NYANDARUA,NYANDARUA NORTH,2,1102,1022,2124
NYANDARUA,NYANDARUA NORTH,3,1052,1082,2134
NYANDARUA,NYANDARUA NORTH,4,1152,1052,2204
NYANDARUA,NYANDARUA NORTH,0 - 4,5386,5131,10517
NYANDARUA,NYANDARUA NORTH,5,1126,1082,2208
NYANDARUA,NYANDARUA NORTH,6,1056,1127,2183
NYANDARUA,NYANDARUA NORTH,7,1229,1115,2344
NYANDARUA,NYANDARUA NORTH,8,1097,1131,2228
NYANDARUA,NYANDARUA NORTH,9,1252,1241,2493
NYANDARUA,NYANDARUA NORTH,05-Sep,5760,5696,11456
NYANDARUA,NYANDARUA NORTH,10,1295,1203,2498
NYANDARUA,NYANDARUA NORTH,11,1145,1177,2322
NYANDARUA,NYANDARUA NORTH,12,1321,1252,2573
NYANDARUA,NYANDARUA NORTH,13,1300,1234,2534
NYANDARUA,NYANDARUA NORTH,14,1431,1302,2733
NYANDARUA,NYANDARUA NORTH,Oct-14,6492,6168,12660
NYANDARUA,NYANDARUA NORTH,15,1314,1232,2546
NYANDARUA,NYANDARUA NORTH,16,1303,1184,2487
NYANDARUA,NYANDARUA NORTH,17,1321,1178,2499
NYANDARUA,NYANDARUA NORTH,18,1002,901,1903
NYANDARUA,NYANDARUA NORTH,19,971,891,1862
NYANDARUA,NYANDARUA NORTH,15-19,5911,5386,11297
NYANDARUA,NYANDARUA NORTH,20,804,696,1500
NYANDARUA,NYANDARUA NORTH,21,717,664,1381
NYANDARUA,NYANDARUA NORTH,22,640,617,1257
NYANDARUA,NYANDARUA NORTH,23,557,601,1158
NYANDARUA,NYANDARUA NORTH,24,534,558,1092
NYANDARUA,NYANDARUA NORTH,20-24,3252,3136,6388
NYANDARUA,NYANDARUA NORTH,25,572,596,1168
NYANDARUA,NYANDARUA NORTH,26,450,516,966
NYANDARUA,NYANDARUA NORTH,27,439,574,1013
NYANDARUA,NYANDARUA NORTH,28,437,519,956
NYANDARUA,NYANDARUA NORTH,29,492,592,1084
NYANDARUA,NYANDARUA NORTH,25-29,2390,2797,5187
NYANDARUA,NYANDARUA NORTH,30,629,746,1375
NYANDARUA,NYANDARUA NORTH,31,491,547,1038
NYANDARUA,NYANDARUA NORTH,32,618,709,1327
NYANDARUA,NYANDARUA NORTH,33,535,656,1191
NYANDARUA,NYANDARUA NORTH,34,555,637,1192
NYANDARUA,NYANDARUA NORTH,30-34,2828,3295,6123
NYANDARUA,NYANDARUA NORTH,35,769,809,1578
NYANDARUA,NYANDARUA NORTH,36,547,633,1180
NYANDARUA,NYANDARUA NORTH,37,571,579,1150
NYANDARUA,NYANDARUA NORTH,38,454,542,996
NYANDARUA,NYANDARUA NORTH,39,598,606,1204
NYANDARUA,NYANDARUA NORTH,35-39,2939,3169,6108
NYANDARUA,NYANDARUA NORTH,40,688,743,1431
NYANDARUA,NYANDARUA NORTH,41,580,621,1201
NYANDARUA,NYANDARUA NORTH,42,517,621,1138
NYANDARUA,NYANDARUA NORTH,43,461,562,1023
NYANDARUA,NYANDARUA NORTH,44,407,435,842
NYANDARUA,NYANDARUA NORTH,40-44,2653,2982,5635
NYANDARUA,NYANDARUA NORTH,45,619,622,1241
NYANDARUA,NYANDARUA NORTH,46,466,477,943
NYANDARUA,NYANDARUA NORTH,47,538,557,1095
NYANDARUA,NYANDARUA NORTH,48,398,435,833
NYANDARUA,NYANDARUA NORTH,49,466,509,975
NYANDARUA,NYANDARUA NORTH,45-49,2487,2600,5087
NYANDARUA,NYANDARUA NORTH,50,540,567,1107
NYANDARUA,NYANDARUA NORTH,51,436,478,914
NYANDARUA,NYANDARUA NORTH,52,462,485,947
NYANDARUA,NYANDARUA NORTH,53,357,401,758
NYANDARUA,NYANDARUA NORTH,54,405,463,868
NYANDARUA,NYANDARUA NORTH,50-54,2200,2394,4594
NYANDARUA,NYANDARUA NORTH,55,427,496,923
NYANDARUA,NYANDARUA NORTH,56,422,477,899
NYANDARUA,NYANDARUA NORTH,57,356,460,816
NYANDARUA,NYANDARUA NORTH,58,325,320,645
NYANDARUA,NYANDARUA NORTH,59,322,383,705
NYANDARUA,NYANDARUA NORTH,55-59,1852,2136,3988
NYANDARUA,NYANDARUA NORTH,60,378,391,769
NYANDARUA,NYANDARUA NORTH,61,257,321,578
NYANDARUA,NYANDARUA NORTH,62,274,275,549
NYANDARUA,NYANDARUA NORTH,63,195,212,407
NYANDARUA,NYANDARUA NORTH,64,139,186,325
NYANDARUA,NYANDARUA NORTH,60-64,1243,1385,2628
NYANDARUA,NYANDARUA NORTH,65,236,269,505
NYANDARUA,NYANDARUA NORTH,66,172,186,358
NYANDARUA,NYANDARUA NORTH,67,303,338,641
NYANDARUA,NYANDARUA NORTH,68,118,140,258
NYANDARUA,NYANDARUA NORTH,69,203,217,420
NYANDARUA,NYANDARUA NORTH,65-69,1032,1150,2182
NYANDARUA,NYANDARUA NORTH,70,272,320,592
NYANDARUA,NYANDARUA NORTH,71,193,220,413
NYANDARUA,NYANDARUA NORTH,72,178,190,368
NYANDARUA,NYANDARUA NORTH,73,135,144,279
NYANDARUA,NYANDARUA NORTH,74,142,179,321
NYANDARUA,NYANDARUA NORTH,70-74,920,1053,1973
NYANDARUA,NYANDARUA NORTH,75,139,176,315
NYANDARUA,NYANDARUA NORTH,76,155,299,454
NYANDARUA,NYANDARUA NORTH,77,97,136,233
NYANDARUA,NYANDARUA NORTH,78,62,91,153
NYANDARUA,NYANDARUA NORTH,79,83,99,182
NYANDARUA,NYANDARUA NORTH,75-79,536,801,1337
NYANDARUA,NYANDARUA NORTH,80,103,169,272
NYANDARUA,NYANDARUA NORTH,81,57,88,145
NYANDARUA,NYANDARUA NORTH,82,54,51,105
NYANDARUA,NYANDARUA NORTH,83,67,60,127
NYANDARUA,NYANDARUA NORTH,84,49,68,117
NYANDARUA,NYANDARUA NORTH,80-84,330,436,766
NYANDARUA,NYANDARUA NORTH,85,43,66,109
NYANDARUA,NYANDARUA NORTH,86,34,49,83
NYANDARUA,NYANDARUA NORTH,87,27,57,84
NYANDARUA,NYANDARUA NORTH,88,14,25,39
NYANDARUA,NYANDARUA NORTH,89,30,68,98
NYANDARUA,NYANDARUA NORTH,85-89,148,265,413
NYANDARUA,NYANDARUA NORTH,90,24,35,59
NYANDARUA,NYANDARUA NORTH,91,26,45,71
NYANDARUA,NYANDARUA NORTH,92,11,17,28
NYANDARUA,NYANDARUA NORTH,93,8,9,17
NYANDARUA,NYANDARUA NORTH,94,4,14,18
NYANDARUA,NYANDARUA NORTH,90-94,73,120,193
NYANDARUA,NYANDARUA NORTH,95,11,23,34
NYANDARUA,NYANDARUA NORTH,96,6,10,16
NYANDARUA,NYANDARUA NORTH,97,9,20,29
NYANDARUA,NYANDARUA NORTH,98,3,6,9
NYANDARUA,NYANDARUA NORTH,99,11,16,27
NYANDARUA,NYANDARUA NORTH,95-99,40,75,115
NYANDARUA,NYANDARUA NORTH,100+,14,35,49
NYANDARUA,NYANDARUA NORTH,Not Stated,-,-,-
NYANDARUA,ABERDARE NATIONA,Total,11,4,15
NYANDARUA,ABERDARE NATIONA,0,-,-,-
NYANDARUA,ABERDARE NATIONA,1,-,-,-
NYANDARUA,ABERDARE NATIONA,2,1,-,1
NYANDARUA,ABERDARE NATIONA,3,-,-,-
NYANDARUA,ABERDARE NATIONA,4,-,-,-
NYANDARUA,ABERDARE NATIONA,0 - 4,1,-,1
NYANDARUA,ABERDARE NATIONA,5,-,-,-
NYANDARUA,ABERDARE NATIONA,6,-,-,-
NYANDARUA,ABERDARE NATIONA,7,-,-,-
NYANDARUA,ABERDARE NATIONA,8,-,-,-
NYANDARUA,ABERDARE NATIONA,9,-,-,-
NYANDARUA,ABERDARE NATIONA,05-Sep,-,-,-
NYANDARUA,ABERDARE NATIONA,10,-,-,-
NYANDARUA,ABERDARE NATIONA,11,-,-,-
NYANDARUA,ABERDARE NATIONA,12,-,-,-
NYANDARUA,ABERDARE NATIONA,13,-,-,-
NYANDARUA,ABERDARE NATIONA,14,-,-,-
NYANDARUA,ABERDARE NATIONA,Oct-14,-,-,-
NYANDARUA,ABERDARE NATIONA,15,-,-,-
NYANDARUA,ABERDARE NATIONA,16,-,-,-
NYANDARUA,ABERDARE NATIONA,17,-,-,-
NYANDARUA,ABERDARE NATIONA,18,-,-,-
NYANDARUA,ABERDARE NATIONA,19,-,-,-
NYANDARUA,ABERDARE NATIONA,15-19,-,-,-
NYANDARUA,ABERDARE NATIONA,20,-,-,-
NYANDARUA,ABERDARE NATIONA,21,-,-,-
NYANDARUA,ABERDARE NATIONA,22,-,2,2
NYANDARUA,ABERDARE NATIONA,23,-,-,-
NYANDARUA,ABERDARE NATIONA,24,-,-,-
NYANDARUA,ABERDARE NATIONA,20-24,-,2,2
NYANDARUA,ABERDARE NATIONA,25,-,-,-
NYANDARUA,ABERDARE NATIONA,26,3,-,3
NYANDARUA,ABERDARE NATIONA,27,-,-,-
NYANDARUA,ABERDARE NATIONA,28,-,-,-
NYANDARUA,ABERDARE NATIONA,29,1,-,1
NYANDARUA,ABERDARE NATIONA,25-29,4,-,4
NYANDARUA,ABERDARE NATIONA,30,3,-,3
NYANDARUA,ABERDARE NATIONA,31,-,-,-
NYANDARUA,ABERDARE NATIONA,32,-,1,1
NYANDARUA,ABERDARE NATIONA,33,-,-,-
NYANDARUA,ABERDARE NATIONA,34,-,-,-
NYANDARUA,ABERDARE NATIONA,30-34,3,1,4
NYANDARUA,ABERDARE NATIONA,35,1,-,1
NYANDARUA,ABERDARE NATIONA,36,-,-,-
NYANDARUA,ABERDARE NATIONA,37,-,-,-
NYANDARUA,ABERDARE NATIONA,38,-,-,-
NYANDARUA,ABERDARE NATIONA,39,-,-,-
NYANDARUA,ABERDARE NATIONA,35-39,1,-,1
NYANDARUA,ABERDARE NATIONA,40,-,-,-
NYANDARUA,ABERDARE NATIONA,41,-,-,-
NYANDARUA,ABERDARE NATIONA,42,-,-,-
NYANDARUA,ABERDARE NATIONA,43,-,-,-
NYANDARUA,ABERDARE NATIONA,44,-,-,-
NYANDARUA,ABERDARE NATIONA,40-44,-,-,-
NYANDARUA,ABERDARE NATIONA,45,-,-,-
NYANDARUA,ABERDARE NATIONA,46,1,-,1
NYANDARUA,ABERDARE NATIONA,47,-,1,1
NYANDARUA,ABERDARE NATIONA,48,-,-,-
NYANDARUA,ABERDARE NATIONA,49,-,-,-
NYANDARUA,ABERDARE NATIONA,45-49,1,1,2
NYANDARUA,ABERDARE NATIONA,50,1,-,1
NYANDARUA,ABERDARE NATIONA,51,-,-,-
NYANDARUA,ABERDARE NATIONA,52,-,-,-
NYANDARUA,ABERDARE NATIONA,53,-,-,-
NYANDARUA,ABERDARE NATIONA,54,-,-,-
NYANDARUA,ABERDARE NATIONA,50-54,1,-,1
NYANDARUA,ABERDARE NATIONA,55,-,-,-
NYANDARUA,ABERDARE NATIONA,56,-,-,-
NYANDARUA,ABERDARE NATIONA,57,-,-,-
NYANDARUA,ABERDARE NATIONA,58,-,-,-
NYANDARUA,ABERDARE NATIONA,59,-,-,-
NYANDARUA,ABERDARE NATIONA,55-59,-,-,-
NYANDARUA,ABERDARE NATIONA,60,-,-,-
NYANDARUA,ABERDARE NATIONA,61,-,-,-
NYANDARUA,ABERDARE NATIONA,62,-,-,-
NYANDARUA,ABERDARE NATIONA,63,-,-,-
NYANDARUA,ABERDARE NATIONA,64,-,-,-
NYANDARUA,ABERDARE NATIONA,60-64,-,-,-
NYANDARUA,ABERDARE NATIONA,65,-,-,-
NYANDARUA,ABERDARE NATIONA,66,-,-,-
NYANDARUA,ABERDARE NATIONA,67,-,-,-
NYANDARUA,ABERDARE NATIONA,68,-,-,-
NYANDARUA,ABERDARE NATIONA,69,-,-,-
NYANDARUA,ABERDARE NATIONA,65-69,-,-,-
NYANDARUA,ABERDARE NATIONA,70,-,-,-
NYANDARUA,ABERDARE NATIONA,71,-,-,-
NYANDARUA,ABERDARE NATIONA,72,-,-,-
NYANDARUA,ABERDARE NATIONA,73,-,-,-
NYANDARUA,ABERDARE NATIONA,74,-,-,-
NYANDARUA,ABERDARE NATIONA,70-74,-,-,-
NYANDARUA,ABERDARE NATIONA,75,-,-,-
NYANDARUA,ABERDARE NATIONA,76,-,-,-
NYANDARUA,ABERDARE NATIONA,77,-,-,-
NYANDARUA,ABERDARE NATIONA,78,-,-,-
NYANDARUA,ABERDARE NATIONA,79,-,-,-
NYANDARUA,ABERDARE NATIONA,75-79,-,-,-
NYANDARUA,ABERDARE NATIONA,80,-,-,-
NYANDARUA,ABERDARE NATIONA,81,-,-,-
NYANDARUA,ABERDARE NATIONA,82,-,-,-
NYANDARUA,ABERDARE NATIONA,83,-,-,-
NYANDARUA,ABERDARE NATIONA,84,-,-,-
NYANDARUA,ABERDARE NATIONA,80-84,-,-,-
NYANDARUA,ABERDARE NATIONA,85,-,-,-
NYANDARUA,ABERDARE NATIONA,86,-,-,-
NYANDARUA,ABERDARE NATIONA,87,-,-,-
NYANDARUA,ABERDARE NATIONA,88,-,-,-
NYANDARUA,ABERDARE NATIONA,89,-,-,-
NYANDARUA,ABERDARE NATIONA,85-89,-,-,-
NYANDARUA,ABERDARE NATIONA,90,-,-,-
NYANDARUA,ABERDARE NATIONA,91,-,-,-
NYANDARUA,ABERDARE NATIONA,92,-,-,-
NYANDARUA,ABERDARE NATIONA,93,-,-,-
NYANDARUA,ABERDARE NATIONA,94,-,-,-
NYANDARUA,ABERDARE NATIONA,90-94,-,-,-
NYANDARUA,ABERDARE NATIONA,95,-,-,-
NYANDARUA,ABERDARE NATIONA,96,-,-,-
NYANDARUA,ABERDARE NATIONA,97,-,-,-
NYANDARUA,ABERDARE NATIONA,98,-,-,-
NYANDARUA,ABERDARE NATIONA,99,-,-,-
NYANDARUA,ABERDARE NATIONA,95-99,-,-,-
NYANDARUA,ABERDARE NATIONA,100+,-,-,-
NYANDARUA,ABERDARE NATIONA,Not Stated,-,-,-
NYERI,ALL,Total,374288,384845,759133
NYERI,ALL,0,7398,7367,14765
NYERI,ALL,1,7302,7214,14516
NYERI,ALL,2,7302,7102,14404
NYERI,ALL,3,7556,7240,14796
NYERI,ALL,4,7458,7159,14617
NYERI,ALL,0 - 4,37016,36082,73098
NYERI,ALL,5,7342,7200,14542
NYERI,ALL,6,7415,7348,14763
NYERI,ALL,7,7633,7508,15141
NYERI,ALL,8,7454,7445,14899
NYERI,ALL,9,7922,7812,15734
NYERI,ALL,05-Sep,37766,37313,75079
NYERI,ALL,10,7751,7636,15387
NYERI,ALL,11,7187,7171,14358
NYERI,ALL,12,8042,7593,15635
NYERI,ALL,13,8197,7788,15985
NYERI,ALL,14,7866,7291,15157
NYERI,ALL,Oct-14,39043,37479,76522
NYERI,ALL,15,7792,7559,15351
NYERI,ALL,16,7711,7393,15104
NYERI,ALL,17,8298,7577,15875
NYERI,ALL,18,7010,6449,13459
NYERI,ALL,19,7158,6580,13738
NYERI,ALL,15-19,37969,35558,73527
NYERI,ALL,20,6391,6182,12573
NYERI,ALL,21,6084,5901,11985
NYERI,ALL,22,5880,5898,11778
NYERI,ALL,23,6053,5996,12049
NYERI,ALL,24,5370,5414,10784
NYERI,ALL,20-24,29778,29391,59169
NYERI,ALL,25,5457,5374,10831
NYERI,ALL,26,4591,4981,9572
NYERI,ALL,27,4760,4930,9690
NYERI,ALL,28,4303,4795,9098
NYERI,ALL,29,4907,5199,10106
NYERI,ALL,25-29,24018,25279,49297
NYERI,ALL,30,5956,6375,12331
NYERI,ALL,31,4656,4789,9445
NYERI,ALL,32,5828,6250,12078
NYERI,ALL,33,5017,5505,10522
NYERI,ALL,34,4923,5286,10209
NYERI,ALL,30-34,26380,28205,54585
NYERI,ALL,35,6503,6649,13152
NYERI,ALL,36,4927,5218,10145
NYERI,ALL,37,5102,5157,10259
NYERI,ALL,38,4554,4867,9421
NYERI,ALL,39,4819,5338,10157
NYERI,ALL,35-39,25905,27229,53134
NYERI,ALL,40,5906,5821,11727
NYERI,ALL,41,4850,4806,9656
NYERI,ALL,42,4952,4766,9718
NYERI,ALL,43,4235,4727,8962
NYERI,ALL,44,3893,4082,7975
NYERI,ALL,40-44,23836,24202,48038
NYERI,ALL,45,5336,5295,10631
NYERI,ALL,46,4230,4275,8505
NYERI,ALL,47,4484,4481,8965
NYERI,ALL,48,3737,3601,7338
NYERI,ALL,49,3987,4142,8129
NYERI,ALL,45-49,21774,21794,43568
NYERI,ALL,50,4610,4881,9491
NYERI,ALL,51,3535,3725,7260
NYERI,ALL,52,3956,4325,8281
NYERI,ALL,53,2926,3422,6348
NYERI,ALL,54,3617,3671,7288
NYERI,ALL,50-54,18644,20024,38668
NYERI,ALL,55,3585,3724,7309
NYERI,ALL,56,3580,3557,7137
NYERI,ALL,57,3122,3477,6599
NYERI,ALL,58,2752,2819,5571
NYERI,ALL,59,2877,2985,5862
NYERI,ALL,55-59,15916,16562,32478
NYERI,ALL,60,3110,3470,6580
NYERI,ALL,61,2348,2544,4892
NYERI,ALL,62,2063,2093,4156
NYERI,ALL,63,1613,1792,3405
NYERI,ALL,64,1177,1308,2485
NYERI,ALL,60-64,10311,11207,21518
NYERI,ALL,65,1922,2213,4135
NYERI,ALL,66,1366,1487,2853
NYERI,ALL,67,2478,2677,5155
NYERI,ALL,68,1194,1253,2447
NYERI,ALL,69,1701,1877,3578
NYERI,ALL,65-69,8661,9507,18168
NYERI,ALL,70,2305,3015,5320
NYERI,ALL,71,1643,1871,3514
NYERI,ALL,72,1618,1542,3160
NYERI,ALL,73,1302,1332,2634
NYERI,ALL,74,1118,1448,2566
NYERI,ALL,70-74,7986,9208,17194
NYERI,ALL,75,968,1349,2317
NYERI,ALL,76,1064,2024,3088
NYERI,ALL,77,796,1229,2025
NYERI,ALL,78,566,742,1308
NYERI,ALL,79,597,1103,1700
NYERI,ALL,75-79,3991,6447,10438
NYERI,ALL,80,908,1526,2434
NYERI,ALL,81,506,750,1256
NYERI,ALL,82,490,567,1057
NYERI,ALL,83,536,740,1276
NYERI,ALL,84,415,671,1086
NYERI,ALL,80-84,2855,4254,7109
NYERI,ALL,85,362,609,971
NYERI,ALL,86,319,543,862
NYERI,ALL,87,297,456,753
NYERI,ALL,88,155,266,421
NYERI,ALL,89,253,622,875
NYERI,ALL,85-89,1386,2496,3882
NYERI,ALL,90,182,506,688
NYERI,ALL,91,208,410,618
NYERI,ALL,92,92,179,271
NYERI,ALL,93,87,175,262
NYERI,ALL,94,72,182,254
NYERI,ALL,90-94,641,1452,2093
NYERI,ALL,95,103,237,340
NYERI,ALL,96,53,127,180
NYERI,ALL,97,68,110,178
NYERI,ALL,98,51,102,153
NYERI,ALL,99,42,174,216
NYERI,ALL,95-99,317,750,1067
NYERI,ALL,100+,90,401,491
NYERI,ALL,Not Stated,5,5,10
NYERI,TETU,Total,39293,41155,80448
NYERI,TETU,0,675,721,1396
NYERI,TETU,1,701,774,1475
NYERI,TETU,2,754,728,1482
NYERI,TETU,3,793,780,1573
NYERI,TETU,4,756,719,1475
NYERI,TETU,0 - 4,3679,3722,7401
NYERI,TETU,5,783,775,1558
NYERI,TETU,6,835,770,1605
NYERI,TETU,7,815,781,1596
NYERI,TETU,8,824,768,1592
NYERI,TETU,9,872,838,1710
NYERI,TETU,05-Sep,4129,3932,8061
NYERI,TETU,10,880,808,1688
NYERI,TETU,11,728,781,1509
NYERI,TETU,12,839,792,1631
NYERI,TETU,13,851,819,1670
NYERI,TETU,14,860,785,1645
NYERI,TETU,Oct-14,4158,3985,8143
NYERI,TETU,15,820,775,1595
NYERI,TETU,16,849,832,1681
NYERI,TETU,17,888,839,1727
NYERI,TETU,18,735,629,1364
NYERI,TETU,19,747,656,1403
NYERI,TETU,15-19,4039,3731,7770
NYERI,TETU,20,637,531,1168
NYERI,TETU,21,561,521,1082
NYERI,TETU,22,518,525,1043
NYERI,TETU,23,537,478,1015
NYERI,TETU,24,433,420,853
NYERI,TETU,20-24,2686,2475,5161
NYERI,TETU,25,489,469,958
NYERI,TETU,26,383,440,823
NYERI,TETU,27,381,434,815
NYERI,TETU,28,397,434,831
NYERI,TETU,29,425,461,886
NYERI,TETU,25-29,2075,2238,4313
NYERI,TETU,30,539,572,1111
NYERI,TETU,31,442,457,899
NYERI,TETU,32,532,581,1113
NYERI,TETU,33,476,522,998
NYERI,TETU,34,484,496,980
NYERI,TETU,30-34,2473,2628,5101
NYERI,TETU,35,621,633,1254
NYERI,TETU,36,493,541,1034
NYERI,TETU,37,470,535,1005
NYERI,TETU,38,415,528,943
NYERI,TETU,39,505,540,1045
NYERI,TETU,35-39,2504,2777,5281
NYERI,TETU,40,577,595,1172
NYERI,TETU,41,461,490,951
NYERI,TETU,42,488,496,984
NYERI,TETU,43,420,496,916
NYERI,TETU,44,402,480,882
NYERI,TETU,40-44,2348,2557,4905
NYERI,TETU,45,541,511,1052
NYERI,TETU,46,465,509,974
NYERI,TETU,47,479,525,1004
NYERI,TETU,48,403,405,808
NYERI,TETU,49,429,463,892
NYERI,TETU,45-49,2317,2413,4730
NYERI,TETU,50,441,548,989
NYERI,TETU,51,358,452,810
NYERI,TETU,52,439,489,928
NYERI,TETU,53,277,400,677
NYERI,TETU,54,416,421,837
NYERI,TETU,50-54,1931,2310,4241
NYERI,TETU,55,379,464,843
NYERI,TETU,56,391,421,812
NYERI,TETU,57,372,456,828
NYERI,TETU,58,345,359,704
NYERI,TETU,59,328,357,685
NYERI,TETU,55-59,1815,2057,3872
NYERI,TETU,60,378,437,815
NYERI,TETU,61,303,342,645
NYERI,TETU,62,278,277,555
NYERI,TETU,63,226,262,488
NYERI,TETU,64,163,174,337
NYERI,TETU,60-64,1348,1492,2840
NYERI,TETU,65,269,305,574
NYERI,TETU,66,167,204,371
NYERI,TETU,67,340,369,709
NYERI,TETU,68,168,153,321
NYERI,TETU,69,250,258,508
NYERI,TETU,65-69,1194,1289,2483
NYERI,TETU,70,353,421,774
NYERI,TETU,71,274,233,507
NYERI,TETU,72,245,208,453
NYERI,TETU,73,176,195,371
NYERI,TETU,74,192,188,380
NYERI,TETU,70-74,1240,1245,2485
NYERI,TETU,75,133,167,300
NYERI,TETU,76,173,365,538
NYERI,TETU,77,95,165,260
NYERI,TETU,78,84,112,196
NYERI,TETU,79,91,148,239
NYERI,TETU,75-79,576,957,1533
NYERI,TETU,80,142,180,322
NYERI,TETU,81,82,115,197
NYERI,TETU,82,42,88,130
NYERI,TETU,83,83,115,198
NYERI,TETU,84,47,87,134
NYERI,TETU,80-84,396,585,981
NYERI,TETU,85,59,89,148
NYERI,TETU,86,52,107,159
NYERI,TETU,87,42,77,119
NYERI,TETU,88,23,31,54
NYERI,TETU,89,35,106,141
NYERI,TETU,85-89,211,410,621
NYERI,TETU,90,30,64,94
NYERI,TETU,91,29,51,80
NYERI,TETU,92,13,27,40
NYERI,TETU,93,14,30,44
NYERI,TETU,94,18,19,37
NYERI,TETU,90-94,104,191,295
NYERI,TETU,95,19,42,61
NYERI,TETU,96,6,19,25
NYERI,TETU,97,11,7,18
NYERI,TETU,98,10,20,30
NYERI,TETU,99,9,18,27
NYERI,TETU,95-99,55,106,161
NYERI,TETU,100+,14,55,69
NYERI,TETU,Not Stated,1,-,1
NYERI,KIENI EAST,Total,55360,55012,110372
NYERI,KIENI EAST,0,1210,1141,2351
NYERI,KIENI EAST,1,1177,1134,2311
NYERI,KIENI EAST,2,1110,1118,2228
NYERI,KIENI EAST,3,1190,1151,2341
NYERI,KIENI EAST,4,1164,1130,2294
NYERI,KIENI EAST,0 - 4,5851,5674,11525
NYERI,KIENI EAST,5,1082,1077,2159
NYERI,KIENI EAST,6,1157,1198,2355
NYERI,KIENI EAST,7,1164,1123,2287
NYERI,KIENI EAST,8,1166,1206,2372
NYERI,KIENI EAST,9,1209,1212,2421
NYERI,KIENI EAST,05-Sep,5778,5816,11594
NYERI,KIENI EAST,10,1112,1169,2281
NYERI,KIENI EAST,11,1043,1079,2122
NYERI,KIENI EAST,12,1264,1147,2411
NYERI,KIENI EAST,13,1267,1184,2451
NYERI,KIENI EAST,14,1179,1058,2237
NYERI,KIENI EAST,Oct-14,5865,5637,11502
NYERI,KIENI EAST,15,1143,1160,2303
NYERI,KIENI EAST,16,1169,1138,2307
NYERI,KIENI EAST,17,1201,1104,2305
NYERI,KIENI EAST,18,1005,937,1942
NYERI,KIENI EAST,19,1009,885,1894
NYERI,KIENI EAST,15-19,5527,5224,10751
NYERI,KIENI EAST,20,887,839,1726
NYERI,KIENI EAST,21,923,837,1760
NYERI,KIENI EAST,22,877,846,1723
NYERI,KIENI EAST,23,944,854,1798
NYERI,KIENI EAST,24,809,797,1606
NYERI,KIENI EAST,20-24,4440,4173,8613
NYERI,KIENI EAST,25,832,831,1663
NYERI,KIENI EAST,26,680,782,1462
NYERI,KIENI EAST,27,744,731,1475
NYERI,KIENI EAST,28,658,689,1347
NYERI,KIENI EAST,29,766,810,1576
NYERI,KIENI EAST,25-29,3680,3843,7523
NYERI,KIENI EAST,30,905,1015,1920
NYERI,KIENI EAST,31,712,740,1452
NYERI,KIENI EAST,32,975,1015,1990
NYERI,KIENI EAST,33,758,833,1591
NYERI,KIENI EAST,34,780,810,1590
NYERI,KIENI EAST,30-34,4130,4413,8543
NYERI,KIENI EAST,35,1004,1066,2070
NYERI,KIENI EAST,36,749,805,1554
NYERI,KIENI EAST,37,804,762,1566
NYERI,KIENI EAST,38,686,704,1390
NYERI,KIENI EAST,39,735,785,1520
NYERI,KIENI EAST,35-39,3978,4122,8100
NYERI,KIENI EAST,40,925,803,1728
NYERI,KIENI EAST,41,793,763,1556
NYERI,KIENI EAST,42,756,709,1465
NYERI,KIENI EAST,43,656,703,1359
NYERI,KIENI EAST,44,575,600,1175
NYERI,KIENI EAST,40-44,3705,3578,7283
NYERI,KIENI EAST,45,831,818,1649
NYERI,KIENI EAST,46,644,649,1293
NYERI,KIENI EAST,47,695,626,1321
NYERI,KIENI EAST,48,583,498,1081
NYERI,KIENI EAST,49,608,591,1199
NYERI,KIENI EAST,45-49,3361,3182,6543
NYERI,KIENI EAST,50,707,648,1355
NYERI,KIENI EAST,51,547,518,1065
NYERI,KIENI EAST,52,566,575,1141
NYERI,KIENI EAST,53,396,456,852
NYERI,KIENI EAST,54,504,512,1016
NYERI,KIENI EAST,50-54,2720,2709,5429
NYERI,KIENI EAST,55,536,456,992
NYERI,KIENI EAST,56,514,435,949
NYERI,KIENI EAST,57,415,411,826
NYERI,KIENI EAST,58,389,353,742
NYERI,KIENI EAST,59,376,349,725
NYERI,KIENI EAST,55-59,2230,2004,4234
NYERI,KIENI EAST,60,361,372,733
NYERI,KIENI EAST,61,293,288,581
NYERI,KIENI EAST,62,277,244,521
NYERI,KIENI EAST,63,213,220,433
NYERI,KIENI EAST,64,152,154,306
NYERI,KIENI EAST,60-64,1296,1278,2574
NYERI,KIENI EAST,65,224,251,475
NYERI,KIENI EAST,66,181,171,352
NYERI,KIENI EAST,67,270,278,548
NYERI,KIENI EAST,68,131,117,248
NYERI,KIENI EAST,69,203,201,404
NYERI,KIENI EAST,65-69,1009,1018,2027
NYERI,KIENI EAST,70,221,297,518
NYERI,KIENI EAST,71,185,190,375
NYERI,KIENI EAST,72,179,141,320
NYERI,KIENI EAST,73,151,135,286
NYERI,KIENI EAST,74,116,142,258
NYERI,KIENI EAST,70-74,852,905,1757
NYERI,KIENI EAST,75,94,139,233
NYERI,KIENI EAST,76,83,178,261
NYERI,KIENI EAST,77,99,125,224
NYERI,KIENI EAST,78,50,81,131
NYERI,KIENI EAST,79,66,112,178
NYERI,KIENI EAST,75-79,392,635,1027
NYERI,KIENI EAST,80,103,150,253
NYERI,KIENI EAST,81,52,64,116
NYERI,KIENI EAST,82,59,58,117
NYERI,KIENI EAST,83,62,68,130
NYERI,KIENI EAST,84,44,52,96
NYERI,KIENI EAST,80-84,320,392,712
NYERI,KIENI EAST,85,28,36,64
NYERI,KIENI EAST,86,28,38,66
NYERI,KIENI EAST,87,31,40,71
NYERI,KIENI EAST,88,15,22,37
NYERI,KIENI EAST,89,21,59,80
NYERI,KIENI EAST,85-89,123,195,318
NYERI,KIENI EAST,90,16,45,61
NYERI,KIENI EAST,91,21,42,63
NYERI,KIENI EAST,92,6,14,20
NYERI,KIENI EAST,93,7,16,23
NYERI,KIENI EAST,94,6,14,20
NYERI,KIENI EAST,90-94,56,131,187
NYERI,KIENI EAST,95,9,18,27
NYERI,KIENI EAST,96,8,8,16
NYERI,KIENI EAST,97,9,12,21
NYERI,KIENI EAST,98,5,6,11
NYERI,KIENI EAST,99,2,8,10
NYERI,KIENI EAST,95-99,33,52,85
NYERI,KIENI EAST,100+,13,30,43
NYERI,KIENI EAST,Not Stated,1,1,2
NYERI,KIENI WEST,Total,43843,44677,88520
NYERI,KIENI WEST,0,867,903,1770
NYERI,KIENI WEST,1,818,870,1688
NYERI,KIENI WEST,2,892,842,1734
NYERI,KIENI WEST,3,859,877,1736
NYERI,KIENI WEST,4,964,876,1840
NYERI,KIENI WEST,0 - 4,4400,4368,8768
NYERI,KIENI WEST,5,940,891,1831
NYERI,KIENI WEST,6,968,927,1895
NYERI,KIENI WEST,7,953,966,1919
NYERI,KIENI WEST,8,934,957,1891
NYERI,KIENI WEST,9,1026,1005,2031
NYERI,KIENI WEST,05-Sep,4821,4746,9567
NYERI,KIENI WEST,10,1070,1004,2074
NYERI,KIENI WEST,11,974,964,1938
NYERI,KIENI WEST,12,1053,1007,2060
NYERI,KIENI WEST,13,1027,1037,2064
NYERI,KIENI WEST,14,1038,1002,2040
NYERI,KIENI WEST,Oct-14,5162,5014,10176
NYERI,KIENI WEST,15,1066,955,2021
NYERI,KIENI WEST,16,1097,1008,2105
NYERI,KIENI WEST,17,1156,993,2149
NYERI,KIENI WEST,18,858,754,1612
NYERI,KIENI WEST,19,804,716,1520
NYERI,KIENI WEST,15-19,4981,4426,9407
NYERI,KIENI WEST,20,712,678,1390
NYERI,KIENI WEST,21,684,578,1262
NYERI,KIENI WEST,22,644,592,1236
NYERI,KIENI WEST,23,584,586,1170
NYERI,KIENI WEST,24,564,519,1083
NYERI,KIENI WEST,20-24,3188,2953,6141
NYERI,KIENI WEST,25,564,529,1093
NYERI,KIENI WEST,26,437,483,920
NYERI,KIENI WEST,27,532,497,1029
NYERI,KIENI WEST,28,413,454,867
NYERI,KIENI WEST,29,502,505,1007
NYERI,KIENI WEST,25-29,2448,2468,4916
NYERI,KIENI WEST,30,644,649,1293
NYERI,KIENI WEST,31,473,499,972
NYERI,KIENI WEST,32,605,688,1293
NYERI,KIENI WEST,33,572,602,1174
NYERI,KIENI WEST,34,506,627,1133
NYERI,KIENI WEST,30-34,2800,3065,5865
NYERI,KIENI WEST,35,735,777,1512
NYERI,KIENI WEST,36,508,603,1111
NYERI,KIENI WEST,37,587,586,1173
NYERI,KIENI WEST,38,509,561,1070
NYERI,KIENI WEST,39,530,644,1174
NYERI,KIENI WEST,35-39,2869,3171,6040
NYERI,KIENI WEST,40,693,698,1391
NYERI,KIENI WEST,41,550,553,1103
NYERI,KIENI WEST,42,598,557,1155
NYERI,KIENI WEST,43,474,589,1063
NYERI,KIENI WEST,44,453,492,945
NYERI,KIENI WEST,40-44,2768,2889,5657
NYERI,KIENI WEST,45,664,653,1317
NYERI,KIENI WEST,46,481,539,1020
NYERI,KIENI WEST,47,512,562,1074
NYERI,KIENI WEST,48,430,450,880
NYERI,KIENI WEST,49,481,478,959
NYERI,KIENI WEST,45-49,2568,2682,5250
NYERI,KIENI WEST,50,583,589,1172
NYERI,KIENI WEST,51,454,432,886
NYERI,KIENI WEST,52,470,534,1004
NYERI,KIENI WEST,53,367,411,778
NYERI,KIENI WEST,54,413,445,858
NYERI,KIENI WEST,50-54,2287,2411,4698
NYERI,KIENI WEST,55,445,408,853
NYERI,KIENI WEST,56,418,377,795
NYERI,KIENI WEST,57,375,392,767
NYERI,KIENI WEST,58,291,320,611
NYERI,KIENI WEST,59,304,370,674
NYERI,KIENI WEST,55-59,1833,1867,3700
NYERI,KIENI WEST,60,345,392,737
NYERI,KIENI WEST,61,255,273,528
NYERI,KIENI WEST,62,216,182,398
NYERI,KIENI WEST,63,180,198,378
NYERI,KIENI WEST,64,128,132,260
NYERI,KIENI WEST,60-64,1124,1177,2301
NYERI,KIENI WEST,65,229,251,480
NYERI,KIENI WEST,66,156,154,310
NYERI,KIENI WEST,67,253,281,534
NYERI,KIENI WEST,68,106,110,216
NYERI,KIENI WEST,69,164,163,327
NYERI,KIENI WEST,65-69,908,959,1867
NYERI,KIENI WEST,70,226,280,506
NYERI,KIENI WEST,71,152,188,340
NYERI,KIENI WEST,72,147,171,318
NYERI,KIENI WEST,73,120,142,262
NYERI,KIENI WEST,74,120,151,271
NYERI,KIENI WEST,70-74,765,932,1697
NYERI,KIENI WEST,75,91,136,227
NYERI,KIENI WEST,76,120,280,400
NYERI,KIENI WEST,77,68,127,195
NYERI,KIENI WEST,78,71,66,137
NYERI,KIENI WEST,79,56,110,166
NYERI,KIENI WEST,75-79,406,719,1125
NYERI,KIENI WEST,80,88,141,229
NYERI,KIENI WEST,81,41,68,109
NYERI,KIENI WEST,82,62,50,112
NYERI,KIENI WEST,83,58,65,123
NYERI,KIENI WEST,84,38,57,95
NYERI,KIENI WEST,80-84,287,381,668
NYERI,KIENI WEST,85,33,59,92
NYERI,KIENI WEST,86,32,72,104
NYERI,KIENI WEST,87,34,41,75
NYERI,KIENI WEST,88,17,20,37
NYERI,KIENI WEST,89,20,51,71
NYERI,KIENI WEST,85-89,136,243,379
NYERI,KIENI WEST,90,18,38,56
NYERI,KIENI WEST,91,16,37,53
NYERI,KIENI WEST,92,7,12,19
NYERI,KIENI WEST,93,7,15,22
NYERI,KIENI WEST,94,6,14,20
NYERI,KIENI WEST,90-94,54,116,170
NYERI,KIENI WEST,95,6,17,23
NYERI,KIENI WEST,96,5,12,17
NYERI,KIENI WEST,97,14,10,24
NYERI,KIENI WEST,98,4,5,9
NYERI,KIENI WEST,99,4,12,16
NYERI,KIENI WEST,95-99,33,56,89
NYERI,KIENI WEST,100+,5,34,39
NYERI,KIENI WEST,Not Stated,-,-,-
NYERI,MATHIRA EAST,Total,48070,50992,99062
NYERI,MATHIRA EAST,0,924,968,1892
NYERI,MATHIRA EAST,1,940,887,1827
NYERI,MATHIRA EAST,2,888,843,1731
NYERI,MATHIRA EAST,3,904,866,1770
NYERI,MATHIRA EAST,4,901,901,1802
NYERI,MATHIRA EAST,0 - 4,4557,4465,9022
NYERI,MATHIRA EAST,5,898,907,1805
NYERI,MATHIRA EAST,6,895,923,1818
NYERI,MATHIRA EAST,7,873,974,1847
NYERI,MATHIRA EAST,8,868,871,1739
NYERI,MATHIRA EAST,9,929,982,1911
NYERI,MATHIRA EAST,05-Sep,4463,4657,9120
NYERI,MATHIRA EAST,10,917,980,1897
NYERI,MATHIRA EAST,11,913,833,1746
NYERI,MATHIRA EAST,12,982,892,1874
NYERI,MATHIRA EAST,13,981,924,1905
NYERI,MATHIRA EAST,14,993,924,1917
NYERI,MATHIRA EAST,Oct-14,4786,4553,9339
NYERI,MATHIRA EAST,15,932,971,1903
NYERI,MATHIRA EAST,16,865,922,1787
NYERI,MATHIRA EAST,17,993,988,1981
NYERI,MATHIRA EAST,18,979,989,1968
NYERI,MATHIRA EAST,19,1106,1019,2125
NYERI,MATHIRA EAST,15-19,4875,4889,9764
NYERI,MATHIRA EAST,20,958,923,1881
NYERI,MATHIRA EAST,21,939,867,1806
NYERI,MATHIRA EAST,22,917,873,1790
NYERI,MATHIRA EAST,23,849,870,1719
NYERI,MATHIRA EAST,24,767,726,1493
NYERI,MATHIRA EAST,20-24,4430,4259,8689
NYERI,MATHIRA EAST,25,745,731,1476
NYERI,MATHIRA EAST,26,619,664,1283
NYERI,MATHIRA EAST,27,598,713,1311
NYERI,MATHIRA EAST,28,520,643,1163
NYERI,MATHIRA EAST,29,599,699,1298
NYERI,MATHIRA EAST,25-29,3081,3450,6531
NYERI,MATHIRA EAST,30,784,914,1698
NYERI,MATHIRA EAST,31,563,663,1226
NYERI,MATHIRA EAST,32,770,880,1650
NYERI,MATHIRA EAST,33,642,768,1410
NYERI,MATHIRA EAST,34,698,713,1411
NYERI,MATHIRA EAST,30-34,3457,3938,7395
NYERI,MATHIRA EAST,35,898,907,1805
NYERI,MATHIRA EAST,36,602,687,1289
NYERI,MATHIRA EAST,37,662,724,1386
NYERI,MATHIRA EAST,38,613,635,1248
NYERI,MATHIRA EAST,39,607,741,1348
NYERI,MATHIRA EAST,35-39,3382,3694,7076
NYERI,MATHIRA EAST,40,782,796,1578
NYERI,MATHIRA EAST,41,631,638,1269
NYERI,MATHIRA EAST,42,671,691,1362
NYERI,MATHIRA EAST,43,507,616,1123
NYERI,MATHIRA EAST,44,503,519,1022
NYERI,MATHIRA EAST,40-44,3094,3260,6354
NYERI,MATHIRA EAST,45,717,725,1442
NYERI,MATHIRA EAST,46,536,544,1080
NYERI,MATHIRA EAST,47,604,577,1181
NYERI,MATHIRA EAST,48,488,510,998
NYERI,MATHIRA EAST,49,531,558,1089
NYERI,MATHIRA EAST,45-49,2876,2914,5790
NYERI,MATHIRA EAST,50,611,686,1297
NYERI,MATHIRA EAST,51,462,489,951
NYERI,MATHIRA EAST,52,547,610,1157
NYERI,MATHIRA EAST,53,406,423,829
NYERI,MATHIRA EAST,54,502,455,957
NYERI,MATHIRA EAST,50-54,2528,2663,5191
NYERI,MATHIRA EAST,55,467,510,977
NYERI,MATHIRA EAST,56,427,494,921
NYERI,MATHIRA EAST,57,441,437,878
NYERI,MATHIRA EAST,58,352,411,763
NYERI,MATHIRA EAST,59,345,424,769
NYERI,MATHIRA EAST,55-59,2032,2276,4308
NYERI,MATHIRA EAST,60,387,458,845
NYERI,MATHIRA EAST,61,309,331,640
NYERI,MATHIRA EAST,62,244,285,529
NYERI,MATHIRA EAST,63,186,233,419
NYERI,MATHIRA EAST,64,169,170,339
NYERI,MATHIRA EAST,60-64,1295,1477,2772
NYERI,MATHIRA EAST,65,232,277,509
NYERI,MATHIRA EAST,66,176,169,345
NYERI,MATHIRA EAST,67,342,345,687
NYERI,MATHIRA EAST,68,152,188,340
NYERI,MATHIRA EAST,69,206,247,453
NYERI,MATHIRA EAST,65-69,1108,1226,2334
NYERI,MATHIRA EAST,70,302,408,710
NYERI,MATHIRA EAST,71,184,249,433
NYERI,MATHIRA EAST,72,177,212,389
NYERI,MATHIRA EAST,73,140,183,323
NYERI,MATHIRA EAST,74,135,186,321
NYERI,MATHIRA EAST,70-74,938,1238,2176
NYERI,MATHIRA EAST,75,129,173,302
NYERI,MATHIRA EAST,76,106,172,278
NYERI,MATHIRA EAST,77,123,189,312
NYERI,MATHIRA EAST,78,92,84,176
NYERI,MATHIRA EAST,79,83,166,249
NYERI,MATHIRA EAST,75-79,533,784,1317
NYERI,MATHIRA EAST,80,103,227,330
NYERI,MATHIRA EAST,81,66,102,168
NYERI,MATHIRA EAST,82,63,72,135
NYERI,MATHIRA EAST,83,59,89,148
NYERI,MATHIRA EAST,84,49,112,161
NYERI,MATHIRA EAST,80-84,340,602,942
NYERI,MATHIRA EAST,85,39,84,123
NYERI,MATHIRA EAST,86,37,57,94
NYERI,MATHIRA EAST,87,31,45,76
NYERI,MATHIRA EAST,88,19,32,51
NYERI,MATHIRA EAST,89,31,63,94
NYERI,MATHIRA EAST,85-89,157,281,438
NYERI,MATHIRA EAST,90,24,76,100
NYERI,MATHIRA EAST,91,34,56,90
NYERI,MATHIRA EAST,92,16,25,41
NYERI,MATHIRA EAST,93,7,30,37
NYERI,MATHIRA EAST,94,10,26,36
NYERI,MATHIRA EAST,90-94,91,213,304
NYERI,MATHIRA EAST,95,11,40,51
NYERI,MATHIRA EAST,96,8,7,15
NYERI,MATHIRA EAST,97,8,12,20
NYERI,MATHIRA EAST,98,5,17,22
NYERI,MATHIRA EAST,99,5,20,25
NYERI,MATHIRA EAST,95-99,37,96,133
NYERI,MATHIRA EAST,100+,9,57,66
NYERI,MATHIRA EAST,Not Stated,1,-,1
NYERI,MATHIRA WEST,Total,29480,30412,59892
NYERI,MATHIRA WEST,0,489,472,961
NYERI,MATHIRA WEST,1,516,506,1022
NYERI,MATHIRA WEST,2,550,539,1089
NYERI,MATHIRA WEST,3,594,541,1135
NYERI,MATHIRA WEST,4,598,572,1170
NYERI,MATHIRA WEST,0 - 4,2747,2630,5377
NYERI,MATHIRA WEST,5,558,520,1078
NYERI,MATHIRA WEST,6,576,526,1102
NYERI,MATHIRA WEST,7,649,577,1226
NYERI,MATHIRA WEST,8,586,560,1146
NYERI,MATHIRA WEST,9,616,616,1232
NYERI,MATHIRA WEST,05-Sep,2985,2799,5784
NYERI,MATHIRA WEST,10,629,584,1213
NYERI,MATHIRA WEST,11,569,574,1143
NYERI,MATHIRA WEST,12,679,654,1333
NYERI,MATHIRA WEST,13,651,634,1285
NYERI,MATHIRA WEST,14,669,597,1266
NYERI,MATHIRA WEST,Oct-14,3197,3043,6240
NYERI,MATHIRA WEST,15,657,608,1265
NYERI,MATHIRA WEST,16,657,569,1226
NYERI,MATHIRA WEST,17,650,613,1263
NYERI,MATHIRA WEST,18,585,472,1057
NYERI,MATHIRA WEST,19,553,482,1035
NYERI,MATHIRA WEST,15-19,3102,2744,5846
NYERI,MATHIRA WEST,20,475,430,905
NYERI,MATHIRA WEST,21,383,378,761
NYERI,MATHIRA WEST,22,396,388,784
NYERI,MATHIRA WEST,23,415,404,819
NYERI,MATHIRA WEST,24,295,339,634
NYERI,MATHIRA WEST,20-24,1964,1939,3903
NYERI,MATHIRA WEST,25,363,315,678
NYERI,MATHIRA WEST,26,320,301,621
NYERI,MATHIRA WEST,27,286,283,569
NYERI,MATHIRA WEST,28,275,311,586
NYERI,MATHIRA WEST,29,307,366,673
NYERI,MATHIRA WEST,25-29,1551,1576,3127
NYERI,MATHIRA WEST,30,370,419,789
NYERI,MATHIRA WEST,31,307,330,637
NYERI,MATHIRA WEST,32,406,401,807
NYERI,MATHIRA WEST,33,328,371,699
NYERI,MATHIRA WEST,34,321,340,661
NYERI,MATHIRA WEST,30-34,1732,1861,3593
NYERI,MATHIRA WEST,35,428,481,909
NYERI,MATHIRA WEST,36,365,368,733
NYERI,MATHIRA WEST,37,340,373,713
NYERI,MATHIRA WEST,38,336,349,685
NYERI,MATHIRA WEST,39,334,392,726
NYERI,MATHIRA WEST,35-39,1803,1963,3766
NYERI,MATHIRA WEST,40,424,428,852
NYERI,MATHIRA WEST,41,350,381,731
NYERI,MATHIRA WEST,42,367,360,727
NYERI,MATHIRA WEST,43,346,347,693
NYERI,MATHIRA WEST,44,340,308,648
NYERI,MATHIRA WEST,40-44,1827,1824,3651
NYERI,MATHIRA WEST,45,423,409,832
NYERI,MATHIRA WEST,46,360,373,733
NYERI,MATHIRA WEST,47,370,354,724
NYERI,MATHIRA WEST,48,319,293,612
NYERI,MATHIRA WEST,49,322,370,692
NYERI,MATHIRA WEST,45-49,1794,1799,3593
NYERI,MATHIRA WEST,50,352,386,738
NYERI,MATHIRA WEST,51,314,308,622
NYERI,MATHIRA WEST,52,323,335,658
NYERI,MATHIRA WEST,53,259,321,580
NYERI,MATHIRA WEST,54,309,309,618
NYERI,MATHIRA WEST,50-54,1557,1659,3216
NYERI,MATHIRA WEST,55,309,350,659
NYERI,MATHIRA WEST,56,299,328,627
NYERI,MATHIRA WEST,57,270,341,611
NYERI,MATHIRA WEST,58,235,233,468
NYERI,MATHIRA WEST,59,260,261,521
NYERI,MATHIRA WEST,55-59,1373,1513,2886
NYERI,MATHIRA WEST,60,293,354,647
NYERI,MATHIRA WEST,61,220,256,476
NYERI,MATHIRA WEST,62,197,229,426
NYERI,MATHIRA WEST,63,186,168,354
NYERI,MATHIRA WEST,64,117,139,256
NYERI,MATHIRA WEST,60-64,1013,1146,2159
NYERI,MATHIRA WEST,65,169,225,394
NYERI,MATHIRA WEST,66,141,154,295
NYERI,MATHIRA WEST,67,232,285,517
NYERI,MATHIRA WEST,68,113,142,255
NYERI,MATHIRA WEST,69,164,210,374
NYERI,MATHIRA WEST,65-69,819,1016,1835
NYERI,MATHIRA WEST,70,239,328,567
NYERI,MATHIRA WEST,71,186,209,395
NYERI,MATHIRA WEST,72,195,203,398
NYERI,MATHIRA WEST,73,134,160,294
NYERI,MATHIRA WEST,74,116,189,305
NYERI,MATHIRA WEST,70-74,870,1089,1959
NYERI,MATHIRA WEST,75,109,149,258
NYERI,MATHIRA WEST,76,129,204,333
NYERI,MATHIRA WEST,77,98,155,253
NYERI,MATHIRA WEST,78,71,77,148
NYERI,MATHIRA WEST,79,72,143,215
NYERI,MATHIRA WEST,75-79,479,728,1207
NYERI,MATHIRA WEST,80,117,172,289
NYERI,MATHIRA WEST,81,65,90,155
NYERI,MATHIRA WEST,82,59,68,127
NYERI,MATHIRA WEST,83,78,95,173
NYERI,MATHIRA WEST,84,60,75,135
NYERI,MATHIRA WEST,80-84,379,500,879
NYERI,MATHIRA WEST,85,43,65,108
NYERI,MATHIRA WEST,86,44,66,110
NYERI,MATHIRA WEST,87,35,53,88
NYERI,MATHIRA WEST,88,19,29,48
NYERI,MATHIRA WEST,89,32,53,85
NYERI,MATHIRA WEST,85-89,173,266,439
NYERI,MATHIRA WEST,90,17,62,79
NYERI,MATHIRA WEST,91,32,65,97
NYERI,MATHIRA WEST,92,11,23,34
NYERI,MATHIRA WEST,93,9,22,31
NYERI,MATHIRA WEST,94,9,16,25
NYERI,MATHIRA WEST,90-94,78,188,266
NYERI,MATHIRA WEST,95,13,26,39
NYERI,MATHIRA WEST,96,3,11,14
NYERI,MATHIRA WEST,97,3,17,20
NYERI,MATHIRA WEST,98,5,7,12
NYERI,MATHIRA WEST,99,4,28,32
NYERI,MATHIRA WEST,95-99,28,89,117
NYERI,MATHIRA WEST,100+,8,40,48
NYERI,MATHIRA WEST,Not Stated,1,-,1
NYERI,NYERI SOUTH,Total,44115,46964,91079
NYERI,NYERI SOUTH,0,816,854,1670
NYERI,NYERI SOUTH,1,841,811,1652
NYERI,NYERI SOUTH,2,857,811,1668
NYERI,NYERI SOUTH,3,898,871,1769
NYERI,NYERI SOUTH,4,888,827,1715
NYERI,NYERI SOUTH,0 - 4,4300,4174,8474
NYERI,NYERI SOUTH,5,923,896,1819
NYERI,NYERI SOUTH,6,871,876,1747
NYERI,NYERI SOUTH,7,888,897,1785
NYERI,NYERI SOUTH,8,910,912,1822
NYERI,NYERI SOUTH,9,918,951,1869
NYERI,NYERI SOUTH,05-Sep,4510,4532,9042
NYERI,NYERI SOUTH,10,958,909,1867
NYERI,NYERI SOUTH,11,874,857,1731
NYERI,NYERI SOUTH,12,940,926,1866
NYERI,NYERI SOUTH,13,999,926,1925
NYERI,NYERI SOUTH,14,970,877,1847
NYERI,NYERI SOUTH,Oct-14,4741,4495,9236
NYERI,NYERI SOUTH,15,966,980,1946
NYERI,NYERI SOUTH,16,950,892,1842
NYERI,NYERI SOUTH,17,1098,895,1993
NYERI,NYERI SOUTH,18,871,805,1676
NYERI,NYERI SOUTH,19,879,851,1730
NYERI,NYERI SOUTH,15-19,4764,4423,9187
NYERI,NYERI SOUTH,20,743,710,1453
NYERI,NYERI SOUTH,21,653,699,1352
NYERI,NYERI SOUTH,22,624,631,1255
NYERI,NYERI SOUTH,23,620,636,1256
NYERI,NYERI SOUTH,24,516,563,1079
NYERI,NYERI SOUTH,20-24,3156,3239,6395
NYERI,NYERI SOUTH,25,539,551,1090
NYERI,NYERI SOUTH,26,458,538,996
NYERI,NYERI SOUTH,27,504,520,1024
NYERI,NYERI SOUTH,28,448,523,971
NYERI,NYERI SOUTH,29,492,598,1090
NYERI,NYERI SOUTH,25-29,2441,2730,5171
NYERI,NYERI SOUTH,30,630,679,1309
NYERI,NYERI SOUTH,31,524,545,1069
NYERI,NYERI SOUTH,32,594,678,1272
NYERI,NYERI SOUTH,33,554,620,1174
NYERI,NYERI SOUTH,34,528,606,1134
NYERI,NYERI SOUTH,30-34,2830,3128,5958
NYERI,NYERI SOUTH,35,726,784,1510
NYERI,NYERI SOUTH,36,560,606,1166
NYERI,NYERI SOUTH,37,596,595,1191
NYERI,NYERI SOUTH,38,489,566,1055
NYERI,NYERI SOUTH,39,565,638,1203
NYERI,NYERI SOUTH,35-39,2936,3189,6125
NYERI,NYERI SOUTH,40,680,682,1362
NYERI,NYERI SOUTH,41,554,612,1166
NYERI,NYERI SOUTH,42,557,606,1163
NYERI,NYERI SOUTH,43,519,598,1117
NYERI,NYERI SOUTH,44,501,554,1055
NYERI,NYERI SOUTH,40-44,2811,3052,5863
NYERI,NYERI SOUTH,45,596,672,1268
NYERI,NYERI SOUTH,46,510,531,1041
NYERI,NYERI SOUTH,47,517,601,1118
NYERI,NYERI SOUTH,48,461,458,919
NYERI,NYERI SOUTH,49,450,493,943
NYERI,NYERI SOUTH,45-49,2534,2755,5289
NYERI,NYERI SOUTH,50,582,627,1209
NYERI,NYERI SOUTH,51,414,481,895
NYERI,NYERI SOUTH,52,493,546,1039
NYERI,NYERI SOUTH,53,352,475,827
NYERI,NYERI SOUTH,54,410,505,915
NYERI,NYERI SOUTH,50-54,2251,2634,4885
NYERI,NYERI SOUTH,55,450,472,922
NYERI,NYERI SOUTH,56,446,497,943
NYERI,NYERI SOUTH,57,364,461,825
NYERI,NYERI SOUTH,58,345,359,704
NYERI,NYERI SOUTH,59,420,430,850
NYERI,NYERI SOUTH,55-59,2025,2219,4244
NYERI,NYERI SOUTH,60,419,476,895
NYERI,NYERI SOUTH,61,303,366,669
NYERI,NYERI SOUTH,62,256,283,539
NYERI,NYERI SOUTH,63,186,216,402
NYERI,NYERI SOUTH,64,130,181,311
NYERI,NYERI SOUTH,60-64,1294,1522,2816
NYERI,NYERI SOUTH,65,232,274,506
NYERI,NYERI SOUTH,66,176,206,382
NYERI,NYERI SOUTH,67,317,379,696
NYERI,NYERI SOUTH,68,173,177,350
NYERI,NYERI SOUTH,69,242,273,515
NYERI,NYERI SOUTH,65-69,1140,1309,2449
NYERI,NYERI SOUTH,70,314,447,761
NYERI,NYERI SOUTH,71,213,301,514
NYERI,NYERI SOUTH,72,238,182,420
NYERI,NYERI SOUTH,73,181,178,359
NYERI,NYERI SOUTH,74,146,182,328
NYERI,NYERI SOUTH,70-74,1092,1290,2382
NYERI,NYERI SOUTH,75,130,178,308
NYERI,NYERI SOUTH,76,178,339,517
NYERI,NYERI SOUTH,77,107,145,252
NYERI,NYERI SOUTH,78,77,106,183
NYERI,NYERI SOUTH,79,82,163,245
NYERI,NYERI SOUTH,75-79,574,931,1505
NYERI,NYERI SOUTH,80,110,203,313
NYERI,NYERI SOUTH,81,61,115,176
NYERI,NYERI SOUTH,82,64,77,141
NYERI,NYERI SOUTH,83,64,93,157
NYERI,NYERI SOUTH,84,71,118,189
NYERI,NYERI SOUTH,80-84,370,606,976
NYERI,NYERI SOUTH,85,57,104,161
NYERI,NYERI SOUTH,86,36,53,89
NYERI,NYERI SOUTH,87,45,71,116
NYERI,NYERI SOUTH,88,19,42,61
NYERI,NYERI SOUTH,89,45,113,158
NYERI,NYERI SOUTH,85-89,202,383,585
NYERI,NYERI SOUTH,90,25,70,95
NYERI,NYERI SOUTH,91,30,47,77
NYERI,NYERI SOUTH,92,14,21,35
NYERI,NYERI SOUTH,93,14,20,34
NYERI,NYERI SOUTH,94,2,33,35
NYERI,NYERI SOUTH,90-94,85,191,276
NYERI,NYERI SOUTH,95,19,26,45
NYERI,NYERI SOUTH,96,6,16,22
NYERI,NYERI SOUTH,97,8,14,22
NYERI,NYERI SOUTH,98,9,9,18
NYERI,NYERI SOUTH,99,6,33,39
NYERI,NYERI SOUTH,95-99,48,98,146
NYERI,NYERI SOUTH,100+,11,64,75
NYERI,NYERI SOUTH,Not Stated,-,-,-
NYERI,MUKURWEINI,Total,43975,45156,89131
NYERI,MUKURWEINI,0,790,765,1555
NYERI,MUKURWEINI,1,754,780,1534
NYERI,MUKURWEINI,2,827,841,1668
NYERI,MUKURWEINI,3,868,781,1649
NYERI,MUKURWEINI,4,819,827,1646
NYERI,MUKURWEINI,0 - 4,4058,3994,8052
NYERI,MUKURWEINI,5,848,839,1687
NYERI,MUKURWEINI,6,879,884,1763
NYERI,MUKURWEINI,7,972,889,1861
NYERI,MUKURWEINI,8,882,945,1827
NYERI,MUKURWEINI,9,1030,910,1940
NYERI,MUKURWEINI,05-Sep,15-Aug,4467,9078
NYERI,MUKURWEINI,10,926,948,1874
NYERI,MUKURWEINI,11,930,899,1829
NYERI,MUKURWEINI,12,996,896,1892
NYERI,MUKURWEINI,13,1068,983,2051
NYERI,MUKURWEINI,14,1003,867,1870
NYERI,MUKURWEINI,Oct-14,23-Jun,4593,9516
NYERI,MUKURWEINI,15,1022,880,1902
NYERI,MUKURWEINI,16,968,832,1800
NYERI,MUKURWEINI,17,1068,867,1935
NYERI,MUKURWEINI,18,877,670,1547
NYERI,MUKURWEINI,19,789,662,1451
NYERI,MUKURWEINI,15-19,4724,3911,8635
NYERI,MUKURWEINI,20,693,637,1330
NYERI,MUKURWEINI,21,591,546,1137
NYERI,MUKURWEINI,22,505,504,1009
NYERI,MUKURWEINI,23,550,560,1110
NYERI,MUKURWEINI,24,494,465,959
NYERI,MUKURWEINI,20-24,2833,2712,5545
NYERI,MUKURWEINI,25,501,480,981
NYERI,MUKURWEINI,26,417,438,855
NYERI,MUKURWEINI,27,407,449,856
NYERI,MUKURWEINI,28,359,454,813
NYERI,MUKURWEINI,29,465,527,992
NYERI,MUKURWEINI,25-29,2149,2348,4497
NYERI,MUKURWEINI,30,578,645,1223
NYERI,MUKURWEINI,31,490,517,1007
NYERI,MUKURWEINI,32,598,618,1216
NYERI,MUKURWEINI,33,536,552,1088
NYERI,MUKURWEINI,34,486,540,1026
NYERI,MUKURWEINI,30-34,2688,2872,5560
NYERI,MUKURWEINI,35,702,632,1334
NYERI,MUKURWEINI,36,572,545,1117
NYERI,MUKURWEINI,37,558,559,1117
NYERI,MUKURWEINI,38,483,544,1027
NYERI,MUKURWEINI,39,529,614,1143
NYERI,MUKURWEINI,35-39,2844,2894,5738
NYERI,MUKURWEINI,40,679,681,1360
NYERI,MUKURWEINI,41,550,510,1060
NYERI,MUKURWEINI,42,541,490,1031
NYERI,MUKURWEINI,43,510,561,1071
NYERI,MUKURWEINI,44,451,456,907
NYERI,MUKURWEINI,40-44,2731,2698,5429
NYERI,MUKURWEINI,45,604,618,1222
NYERI,MUKURWEINI,46,521,460,981
NYERI,MUKURWEINI,47,528,545,1073
NYERI,MUKURWEINI,48,396,418,814
NYERI,MUKURWEINI,49,477,536,1013
NYERI,MUKURWEINI,45-49,2526,2577,5103
NYERI,MUKURWEINI,50,531,599,1130
NYERI,MUKURWEINI,51,452,450,902
NYERI,MUKURWEINI,52,501,537,1038
NYERI,MUKURWEINI,53,370,447,817
NYERI,MUKURWEINI,54,473,463,936
NYERI,MUKURWEINI,50-54,2327,2496,4823
NYERI,MUKURWEINI,55,449,524,973
NYERI,MUKURWEINI,56,497,502,999
NYERI,MUKURWEINI,57,380,463,843
NYERI,MUKURWEINI,58,327,376,703
NYERI,MUKURWEINI,59,404,423,827
NYERI,MUKURWEINI,55-59,2057,2288,4345
NYERI,MUKURWEINI,60,434,501,935
NYERI,MUKURWEINI,61,328,373,701
NYERI,MUKURWEINI,62,289,299,588
NYERI,MUKURWEINI,63,200,247,447
NYERI,MUKURWEINI,64,161,186,347
NYERI,MUKURWEINI,60-64,1412,1606,3018
NYERI,MUKURWEINI,65,307,354,661
NYERI,MUKURWEINI,66,209,221,430
NYERI,MUKURWEINI,67,409,424,833
NYERI,MUKURWEINI,68,195,198,393
NYERI,MUKURWEINI,69,272,302,574
NYERI,MUKURWEINI,65-69,1392,1499,2891
NYERI,MUKURWEINI,70,361,509,870
NYERI,MUKURWEINI,71,250,297,547
NYERI,MUKURWEINI,72,240,244,484
NYERI,MUKURWEINI,73,221,196,417
NYERI,MUKURWEINI,74,162,254,416
NYERI,MUKURWEINI,70-74,1234,1500,2734
NYERI,MUKURWEINI,75,154,256,410
NYERI,MUKURWEINI,76,142,264,406
NYERI,MUKURWEINI,77,120,197,317
NYERI,MUKURWEINI,78,59,134,193
NYERI,MUKURWEINI,79,83,157,240
NYERI,MUKURWEINI,75-79,558,1008,1566
NYERI,MUKURWEINI,80,146,288,434
NYERI,MUKURWEINI,81,82,124,206
NYERI,MUKURWEINI,82,80,91,171
NYERI,MUKURWEINI,83,84,122,206
NYERI,MUKURWEINI,84,75,109,184
NYERI,MUKURWEINI,80-84,467,734,1201
NYERI,MUKURWEINI,85,73,101,174
NYERI,MUKURWEINI,86,60,95,155
NYERI,MUKURWEINI,87,51,77,128
NYERI,MUKURWEINI,88,23,59,82
NYERI,MUKURWEINI,89,43,118,161
NYERI,MUKURWEINI,85-89,250,450,700
NYERI,MUKURWEINI,90,42,86,128
NYERI,MUKURWEINI,91,30,49,79
NYERI,MUKURWEINI,92,15,40,55
NYERI,MUKURWEINI,93,18,29,47
NYERI,MUKURWEINI,94,14,41,55
NYERI,MUKURWEINI,90-94,119,245,364
NYERI,MUKURWEINI,95,14,41,55
NYERI,MUKURWEINI,96,12,42,54
NYERI,MUKURWEINI,97,8,27,35
NYERI,MUKURWEINI,98,8,28,36
NYERI,MUKURWEINI,99,9,44,53
NYERI,MUKURWEINI,95-99,51,182,233
NYERI,MUKURWEINI,100+,21,81,102
NYERI,MUKURWEINI,Not Stated,-,1,1
NYERI,NYERI CENTRAL,Total,69955,70380,140335
NYERI,NYERI CENTRAL,0,1625,1539,3164
NYERI,NYERI CENTRAL,1,1553,1450,3003
NYERI,NYERI CENTRAL,2,1419,1378,2797
NYERI,NYERI CENTRAL,3,1446,1373,2819
NYERI,NYERI CENTRAL,4,1366,1306,2672
NYERI,NYERI CENTRAL,0 - 4,7409,7046,14455
NYERI,NYERI CENTRAL,5,1306,1293,2599
NYERI,NYERI CENTRAL,6,1234,1243,2477
NYERI,NYERI CENTRAL,7,1317,1300,2617
NYERI,NYERI CENTRAL,8,1282,1223,2505
NYERI,NYERI CENTRAL,9,1320,1298,2618
NYERI,NYERI CENTRAL,05-Sep,6459,6357,12816
NYERI,NYERI CENTRAL,10,1258,1233,2491
NYERI,NYERI CENTRAL,11,1155,1183,2338
NYERI,NYERI CENTRAL,12,1287,1278,2565
NYERI,NYERI CENTRAL,13,1352,1281,2633
NYERI,NYERI CENTRAL,14,1153,1179,2332
NYERI,NYERI CENTRAL,Oct-14,6205,6154,12359
NYERI,NYERI CENTRAL,15,1186,1228,2414
NYERI,NYERI CENTRAL,16,1155,1198,2353
NYERI,NYERI CENTRAL,17,1244,1277,2521
NYERI,NYERI CENTRAL,18,1098,1189,2287
NYERI,NYERI CENTRAL,19,1270,1306,2576
NYERI,NYERI CENTRAL,15-19,5953,6198,12151
NYERI,NYERI CENTRAL,20,1284,1431,2715
NYERI,NYERI CENTRAL,21,1348,1474,2822
NYERI,NYERI CENTRAL,22,1399,1539,2938
NYERI,NYERI CENTRAL,23,1552,1605,3157
NYERI,NYERI CENTRAL,24,1488,1580,3068
NYERI,NYERI CENTRAL,20-24,7071,7629,14700
NYERI,NYERI CENTRAL,25,1421,1461,2882
NYERI,NYERI CENTRAL,26,1274,1332,2606
NYERI,NYERI CENTRAL,27,1301,1300,2601
NYERI,NYERI CENTRAL,28,1225,1280,2505
NYERI,NYERI CENTRAL,29,1346,1230,2576
NYERI,NYERI CENTRAL,25-29,6567,6603,13170
NYERI,NYERI CENTRAL,30,1499,1480,2979
NYERI,NYERI CENTRAL,31,1139,1037,2176
NYERI,NYERI CENTRAL,32,1339,1388,2727
NYERI,NYERI CENTRAL,33,1148,1237,2385
NYERI,NYERI CENTRAL,34,1117,1153,2270
NYERI,NYERI CENTRAL,30-34,6242,6295,12537
NYERI,NYERI CENTRAL,35,1382,1365,2747
NYERI,NYERI CENTRAL,36,1071,1060,2131
NYERI,NYERI CENTRAL,37,1078,1022,2100
NYERI,NYERI CENTRAL,38,1012,978,1990
NYERI,NYERI CENTRAL,39,1007,984,1991
NYERI,NYERI CENTRAL,35-39,5550,5409,10959
NYERI,NYERI CENTRAL,40,1136,1138,2274
NYERI,NYERI CENTRAL,41,961,859,1820
NYERI,NYERI CENTRAL,42,970,856,1826
NYERI,NYERI CENTRAL,43,802,817,1619
NYERI,NYERI CENTRAL,44,666,672,1338
NYERI,NYERI CENTRAL,40-44,4535,4342,8877
NYERI,NYERI CENTRAL,45,958,889,1847
NYERI,NYERI CENTRAL,46,710,670,1380
NYERI,NYERI CENTRAL,47,775,689,1464
NYERI,NYERI CENTRAL,48,654,568,1222
NYERI,NYERI CENTRAL,49,687,653,1340
NYERI,NYERI CENTRAL,45-49,3784,3469,7253
NYERI,NYERI CENTRAL,50,800,796,1596
NYERI,NYERI CENTRAL,51,532,594,1126
NYERI,NYERI CENTRAL,52,615,699,1314
NYERI,NYERI CENTRAL,53,497,488,985
NYERI,NYERI CENTRAL,54,589,560,1149
NYERI,NYERI CENTRAL,50-54,3033,3137,6170
NYERI,NYERI CENTRAL,55,547,538,1085
NYERI,NYERI CENTRAL,56,586,503,1089
NYERI,NYERI CENTRAL,57,502,516,1018
NYERI,NYERI CENTRAL,58,467,407,874
NYERI,NYERI CENTRAL,59,439,371,810
NYERI,NYERI CENTRAL,55-59,2541,2335,4876
NYERI,NYERI CENTRAL,60,492,479,971
NYERI,NYERI CENTRAL,61,336,315,651
NYERI,NYERI CENTRAL,62,306,294,600
NYERI,NYERI CENTRAL,63,234,248,482
NYERI,NYERI CENTRAL,64,157,172,329
NYERI,NYERI CENTRAL,60-64,1525,1508,3033
NYERI,NYERI CENTRAL,65,260,276,536
NYERI,NYERI CENTRAL,66,159,208,367
NYERI,NYERI CENTRAL,67,313,316,629
NYERI,NYERI CENTRAL,68,156,168,324
NYERI,NYERI CENTRAL,69,200,223,423
NYERI,NYERI CENTRAL,65-69,1088,1191,2279
NYERI,NYERI CENTRAL,70,289,325,614
NYERI,NYERI CENTRAL,71,199,204,403
NYERI,NYERI CENTRAL,72,197,181,378
NYERI,NYERI CENTRAL,73,179,143,322
NYERI,NYERI CENTRAL,74,131,156,287
NYERI,NYERI CENTRAL,70-74,995,1009,2004
NYERI,NYERI CENTRAL,75,128,151,279
NYERI,NYERI CENTRAL,76,133,222,355
NYERI,NYERI CENTRAL,77,86,126,212
NYERI,NYERI CENTRAL,78,62,82,144
NYERI,NYERI CENTRAL,79,64,104,168
NYERI,NYERI CENTRAL,75-79,473,685,1158
NYERI,NYERI CENTRAL,80,99,165,264
NYERI,NYERI CENTRAL,81,57,72,129
NYERI,NYERI CENTRAL,82,61,63,124
NYERI,NYERI CENTRAL,83,48,93,141
NYERI,NYERI CENTRAL,84,31,61,92
NYERI,NYERI CENTRAL,80-84,296,454,750
NYERI,NYERI CENTRAL,85,29,71,100
NYERI,NYERI CENTRAL,86,30,55,85
NYERI,NYERI CENTRAL,87,28,52,80
NYERI,NYERI CENTRAL,88,20,31,51
NYERI,NYERI CENTRAL,89,26,59,85
NYERI,NYERI CENTRAL,85-89,133,268,401
NYERI,NYERI CENTRAL,90,10,65,75
NYERI,NYERI CENTRAL,91,16,63,79
NYERI,NYERI CENTRAL,92,10,17,27
NYERI,NYERI CENTRAL,93,11,13,24
NYERI,NYERI CENTRAL,94,7,19,26
NYERI,NYERI CENTRAL,90-94,54,177,231
NYERI,NYERI CENTRAL,95,12,27,39
NYERI,NYERI CENTRAL,96,5,12,17
NYERI,NYERI CENTRAL,97,7,11,18
NYERI,NYERI CENTRAL,98,5,10,15
NYERI,NYERI CENTRAL,99,3,11,14
NYERI,NYERI CENTRAL,95-99,32,71,103
NYERI,NYERI CENTRAL,100+,9,40,49
NYERI,NYERI CENTRAL,Not Stated,1,3,4
NYERI,MT. KENYA FOREST,Total,123,65,188
NYERI,MT. KENYA FOREST,0,1,2,3
NYERI,MT. KENYA FOREST,1,1,2,3
NYERI,MT. KENYA FOREST,2,3,1,4
NYERI,MT. KENYA FOREST,3,1,-,1
NYERI,MT. KENYA FOREST,4,2,1,3
NYERI,MT. KENYA FOREST,0 - 4,8,6,14
NYERI,MT. KENYA FOREST,5,3,2,5
NYERI,MT. KENYA FOREST,6,-,1,1
NYERI,MT. KENYA FOREST,7,2,1,3
NYERI,MT. KENYA FOREST,8,1,3,4
NYERI,MT. KENYA FOREST,9,2,-,2
NYERI,MT. KENYA FOREST,05-Sep,8,7,15
NYERI,MT. KENYA FOREST,10,-,1,2
NYERI,MT. KENYA FOREST,11,-,1,1
NYERI,MT. KENYA FOREST,12,2,1,3
NYERI,MT. KENYA FOREST,13,1,-,1
NYERI,MT. KENYA FOREST,14,1,1,2
NYERI,MT. KENYA FOREST,Oct-14,5,4,9
NYERI,MT. KENYA FOREST,15,-,2,2
NYERI,MT. KENYA FOREST,16,1,2,3
NYERI,MT. KENYA FOREST,17,-,1,1
NYERI,MT. KENYA FOREST,18,2,2,4
NYERI,MT. KENYA FOREST,19,1,2,3
NYERI,MT. KENYA FOREST,15-19,4,9,13
NYERI,MT. KENYA FOREST,20,2,1,3
NYERI,MT. KENYA FOREST,21,2,1,3
NYERI,MT. KENYA FOREST,22,-,-,-
NYERI,MT. KENYA FOREST,23,2,1,3
NYERI,MT. KENYA FOREST,24,2,3,5
NYERI,MT. KENYA FOREST,20-24,8,6,14
NYERI,MT. KENYA FOREST,25,3,2,5
NYERI,MT. KENYA FOREST,26,1,-,1
NYERI,MT. KENYA FOREST,27,1,1,2
NYERI,MT. KENYA FOREST,28,1,3,4
NYERI,MT. KENYA FOREST,29,2,1,3
NYERI,MT. KENYA FOREST,25-29,8,7,15
NYERI,MT. KENYA FOREST,30,4,1,5
NYERI,MT. KENYA FOREST,31,4,1,5
NYERI,MT. KENYA FOREST,32,4,1,5
NYERI,MT. KENYA FOREST,33,2,-,2
NYERI,MT. KENYA FOREST,34,3,1,4
NYERI,MT. KENYA FOREST,30-34,17,4,21
NYERI,MT. KENYA FOREST,35,1,3,4
NYERI,MT. KENYA FOREST,36,5,2,7
NYERI,MT. KENYA FOREST,37,4,1,5
NYERI,MT. KENYA FOREST,38,4,2,6
NYERI,MT. KENYA FOREST,39,7,-,7
NYERI,MT. KENYA FOREST,35-39,21,8,29
NYERI,MT. KENYA FOREST,40,4,-,4
NYERI,MT. KENYA FOREST,41,-,-,-
NYERI,MT. KENYA FOREST,42,2,1,3
NYERI,MT. KENYA FOREST,43,-,-,-
NYERI,MT. KENYA FOREST,44,1,1,2
NYERI,MT. KENYA FOREST,40-44,7,2,9
NYERI,MT. KENYA FOREST,45,2,-,2
NYERI,MT. KENYA FOREST,46,3,-,3
NYERI,MT. KENYA FOREST,47,3,2,5
NYERI,MT. KENYA FOREST,48,3,1,4
NYERI,MT. KENYA FOREST,49,-,-,-
NYERI,MT. KENYA FOREST,45-49,11,3,14
NYERI,MT. KENYA FOREST,50,3,2,5
NYERI,MT. KENYA FOREST,51,2,1,3
NYERI,MT. KENYA FOREST,52,1,-,1
NYERI,MT. KENYA FOREST,53,2,1,3
NYERI,MT. KENYA FOREST,54,1,1,2
NYERI,MT. KENYA FOREST,50-54,9,5,14
NYERI,MT. KENYA FOREST,55,3,2,5
NYERI,MT. KENYA FOREST,56,2,-,2
NYERI,MT. KENYA FOREST,57,2,-,2
NYERI,MT. KENYA FOREST,58,1,1,2
NYERI,MT. KENYA FOREST,59,1,-,1
NYERI,MT. KENYA FOREST,55-59,9,3,12
NYERI,MT. KENYA FOREST,60,1,1,2
NYERI,MT. KENYA FOREST,61,1,-,1
NYERI,MT. KENYA FOREST,62,-,-,-
NYERI,MT. KENYA FOREST,63,2,-,2
NYERI,MT. KENYA FOREST,64,-,-,-
NYERI,MT. KENYA FOREST,60-64,4,1,5
NYERI,MT. KENYA FOREST,65,-,-,-
NYERI,MT. KENYA FOREST,66,1,-,1
NYERI,MT. KENYA FOREST,67,2,-,2
NYERI,MT. KENYA FOREST,68,-,-,-
NYERI,MT. KENYA FOREST,69,-,-,-
NYERI,MT. KENYA FOREST,65-69,3,-,3
NYERI,MT. KENYA FOREST,70,-,-,-
NYERI,MT. KENYA FOREST,71,-,-,-
NYERI,MT. KENYA FOREST,72,-,-,-
NYERI,MT. KENYA FOREST,73,-,-,-
NYERI,MT. KENYA FOREST,74,-,-,-
NYERI,MT. KENYA FOREST,70-74,-,-,-
NYERI,MT. KENYA FOREST,75,-,-,-
NYERI,MT. KENYA FOREST,76,-,-,-
NYERI,MT. KENYA FOREST,77,-,-,-
NYERI,MT. KENYA FOREST,78,-,-,-
NYERI,MT. KENYA FOREST,79,-,-,-
NYERI,MT. KENYA FOREST,75-79,-,-,-
NYERI,MT. KENYA FOREST,80,-,-,-
NYERI,MT. KENYA FOREST,81,-,-,-
NYERI,MT. KENYA FOREST,82,-,-,-
NYERI,MT. KENYA FOREST,83,-,-,-
NYERI,MT. KENYA FOREST,84,-,-,-
NYERI,MT. KENYA FOREST,80-84,-,-,-
NYERI,MT. KENYA FOREST,85,1,-,1
NYERI,MT. KENYA FOREST,86,-,-,-
NYERI,MT. KENYA FOREST,87,-,-,-
NYERI,MT. KENYA FOREST,88,-,-,-
NYERI,MT. KENYA FOREST,89,-,-,-
NYERI,MT. KENYA FOREST,85-89,1,-,1
NYERI,MT. KENYA FOREST,90,-,-,-
NYERI,MT. KENYA FOREST,91,-,-,-
NYERI,MT. KENYA FOREST,92,-,-,-
NYERI,MT. KENYA FOREST,93,-,-,-
NYERI,MT. KENYA FOREST,94,-,-,-
NYERI,MT. KENYA FOREST,90-94,-,-,-
NYERI,MT. KENYA FOREST,95,-,-,-
NYERI,MT. KENYA FOREST,96,-,-,-
NYERI,MT. KENYA FOREST,97,-,-,-
NYERI,MT. KENYA FOREST,98,-,-,-
NYERI,MT. KENYA FOREST,99,-,-,-
NYERI,MT. KENYA FOREST,95-99,-,-,-
NYERI,MT. KENYA FOREST,100+,-,-,-
NYERI,MT. KENYA FOREST,Not Stated,-,-,-
NYERI,ABERDARE FOREST,Total,74,32,106
NYERI,ABERDARE FOREST,0,1,2,3
NYERI,ABERDARE FOREST,1,1,-,1
NYERI,ABERDARE FOREST,2,2,1,3
NYERI,ABERDARE FOREST,3,3,-,3
NYERI,ABERDARE FOREST,4,-,-,-
NYERI,ABERDARE FOREST,0 - 4,7,3,10
NYERI,ABERDARE FOREST,5,1,-,1
NYERI,ABERDARE FOREST,6,-,-,-
NYERI,ABERDARE FOREST,7,-,-,-
NYERI,ABERDARE FOREST,8,1,-,1
NYERI,ABERDARE FOREST,9,-,-,-
NYERI,ABERDARE FOREST,05-Sep,2,-,2
NYERI,ABERDARE FOREST,10,-,-,-
NYERI,ABERDARE FOREST,11,1,-,1
NYERI,ABERDARE FOREST,12,-,-,-
NYERI,ABERDARE FOREST,13,-,-,-
NYERI,ABERDARE FOREST,14,-,1,1
NYERI,ABERDARE FOREST,Oct-14,1,1,2
NYERI,ABERDARE FOREST,15,-,-,-
NYERI,ABERDARE FOREST,16,-,-,-
NYERI,ABERDARE FOREST,17,-,-,-
NYERI,ABERDARE FOREST,18,-,2,2
NYERI,ABERDARE FOREST,19,-,1,1
NYERI,ABERDARE FOREST,15-19,-,3,3
NYERI,ABERDARE FOREST,20,-,2,2
NYERI,ABERDARE FOREST,21,-,-,-
NYERI,ABERDARE FOREST,22,-,-,-
NYERI,ABERDARE FOREST,23,-,2,2
NYERI,ABERDARE FOREST,24,2,2,4
NYERI,ABERDARE FOREST,20-24,2,6,8
NYERI,ABERDARE FOREST,25,-,5,5
NYERI,ABERDARE FOREST,26,2,3,5
NYERI,ABERDARE FOREST,27,6,2,8
NYERI,ABERDARE FOREST,28,7,4,11
NYERI,ABERDARE FOREST,29,3,2,5
NYERI,ABERDARE FOREST,25-29,18,16,34
NYERI,ABERDARE FOREST,30,3,1,4
NYERI,ABERDARE FOREST,31,2,-,2
NYERI,ABERDARE FOREST,32,5,-,5
NYERI,ABERDARE FOREST,33,1,-,1
NYERI,ABERDARE FOREST,34,-,-,-
NYERI,ABERDARE FOREST,30-34,11,1,12
NYERI,ABERDARE FOREST,35,6,1,7
NYERI,ABERDARE FOREST,36,2,1,3
NYERI,ABERDARE FOREST,37,3,-,3
NYERI,ABERDARE FOREST,38,7,-,7
NYERI,ABERDARE FOREST,39,-,-,-
NYERI,ABERDARE FOREST,35-39,18,2,20
NYERI,ABERDARE FOREST,40,6,-,6
NYERI,ABERDARE FOREST,41,-,-,-
NYERI,ABERDARE FOREST,42,2,-,2
NYERI,ABERDARE FOREST,43,1,-,1
NYERI,ABERDARE FOREST,44,1,-,1
NYERI,ABERDARE FOREST,40-44,10,-,10
NYERI,ABERDARE FOREST,45,-,-,-
NYERI,ABERDARE FOREST,46,-,-,-
NYERI,ABERDARE FOREST,47,1,-,1
NYERI,ABERDARE FOREST,48,-,-,-
NYERI,ABERDARE FOREST,49,2,-,2
NYERI,ABERDARE FOREST,45-49,3,-,3
NYERI,ABERDARE FOREST,50,-,-,-
NYERI,ABERDARE FOREST,51,-,-,-
NYERI,ABERDARE FOREST,52,1,-,1
NYERI,ABERDARE FOREST,53,-,-,-
NYERI,ABERDARE FOREST,54,-,-,-
NYERI,ABERDARE FOREST,50-54,1,-,1
NYERI,ABERDARE FOREST,55,-,-,-
NYERI,ABERDARE FOREST,56,-,-,-
NYERI,ABERDARE FOREST,57,1,-,1
NYERI,ABERDARE FOREST,58,-,-,-
NYERI,ABERDARE FOREST,59,-,-,-
NYERI,ABERDARE FOREST,55-59,1,-,1
NYERI,ABERDARE FOREST,60,-,-,-
NYERI,ABERDARE FOREST,61,-,-,-
NYERI,ABERDARE FOREST,62,-,-,-
NYERI,ABERDARE FOREST,63,-,-,-
NYERI,ABERDARE FOREST,64,-,-,-
NYERI,ABERDARE FOREST,60-64,-,-,-
NYERI,ABERDARE FOREST,65,-,-,-
NYERI,ABERDARE FOREST,66,-,-,-
NYERI,ABERDARE FOREST,67,-,-,-
NYERI,ABERDARE FOREST,68,-,-,-
NYERI,ABERDARE FOREST,69,-,-,-
NYERI,ABERDARE FOREST,65-69,-,-,-
NYERI,ABERDARE FOREST,70,-,-,-
NYERI,ABERDARE FOREST,71,-,-,-
NYERI,ABERDARE FOREST,72,-,-,-
NYERI,ABERDARE FOREST,73,-,-,-
NYERI,ABERDARE FOREST,74,-,-,-
NYERI,ABERDARE FOREST,70-74,-,-,-
NYERI,ABERDARE FOREST,75,-,-,-
NYERI,ABERDARE FOREST,76,-,-,-
NYERI,ABERDARE FOREST,77,-,-,-
NYERI,ABERDARE FOREST,78,-,-,-
NYERI,ABERDARE FOREST,79,-,-,-
NYERI,ABERDARE FOREST,75-79,-,-,-
NYERI,ABERDARE FOREST,80,-,-,-
NYERI,ABERDARE FOREST,81,-,-,-
NYERI,ABERDARE FOREST,82,-,-,-
NYERI,ABERDARE FOREST,83,-,-,-
NYERI,ABERDARE FOREST,84,-,-,-
NYERI,ABERDARE FOREST,80-84,-,-,-
NYERI,ABERDARE FOREST,85,-,-,-
NYERI,ABERDARE FOREST,86,-,-,-
NYERI,ABERDARE FOREST,87,-,-,-
NYERI,ABERDARE FOREST,88,-,-,-
NYERI,ABERDARE FOREST,89,-,-,-
NYERI,ABERDARE FOREST,85-89,-,-,-
NYERI,ABERDARE FOREST,90,-,-,-
NYERI,ABERDARE FOREST,91,-,-,-
NYERI,ABERDARE FOREST,92,-,-,-
NYERI,ABERDARE FOREST,93,-,-,-
NYERI,ABERDARE FOREST,94,-,-,-
NYERI,ABERDARE FOREST,90-94,-,-,-
NYERI,ABERDARE FOREST,95,-,-,-
NYERI,ABERDARE FOREST,96,-,-,-
NYERI,ABERDARE FOREST,97,-,-,-
NYERI,ABERDARE FOREST,98,-,-,-
NYERI,ABERDARE FOREST,99,-,-,-
NYERI,ABERDARE FOREST,95-99,-,-,-
NYERI,ABERDARE FOREST,100+,-,-,-
NYERI,ABERDARE FOREST,Not Stated,-,-,-
SAMBURU,ALL,Total,156774,153546,310320
SAMBURU,ALL,0,4527,4386,8913
SAMBURU,ALL,1,4234,4239,8473
SAMBURU,ALL,2,5315,5436,10751
SAMBURU,ALL,3,5591,5581,11172
SAMBURU,ALL,4,5794,5578,11372
SAMBURU,ALL,0 - 4,25461,25220,50681
SAMBURU,ALL,5,5981,5814,11795
SAMBURU,ALL,6,5781,5653,11434
SAMBURU,ALL,7,4965,4788,9753
SAMBURU,ALL,8,5713,5641,11354
SAMBURU,ALL,9,4356,4271,8627
SAMBURU,ALL,05-Sep,26796,26167,52963
SAMBURU,ALL,10,7223,6917,14140
SAMBURU,ALL,11,3312,3664,6976
SAMBURU,ALL,12,5778,4993,10771
SAMBURU,ALL,13,4234,3816,8050
SAMBURU,ALL,14,4516,3890,8406
SAMBURU,ALL,Oct-14,25063,23280,48343
SAMBURU,ALL,15,5215,4376,9591
SAMBURU,ALL,16,3827,3181,7008
SAMBURU,ALL,17,3827,2825,6652
SAMBURU,ALL,18,3921,3243,7164
SAMBURU,ALL,19,3075,2688,5763
SAMBURU,ALL,15-19,19865,16313,36178
SAMBURU,ALL,20,4485,4327,8812
SAMBURU,ALL,21,2413,2688,5101
SAMBURU,ALL,22,2538,2733,5271
SAMBURU,ALL,23,2571,2916,5487
SAMBURU,ALL,24,2301,2276,4577
SAMBURU,ALL,20-24,14308,14940,29248
SAMBURU,ALL,25,3414,3384,6798
SAMBURU,ALL,26,1905,2246,4151
SAMBURU,ALL,27,1877,2098,3975
SAMBURU,ALL,28,1848,1830,3678
SAMBURU,ALL,29,1945,1947,3892
SAMBURU,ALL,25-29,10989,11505,22494
SAMBURU,ALL,30,3370,3180,6550
SAMBURU,ALL,31,1261,1536,2797
SAMBURU,ALL,32,1632,1934,3566
SAMBURU,ALL,33,1186,1603,2789
SAMBURU,ALL,34,935,1060,1995
SAMBURU,ALL,30-34,8384,9313,17697
SAMBURU,ALL,35,2271,2393,4664
SAMBURU,ALL,36,871,1097,1968
SAMBURU,ALL,37,772,683,1455
SAMBURU,ALL,38,635,598,1233
SAMBURU,ALL,39,753,695,1448
SAMBURU,ALL,35-39,5302,5466,10768
SAMBURU,ALL,40,2007,1547,3554
SAMBURU,ALL,41,1087,1016,2103
SAMBURU,ALL,42,990,953,1943
SAMBURU,ALL,43,732,766,1498
SAMBURU,ALL,44,506,428,934
SAMBURU,ALL,40-44,5322,4710,10032
SAMBURU,ALL,45,1451,1309,2760
SAMBURU,ALL,46,784,937,1721
SAMBURU,ALL,47,790,810,1600
SAMBURU,ALL,48,501,574,1075
SAMBURU,ALL,49,584,584,1168
SAMBURU,ALL,45-49,4110,4214,8324
SAMBURU,ALL,50,1156,1171,2327
SAMBURU,ALL,51,401,501,902
SAMBURU,ALL,52,396,445,841
SAMBURU,ALL,53,274,295,569
SAMBURU,ALL,54,440,418,858
SAMBURU,ALL,50-54,2667,2830,5497
SAMBURU,ALL,55,538,499,1037
SAMBURU,ALL,56,433,362,795
SAMBURU,ALL,57,299,346,645
SAMBURU,ALL,58,338,289,627
SAMBURU,ALL,59,481,612,1093
SAMBURU,ALL,55-59,2089,2108,4197
SAMBURU,ALL,60,996,989,1985
SAMBURU,ALL,61,385,404,789
SAMBURU,ALL,62,310,363,673
SAMBURU,ALL,63,308,398,706
SAMBURU,ALL,64,195,271,466
SAMBURU,ALL,60-64,2194,2425,4619
SAMBURU,ALL,65,435,514,949
SAMBURU,ALL,66,141,146,287
SAMBURU,ALL,67,223,290,513
SAMBURU,ALL,68,188,202,390
SAMBURU,ALL,69,259,395,654
SAMBURU,ALL,65-69,1246,1547,2793
SAMBURU,ALL,70,624,730,1354
SAMBURU,ALL,71,274,360,634
SAMBURU,ALL,72,162,156,318
SAMBURU,ALL,73,142,158,300
SAMBURU,ALL,74,148,156,304
SAMBURU,ALL,70-74,1350,1560,2910
SAMBURU,ALL,75,273,234,507
SAMBURU,ALL,76,71,92,163
SAMBURU,ALL,77,86,99,185
SAMBURU,ALL,78,74,83,157
SAMBURU,ALL,79,184,240,424
SAMBURU,ALL,75-79,688,748,1436
SAMBURU,ALL,80,238,338,576
SAMBURU,ALL,81,101,100,201
SAMBURU,ALL,82,54,63,117
SAMBURU,ALL,83,54,93,147
SAMBURU,ALL,84,60,68,128
SAMBURU,ALL,80-84,507,662,1169
SAMBURU,ALL,85,47,73,120
SAMBURU,ALL,86,23,34,57
SAMBURU,ALL,87,36,51,87
SAMBURU,ALL,88,27,26,53
SAMBURU,ALL,89,96,119,215
SAMBURU,ALL,85-89,229,303,532
SAMBURU,ALL,90,61,84,145
SAMBURU,ALL,91,16,20,36
SAMBURU,ALL,92,8,5,13
SAMBURU,ALL,93,13,14,27
SAMBURU,ALL,94,12,11,23
SAMBURU,ALL,90-94,110,134,244
SAMBURU,ALL,95,24,32,56
SAMBURU,ALL,96,10,9,19
SAMBURU,ALL,97,7,6,13
SAMBURU,ALL,98,9,5,14
SAMBURU,ALL,99,14,23,37
SAMBURU,ALL,95-99,64,75,139
SAMBURU,ALL,100+,29,25,54
SAMBURU,ALL,Not Stated,1,1,2
SAMBURU,SAMBURU CENTRAL,Total,83633,81307,164940
SAMBURU,SAMBURU CENTRAL,0,2365,2289,4654
SAMBURU,SAMBURU CENTRAL,1,2233,2235,4468
SAMBURU,SAMBURU CENTRAL,2,2688,2833,5521
SAMBURU,SAMBURU CENTRAL,3,2828,2815,5643
SAMBURU,SAMBURU CENTRAL,4,2978,2899,5877
SAMBURU,SAMBURU CENTRAL,0 - 4,13092,13071,26163
SAMBURU,SAMBURU CENTRAL,5,3059,3039,6098
SAMBURU,SAMBURU CENTRAL,6,3032,2951,5983
SAMBURU,SAMBURU CENTRAL,7,2627,2539,5166
SAMBURU,SAMBURU CENTRAL,8,2933,2911,5844
SAMBURU,SAMBURU CENTRAL,9,2418,2306,4724
SAMBURU,SAMBURU CENTRAL,05-Sep,14069,13746,27815
SAMBURU,SAMBURU CENTRAL,10,3709,3434,7143
SAMBURU,SAMBURU CENTRAL,11,1926,1967,3893
SAMBURU,SAMBURU CENTRAL,12,2967,2689,5656
SAMBURU,SAMBURU CENTRAL,13,2339,2159,4498
SAMBURU,SAMBURU CENTRAL,14,2488,2194,4682
SAMBURU,SAMBURU CENTRAL,Oct-14,13429,12443,25872
SAMBURU,SAMBURU CENTRAL,15,2903,2421,5324
SAMBURU,SAMBURU CENTRAL,16,2069,1785,3854
SAMBURU,SAMBURU CENTRAL,17,2172,1709,3881
SAMBURU,SAMBURU CENTRAL,18,2132,1725,3857
SAMBURU,SAMBURU CENTRAL,19,1731,1545,3276
SAMBURU,SAMBURU CENTRAL,15-19,11007,9185,20192
SAMBURU,SAMBURU CENTRAL,20,2267,2340,4607
SAMBURU,SAMBURU CENTRAL,21,1339,1443,2782
SAMBURU,SAMBURU CENTRAL,22,1401,1564,2965
SAMBURU,SAMBURU CENTRAL,23,1348,1463,2811
SAMBURU,SAMBURU CENTRAL,24,1236,1147,2383
SAMBURU,SAMBURU CENTRAL,20-24,7591,7957,15548
SAMBURU,SAMBURU CENTRAL,25,1794,1742,3536
SAMBURU,SAMBURU CENTRAL,26,1061,1087,2148
SAMBURU,SAMBURU CENTRAL,27,1007,1096,2103
SAMBURU,SAMBURU CENTRAL,28,1031,980,2011
SAMBURU,SAMBURU CENTRAL,29,1040,954,1994
SAMBURU,SAMBURU CENTRAL,25-29,5933,5859,11792
SAMBURU,SAMBURU CENTRAL,30,1722,1695,3417
SAMBURU,SAMBURU CENTRAL,31,705,888,1593
SAMBURU,SAMBURU CENTRAL,32,890,958,1848
SAMBURU,SAMBURU CENTRAL,33,644,858,1502
SAMBURU,SAMBURU CENTRAL,34,532,579,1111
SAMBURU,SAMBURU CENTRAL,30-34,4493,4978,9471
SAMBURU,SAMBURU CENTRAL,35,1190,1311,2501
SAMBURU,SAMBURU CENTRAL,36,513,648,1161
SAMBURU,SAMBURU CENTRAL,37,443,423,866
SAMBURU,SAMBURU CENTRAL,38,407,375,782
SAMBURU,SAMBURU CENTRAL,39,442,387,829
SAMBURU,SAMBURU CENTRAL,35-39,2995,3144,6139
SAMBURU,SAMBURU CENTRAL,40,1091,816,1907
SAMBURU,SAMBURU CENTRAL,41,615,505,1120
SAMBURU,SAMBURU CENTRAL,42,502,467,969
SAMBURU,SAMBURU CENTRAL,43,337,379,716
SAMBURU,SAMBURU CENTRAL,44,316,228,544
SAMBURU,SAMBURU CENTRAL,40-44,2861,2395,5256
SAMBURU,SAMBURU CENTRAL,45,737,665,1402
SAMBURU,SAMBURU CENTRAL,46,405,533,938
SAMBURU,SAMBURU CENTRAL,47,462,475,937
SAMBURU,SAMBURU CENTRAL,48,295,319,614
SAMBURU,SAMBURU CENTRAL,49,320,271,591
SAMBURU,SAMBURU CENTRAL,45-49,2219,2263,4482
SAMBURU,SAMBURU CENTRAL,50,593,601,1194
SAMBURU,SAMBURU CENTRAL,51,232,239,471
SAMBURU,SAMBURU CENTRAL,52,214,227,441
SAMBURU,SAMBURU CENTRAL,53,160,144,304
SAMBURU,SAMBURU CENTRAL,54,246,220,466
SAMBURU,SAMBURU CENTRAL,50-54,1445,1431,2876
SAMBURU,SAMBURU CENTRAL,55,291,270,561
SAMBURU,SAMBURU CENTRAL,56,240,188,428
SAMBURU,SAMBURU CENTRAL,57,181,206,387
SAMBURU,SAMBURU CENTRAL,58,215,151,366
SAMBURU,SAMBURU CENTRAL,59,243,327,570
SAMBURU,SAMBURU CENTRAL,55-59,1170,1142,2312
SAMBURU,SAMBURU CENTRAL,60,500,513,1013
SAMBURU,SAMBURU CENTRAL,61,221,215,436
SAMBURU,SAMBURU CENTRAL,62,168,194,362
SAMBURU,SAMBURU CENTRAL,63,166,201,367
SAMBURU,SAMBURU CENTRAL,64,107,124,231
SAMBURU,SAMBURU CENTRAL,60-64,1162,1247,2409
SAMBURU,SAMBURU CENTRAL,65,219,279,498
SAMBURU,SAMBURU CENTRAL,66,74,69,143
SAMBURU,SAMBURU CENTRAL,67,127,164,291
SAMBURU,SAMBURU CENTRAL,68,108,78,186
SAMBURU,SAMBURU CENTRAL,69,126,195,321
SAMBURU,SAMBURU CENTRAL,65-69,654,785,1439
SAMBURU,SAMBURU CENTRAL,70,319,357,676
SAMBURU,SAMBURU CENTRAL,71,135,163,298
SAMBURU,SAMBURU CENTRAL,72,86,67,153
SAMBURU,SAMBURU CENTRAL,73,73,60,133
SAMBURU,SAMBURU CENTRAL,74,75,70,145
SAMBURU,SAMBURU CENTRAL,70-74,688,717,1405
SAMBURU,SAMBURU CENTRAL,75,140,116,256
SAMBURU,SAMBURU CENTRAL,76,38,34,72
SAMBURU,SAMBURU CENTRAL,77,45,37,82
SAMBURU,SAMBURU CENTRAL,78,45,41,86
SAMBURU,SAMBURU CENTRAL,79,82,111,193
SAMBURU,SAMBURU CENTRAL,75-79,350,339,689
SAMBURU,SAMBURU CENTRAL,80,132,185,317
SAMBURU,SAMBURU CENTRAL,81,39,48,87
SAMBURU,SAMBURU CENTRAL,82,28,23,51
SAMBURU,SAMBURU CENTRAL,83,30,51,81
SAMBURU,SAMBURU CENTRAL,84,33,28,61
SAMBURU,SAMBURU CENTRAL,80-84,262,335,597
SAMBURU,SAMBURU CENTRAL,85,21,38,59
SAMBURU,SAMBURU CENTRAL,86,13,15,28
SAMBURU,SAMBURU CENTRAL,87,22,31,53
SAMBURU,SAMBURU CENTRAL,88,17,7,24
SAMBURU,SAMBURU CENTRAL,89,44,55,99
SAMBURU,SAMBURU CENTRAL,85-89,117,146,263
SAMBURU,SAMBURU CENTRAL,90,30,43,73
SAMBURU,SAMBURU CENTRAL,91,6,13,19
SAMBURU,SAMBURU CENTRAL,92,4,4,8
SAMBURU,SAMBURU CENTRAL,93,10,7,17
SAMBURU,SAMBURU CENTRAL,94,6,6,12
SAMBURU,SAMBURU CENTRAL,90-94,56,73,129
SAMBURU,SAMBURU CENTRAL,95,5,15,20
SAMBURU,SAMBURU CENTRAL,96,4,3,7
SAMBURU,SAMBURU CENTRAL,97,3,3,6
SAMBURU,SAMBURU CENTRAL,98,5,2,7
SAMBURU,SAMBURU CENTRAL,99,3,13,16
SAMBURU,SAMBURU CENTRAL,95-99,20,36,56
SAMBURU,SAMBURU CENTRAL,100+,19,15,34
SAMBURU,SAMBURU CENTRAL,Not Stated,1,-,1
SAMBURU,SAMBURU EAST,Total,38211,39782,77993
SAMBURU,SAMBURU EAST,0,1116,1080,2196
SAMBURU,SAMBURU EAST,1,1125,1127,2252
SAMBURU,SAMBURU EAST,2,1356,1391,2747
SAMBURU,SAMBURU EAST,3,1499,1510,3009
SAMBURU,SAMBURU EAST,4,1482,1387,2869
SAMBURU,SAMBURU EAST,0 - 4,6578,6495,13073
SAMBURU,SAMBURU EAST,5,1498,1449,2947
SAMBURU,SAMBURU EAST,6,1408,1447,2855
SAMBURU,SAMBURU EAST,7,1154,1132,2286
SAMBURU,SAMBURU EAST,8,1410,1407,2817
SAMBURU,SAMBURU EAST,9,1025,1024,2049
SAMBURU,SAMBURU EAST,05-Sep,6495,6459,12954
SAMBURU,SAMBURU EAST,10,1806,1872,3678
SAMBURU,SAMBURU EAST,11,737,834,1571
SAMBURU,SAMBURU EAST,12,1377,1238,2615
SAMBURU,SAMBURU EAST,13,1028,954,1982
SAMBURU,SAMBURU EAST,14,950,903,1853
SAMBURU,SAMBURU EAST,Oct-14,5898,5801,11699
SAMBURU,SAMBURU EAST,15,1031,1028,2059
SAMBURU,SAMBURU EAST,16,874,777,1651
SAMBURU,SAMBURU EAST,17,758,609,1367
SAMBURU,SAMBURU EAST,18,859,875,1734
SAMBURU,SAMBURU EAST,19,719,709,1428
SAMBURU,SAMBURU EAST,15-19,4241,3998,8239
SAMBURU,SAMBURU EAST,20,1039,1071,2110
SAMBURU,SAMBURU EAST,21,575,697,1272
SAMBURU,SAMBURU EAST,22,604,701,1305
SAMBURU,SAMBURU EAST,23,681,852,1533
SAMBURU,SAMBURU EAST,24,582,632,1214
SAMBURU,SAMBURU EAST,20-24,3481,3953,7434
SAMBURU,SAMBURU EAST,25,842,993,1835
SAMBURU,SAMBURU EAST,26,430,603,1033
SAMBURU,SAMBURU EAST,27,401,505,906
SAMBURU,SAMBURU EAST,28,457,509,966
SAMBURU,SAMBURU EAST,29,516,648,1164
SAMBURU,SAMBURU EAST,25-29,2646,3258,5904
SAMBURU,SAMBURU EAST,30,922,979,1901
SAMBURU,SAMBURU EAST,31,310,396,706
SAMBURU,SAMBURU EAST,32,411,561,972
SAMBURU,SAMBURU EAST,33,257,340,597
SAMBURU,SAMBURU EAST,34,242,253,495
SAMBURU,SAMBURU EAST,30-34,2142,2529,4671
SAMBURU,SAMBURU EAST,35,626,634,1260
SAMBURU,SAMBURU EAST,36,220,294,514
SAMBURU,SAMBURU EAST,37,209,165,374
SAMBURU,SAMBURU EAST,38,134,134,268
SAMBURU,SAMBURU EAST,39,180,178,358
SAMBURU,SAMBURU EAST,35-39,1369,1405,2774
SAMBURU,SAMBURU EAST,40,535,428,963
SAMBURU,SAMBURU EAST,41,275,301,576
SAMBURU,SAMBURU EAST,42,253,238,491
SAMBURU,SAMBURU EAST,43,238,209,447
SAMBURU,SAMBURU EAST,44,126,121,247
SAMBURU,SAMBURU EAST,40-44,1427,1297,2724
SAMBURU,SAMBURU EAST,45,418,377,795
SAMBURU,SAMBURU EAST,46,202,239,441
SAMBURU,SAMBURU EAST,47,207,169,376
SAMBURU,SAMBURU EAST,48,143,161,304
SAMBURU,SAMBURU EAST,49,160,204,364
SAMBURU,SAMBURU EAST,45-49,1130,1150,2280
SAMBURU,SAMBURU EAST,50,322,305,627
SAMBURU,SAMBURU EAST,51,84,131,215
SAMBURU,SAMBURU EAST,52,93,100,193
SAMBURU,SAMBURU EAST,53,68,72,140
SAMBURU,SAMBURU EAST,54,107,114,221
SAMBURU,SAMBURU EAST,50-54,674,722,1396
SAMBURU,SAMBURU EAST,55,143,151,294
SAMBURU,SAMBURU EAST,56,113,94,207
SAMBURU,SAMBURU EAST,57,63,69,132
SAMBURU,SAMBURU EAST,58,72,78,150
SAMBURU,SAMBURU EAST,59,134,156,290
SAMBURU,SAMBURU EAST,55-59,525,548,1073
SAMBURU,SAMBURU EAST,60,262,284,546
SAMBURU,SAMBURU EAST,61,107,112,219
SAMBURU,SAMBURU EAST,62,80,97,177
SAMBURU,SAMBURU EAST,63,84,116,200
SAMBURU,SAMBURU EAST,64,44,85,129
SAMBURU,SAMBURU EAST,60-64,577,694,1271
SAMBURU,SAMBURU EAST,65,123,147,270
SAMBURU,SAMBURU EAST,66,31,40,71
SAMBURU,SAMBURU EAST,67,48,68,116
SAMBURU,SAMBURU EAST,68,45,74,119
SAMBURU,SAMBURU EAST,69,63,104,167
SAMBURU,SAMBURU EAST,65-69,310,433,743
SAMBURU,SAMBURU EAST,70,146,190,336
SAMBURU,SAMBURU EAST,71,79,118,197
SAMBURU,SAMBURU EAST,72,43,46,89
SAMBURU,SAMBURU EAST,73,33,64,97
SAMBURU,SAMBURU EAST,74,35,47,82
SAMBURU,SAMBURU EAST,70-74,336,465,801
SAMBURU,SAMBURU EAST,75,53,58,111
SAMBURU,SAMBURU EAST,76,17,37,54
SAMBURU,SAMBURU EAST,77,23,37,60
SAMBURU,SAMBURU EAST,78,14,25,39
SAMBURU,SAMBURU EAST,79,45,57,102
SAMBURU,SAMBURU EAST,75-79,152,214,366
SAMBURU,SAMBURU EAST,80,58,98,156
SAMBURU,SAMBURU EAST,81,38,29,67
SAMBURU,SAMBURU EAST,82,6,27,33
SAMBURU,SAMBURU EAST,83,11,26,37
SAMBURU,SAMBURU EAST,84,13,30,43
SAMBURU,SAMBURU EAST,80-84,126,210,336
SAMBURU,SAMBURU EAST,85,13,18,31
SAMBURU,SAMBURU EAST,86,3,12,15
SAMBURU,SAMBURU EAST,87,6,8,14
SAMBURU,SAMBURU EAST,88,5,11,16
SAMBURU,SAMBURU EAST,89,25,36,61
SAMBURU,SAMBURU EAST,85-89,52,85,137
SAMBURU,SAMBURU EAST,90,12,21,33
SAMBURU,SAMBURU EAST,91,5,5,10
SAMBURU,SAMBURU EAST,92,2,1,3
SAMBURU,SAMBURU EAST,93,1,4,5
SAMBURU,SAMBURU EAST,94,2,4,6
SAMBURU,SAMBURU EAST,90-94,22,35,57
SAMBURU,SAMBURU EAST,95,5,6,11
SAMBURU,SAMBURU EAST,96,3,4,7
SAMBURU,SAMBURU EAST,97,3,2,5
SAMBURU,SAMBURU EAST,98,3,3,6
SAMBURU,SAMBURU EAST,99,7,8,15
SAMBURU,SAMBURU EAST,95-99,21,23,44
SAMBURU,SAMBURU EAST,100+,9,8,17
SAMBURU,SAMBURU EAST,Not Stated,-,-,-
SAMBURU,SAMBURU NORTH,Total,34930,32457,67387
SAMBURU,SAMBURU NORTH,0,1046,1017,2063
SAMBURU,SAMBURU NORTH,1,876,877,1753
SAMBURU,SAMBURU NORTH,2,1271,1212,2483
SAMBURU,SAMBURU NORTH,3,1264,1256,2520
SAMBURU,SAMBURU NORTH,4,1334,1292,2626
SAMBURU,SAMBURU NORTH,0 - 4,5791,5654,11445
SAMBURU,SAMBURU NORTH,5,1424,1326,2750
SAMBURU,SAMBURU NORTH,6,1341,1255,2596
SAMBURU,SAMBURU NORTH,7,1184,1117,2301
SAMBURU,SAMBURU NORTH,8,1370,1323,2693
SAMBURU,SAMBURU NORTH,9,913,941,1854
SAMBURU,SAMBURU NORTH,05-Sep,6232,5962,12194
SAMBURU,SAMBURU NORTH,10,1708,1611,3319
SAMBURU,SAMBURU NORTH,11,649,863,1512
SAMBURU,SAMBURU NORTH,12,1434,1066,2500
SAMBURU,SAMBURU NORTH,13,867,703,1570
SAMBURU,SAMBURU NORTH,14,1078,793,1871
SAMBURU,SAMBURU NORTH,Oct-14,5736,5036,10772
SAMBURU,SAMBURU NORTH,15,1281,927,2208
SAMBURU,SAMBURU NORTH,16,884,619,1503
SAMBURU,SAMBURU NORTH,17,897,507,1404
SAMBURU,SAMBURU NORTH,18,930,643,1573
SAMBURU,SAMBURU NORTH,19,625,434,1059
SAMBURU,SAMBURU NORTH,15-19,4617,3130,7747
SAMBURU,SAMBURU NORTH,20,1179,916,2095
SAMBURU,SAMBURU NORTH,21,499,548,1047
SAMBURU,SAMBURU NORTH,22,533,468,1001
SAMBURU,SAMBURU NORTH,23,542,601,1143
SAMBURU,SAMBURU NORTH,24,483,497,980
SAMBURU,SAMBURU NORTH,20-24,3236,3030,6266
SAMBURU,SAMBURU NORTH,25,778,649,1427
SAMBURU,SAMBURU NORTH,26,414,556,970
SAMBURU,SAMBURU NORTH,27,469,497,966
SAMBURU,SAMBURU NORTH,28,360,341,701
SAMBURU,SAMBURU NORTH,29,389,345,734
SAMBURU,SAMBURU NORTH,25-29,2410,2388,4798
SAMBURU,SAMBURU NORTH,30,726,506,1232
SAMBURU,SAMBURU NORTH,31,246,252,498
SAMBURU,SAMBURU NORTH,32,331,415,746
SAMBURU,SAMBURU NORTH,33,285,405,690
SAMBURU,SAMBURU NORTH,34,161,228,389
SAMBURU,SAMBURU NORTH,30-34,1749,1806,3555
SAMBURU,SAMBURU NORTH,35,455,448,903
SAMBURU,SAMBURU NORTH,36,138,155,293
SAMBURU,SAMBURU NORTH,37,120,95,215
SAMBURU,SAMBURU NORTH,38,94,89,183
SAMBURU,SAMBURU NORTH,39,131,130,261
SAMBURU,SAMBURU NORTH,35-39,938,917,1855
SAMBURU,SAMBURU NORTH,40,381,303,684
SAMBURU,SAMBURU NORTH,41,197,210,407
SAMBURU,SAMBURU NORTH,42,235,248,483
SAMBURU,SAMBURU NORTH,43,157,178,335
SAMBURU,SAMBURU NORTH,44,64,79,143
SAMBURU,SAMBURU NORTH,40-44,1034,1018,2052
SAMBURU,SAMBURU NORTH,45,296,267,563
SAMBURU,SAMBURU NORTH,46,177,165,342
SAMBURU,SAMBURU NORTH,47,121,166,287
SAMBURU,SAMBURU NORTH,48,63,94,157
SAMBURU,SAMBURU NORTH,49,104,109,213
SAMBURU,SAMBURU NORTH,45-49,761,801,1562
SAMBURU,SAMBURU NORTH,50,241,265,506
SAMBURU,SAMBURU NORTH,51,85,131,216
SAMBURU,SAMBURU NORTH,52,89,118,207
SAMBURU,SAMBURU NORTH,53,46,79,125
SAMBURU,SAMBURU NORTH,54,87,84,171
SAMBURU,SAMBURU NORTH,50-54,548,677,1225
SAMBURU,SAMBURU NORTH,55,104,78,182
SAMBURU,SAMBURU NORTH,56,80,80,160
SAMBURU,SAMBURU NORTH,57,55,71,126
SAMBURU,SAMBURU NORTH,58,51,60,111
SAMBURU,SAMBURU NORTH,59,104,129,233
SAMBURU,SAMBURU NORTH,55-59,394,418,812
SAMBURU,SAMBURU NORTH,60,234,192,426
SAMBURU,SAMBURU NORTH,61,57,77,134
SAMBURU,SAMBURU NORTH,62,62,72,134
SAMBURU,SAMBURU NORTH,63,58,81,139
SAMBURU,SAMBURU NORTH,64,44,62,106
SAMBURU,SAMBURU NORTH,60-64,455,484,939
SAMBURU,SAMBURU NORTH,65,93,88,181
SAMBURU,SAMBURU NORTH,66,36,37,73
SAMBURU,SAMBURU NORTH,67,48,58,106
SAMBURU,SAMBURU NORTH,68,35,50,85
SAMBURU,SAMBURU NORTH,69,70,96,166
SAMBURU,SAMBURU NORTH,65-69,282,329,611
SAMBURU,SAMBURU NORTH,70,159,183,342
SAMBURU,SAMBURU NORTH,71,60,79,139
SAMBURU,SAMBURU NORTH,72,33,43,76
SAMBURU,SAMBURU NORTH,73,36,34,70
SAMBURU,SAMBURU NORTH,74,38,39,77
SAMBURU,SAMBURU NORTH,70-74,326,378,704
SAMBURU,SAMBURU NORTH,75,80,60,140
SAMBURU,SAMBURU NORTH,76,16,21,37
SAMBURU,SAMBURU NORTH,77,18,25,43
SAMBURU,SAMBURU NORTH,78,15,17,32
SAMBURU,SAMBURU NORTH,79,57,72,129
SAMBURU,SAMBURU NORTH,75-79,186,195,381
SAMBURU,SAMBURU NORTH,80,48,55,103
SAMBURU,SAMBURU NORTH,81,24,23,47
SAMBURU,SAMBURU NORTH,82,20,13,33
SAMBURU,SAMBURU NORTH,83,13,16,29
SAMBURU,SAMBURU NORTH,84,14,10,24
SAMBURU,SAMBURU NORTH,80-84,119,117,236
SAMBURU,SAMBURU NORTH,85,13,17,30
SAMBURU,SAMBURU NORTH,86,7,7,14
SAMBURU,SAMBURU NORTH,87,8,12,20
SAMBURU,SAMBURU NORTH,88,5,8,13
SAMBURU,SAMBURU NORTH,89,27,28,55
SAMBURU,SAMBURU NORTH,85-89,60,72,132
SAMBURU,SAMBURU NORTH,90,19,20,39
SAMBURU,SAMBURU NORTH,91,5,2,7
SAMBURU,SAMBURU NORTH,92,2,-,2
SAMBURU,SAMBURU NORTH,93,2,3,5
SAMBURU,SAMBURU NORTH,94,4,1,5
SAMBURU,SAMBURU NORTH,90-94,32,26,58
SAMBURU,SAMBURU NORTH,95,14,11,25
SAMBURU,SAMBURU NORTH,96,3,2,5
SAMBURU,SAMBURU NORTH,97,1,1,2
SAMBURU,SAMBURU NORTH,98,1,-,1
SAMBURU,SAMBURU NORTH,99,4,2,6
SAMBURU,SAMBURU NORTH,95-99,23,16,39
SAMBURU,SAMBURU NORTH,100+,1,2,3
SAMBURU,SAMBURU NORTH,Not Stated,-,1,1
SIAYA,ALL,Total,471669,521496,993165
SIAYA,ALL,0,11662,11781,23443
SIAYA,ALL,1,11681,11557,23238
SIAYA,ALL,2,11737,11991,23728
SIAYA,ALL,3,12819,12728,25547
SIAYA,ALL,4,12968,12734,25702
SIAYA,ALL,0 - 4,60867,60791,121658
SIAYA,ALL,5,13550,13046,26596
SIAYA,ALL,6,14046,14050,28096
SIAYA,ALL,7,13619,13886,27505
SIAYA,ALL,8,12870,13462,26332
SIAYA,ALL,9,14658,14649,29307
SIAYA,ALL,05-Sep,68743,69093,137836
SIAYA,ALL,10,15661,15172,30833
SIAYA,ALL,11,14304,14500,28804
SIAYA,ALL,12,16218,15898,32116
SIAYA,ALL,13,15736,15653,31389
SIAYA,ALL,14,14130,13876,28006
SIAYA,ALL,Oct-14,76049,75099,151148
SIAYA,ALL,15,13959,13480,27439
SIAYA,ALL,16,12378,12366,24744
SIAYA,ALL,17,12639,12041,24680
SIAYA,ALL,18,9970,9733,19703
SIAYA,ALL,19,10360,10456,20816
SIAYA,ALL,15-19,59306,58076,117382
SIAYA,ALL,20,8912,9781,18693
SIAYA,ALL,21,7632,8463,16095
SIAYA,ALL,22,6862,8409,15271
SIAYA,ALL,23,6787,8713,15500
SIAYA,ALL,24,6219,7871,14090
SIAYA,ALL,20-24,36412,43237,79649
SIAYA,ALL,25,6897,8665,15562
SIAYA,ALL,26,5830,7805,13635
SIAYA,ALL,27,6361,7801,14162
SIAYA,ALL,28,4780,5843,10623
SIAYA,ALL,29,4942,6382,11324
SIAYA,ALL,25-29,28810,36496,65306
SIAYA,ALL,30,6995,9251,16246
SIAYA,ALL,31,4989,5813,10802
SIAYA,ALL,32,6307,7990,14297
SIAYA,ALL,33,5549,6873,12422
SIAYA,ALL,34,5392,6162,11554
SIAYA,ALL,30-34,29232,36089,65321
SIAYA,ALL,35,6430,6847,13277
SIAYA,ALL,36,4705,4755,9460
SIAYA,ALL,37,5089,4753,9842
SIAYA,ALL,38,3483,3189,6672
SIAYA,ALL,39,4209,4109,8318
SIAYA,ALL,35-39,23916,23653,47569
SIAYA,ALL,40,4958,5392,10350
SIAYA,ALL,41,4294,4278,8572
SIAYA,ALL,42,4051,3975,8026
SIAYA,ALL,43,3753,3964,7717
SIAYA,ALL,44,3087,3405,6492
SIAYA,ALL,40-44,20143,21014,41157
SIAYA,ALL,45,4020,4467,8487
SIAYA,ALL,46,2902,3347,6249
SIAYA,ALL,47,3104,3471,6575
SIAYA,ALL,48,1965,2304,4269
SIAYA,ALL,49,2263,2716,4979
SIAYA,ALL,45-49,14254,16305,30559
SIAYA,ALL,50,3054,4395,7449
SIAYA,ALL,51,2562,3536,6098
SIAYA,ALL,52,2012,2701,4713
SIAYA,ALL,53,1730,2331,4061
SIAYA,ALL,54,2042,2539,4581
SIAYA,ALL,50-54,11400,15502,26902
SIAYA,ALL,55,2303,2906,5209
SIAYA,ALL,56,2202,3292,5494
SIAYA,ALL,57,2254,3938,6192
SIAYA,ALL,58,1561,2214,3775
SIAYA,ALL,59,1915,2861,4776
SIAYA,ALL,55-59,10235,15211,25446
SIAYA,ALL,60,2597,4213,6810
SIAYA,ALL,61,1900,2895,4795
SIAYA,ALL,62,1780,2457,4237
SIAYA,ALL,63,1708,2588,4296
SIAYA,ALL,64,1465,2166,3631
SIAYA,ALL,60-64,9450,14319,23769
SIAYA,ALL,65,1982,2949,4931
SIAYA,ALL,66,1566,2469,4035
SIAYA,ALL,67,2123,3451,5574
SIAYA,ALL,68,928,1288,2216
SIAYA,ALL,69,1502,2084,3586
SIAYA,ALL,65-69,8101,12241,20342
SIAYA,ALL,70,2019,3585,5604
SIAYA,ALL,71,1410,1961,3371
SIAYA,ALL,72,1265,1530,2795
SIAYA,ALL,73,1004,1368,2372
SIAYA,ALL,74,971,1453,2424
SIAYA,ALL,70-74,6669,9897,16566
SIAYA,ALL,75,760,1338,2098
SIAYA,ALL,76,704,1108,1812
SIAYA,ALL,77,897,1621,2518
SIAYA,ALL,78,426,676,1102
SIAYA,ALL,79,596,1315,1911
SIAYA,ALL,75-79,3383,6058,9441
SIAYA,ALL,80,755,1520,2275
SIAYA,ALL,81,475,907,1382
SIAYA,ALL,82,503,718,1221
SIAYA,ALL,83,468,711,1179
SIAYA,ALL,84,396,636,1032
SIAYA,ALL,80-84,2597,4492,7089
SIAYA,ALL,85,332,664,996
SIAYA,ALL,86,262,408,670
SIAYA,ALL,87,381,624,1005
SIAYA,ALL,88,162,301,463
SIAYA,ALL,89,261,644,905
SIAYA,ALL,85-89,1398,2641,4039
SIAYA,ALL,90,163,319,482
SIAYA,ALL,91,127,218,345
SIAYA,ALL,92,77,117,194
SIAYA,ALL,93,62,102,164
SIAYA,ALL,94,57,94,151
SIAYA,ALL,90-94,486,850,1336
SIAYA,ALL,95,65,97,162
SIAYA,ALL,96,27,51,78
SIAYA,ALL,97,28,54,82
SIAYA,ALL,98,15,44,59
SIAYA,ALL,99,26,61,87
SIAYA,ALL,95-99,161,307,468
SIAYA,ALL,100+,43,115,158
SIAYA,ALL,Not Stated,14,10,24
SIAYA,SIAYA,Total,105906,118433,224339
SIAYA,SIAYA,0,2746,2620,5366
SIAYA,SIAYA,1,2635,2608,5243
SIAYA,SIAYA,2,2714,2686,5400
SIAYA,SIAYA,3,2842,2785,5627
SIAYA,SIAYA,4,2955,2853,5808
SIAYA,SIAYA,0 - 4,13892,13552,27444
SIAYA,SIAYA,5,3126,2964,6090
SIAYA,SIAYA,6,3109,3123,6232
SIAYA,SIAYA,7,3088,3160,6248
SIAYA,SIAYA,8,2972,3090,6062
SIAYA,SIAYA,9,3335,3459,6794
SIAYA,SIAYA,05-Sep,15630,15796,31426
SIAYA,SIAYA,10,3496,3431,6927
SIAYA,SIAYA,11,3075,3214,6289
SIAYA,SIAYA,12,3626,3504,7130
SIAYA,SIAYA,13,3547,3510,7057
SIAYA,SIAYA,14,3011,3048,6059
SIAYA,SIAYA,Oct-14,16755,16707,33462
SIAYA,SIAYA,15,3063,2931,5994
SIAYA,SIAYA,16,2683,2734,5417
SIAYA,SIAYA,17,2771,2754,5525
SIAYA,SIAYA,18,2197,2148,4345
SIAYA,SIAYA,19,2228,2247,4475
SIAYA,SIAYA,15-19,12942,12814,25756
SIAYA,SIAYA,20,1983,2135,4118
SIAYA,SIAYA,21,1672,1908,3580
SIAYA,SIAYA,22,1540,1907,3447
SIAYA,SIAYA,23,1532,1985,3517
SIAYA,SIAYA,24,1392,1702,3094
SIAYA,SIAYA,20-24,8119,9637,17756
SIAYA,SIAYA,25,1491,1986,3477
SIAYA,SIAYA,26,1265,1820,3085
SIAYA,SIAYA,27,1414,1710,3124
SIAYA,SIAYA,28,1160,1384,2544
SIAYA,SIAYA,29,1133,1451,2584
SIAYA,SIAYA,25-29,6463,8351,14814
SIAYA,SIAYA,30,1602,2067,3669
SIAYA,SIAYA,31,1081,1254,2335
SIAYA,SIAYA,32,1373,1790,3163
SIAYA,SIAYA,33,1188,1467,2655
SIAYA,SIAYA,34,1198,1308,2506
SIAYA,SIAYA,30-34,6442,7886,14328
SIAYA,SIAYA,35,1406,1550,2956
SIAYA,SIAYA,36,1074,1109,2183
SIAYA,SIAYA,37,1120,1047,2167
SIAYA,SIAYA,38,804,744,1548
SIAYA,SIAYA,39,948,981,1929
SIAYA,SIAYA,35-39,5352,5431,10783
SIAYA,SIAYA,40,1072,1164,2236
SIAYA,SIAYA,41,975,954,1929
SIAYA,SIAYA,42,914,920,1834
SIAYA,SIAYA,43,791,892,1683
SIAYA,SIAYA,44,679,735,1414
SIAYA,SIAYA,40-44,4431,4665,9096
SIAYA,SIAYA,45,910,978,1888
SIAYA,SIAYA,46,624,773,1397
SIAYA,SIAYA,47,683,762,1445
SIAYA,SIAYA,48,444,550,994
SIAYA,SIAYA,49,510,632,1142
SIAYA,SIAYA,45-49,3171,3695,6866
SIAYA,SIAYA,50,739,1050,1789
SIAYA,SIAYA,51,624,805,1429
SIAYA,SIAYA,52,470,629,1099
SIAYA,SIAYA,53,404,537,941
SIAYA,SIAYA,54,465,620,1085
SIAYA,SIAYA,50-54,2702,3641,6343
SIAYA,SIAYA,55,575,752,1327
SIAYA,SIAYA,56,507,762,1269
SIAYA,SIAYA,57,483,944,1427
SIAYA,SIAYA,58,347,575,922
SIAYA,SIAYA,59,437,631,1068
SIAYA,SIAYA,55-59,2349,3664,6013
SIAYA,SIAYA,60,587,1061,1648
SIAYA,SIAYA,61,403,724,1127
SIAYA,SIAYA,62,416,598,1014
SIAYA,SIAYA,63,402,593,995
SIAYA,SIAYA,64,344,515,859
SIAYA,SIAYA,60-64,2152,3491,5643
SIAYA,SIAYA,65,519,747,1266
SIAYA,SIAYA,66,362,605,967
SIAYA,SIAYA,67,491,848,1339
SIAYA,SIAYA,68,214,334,548
SIAYA,SIAYA,69,340,534,874
SIAYA,SIAYA,65-69,1926,3068,4994
SIAYA,SIAYA,70,530,904,1434
SIAYA,SIAYA,71,309,506,815
SIAYA,SIAYA,72,290,346,636
SIAYA,SIAYA,73,247,340,587
SIAYA,SIAYA,74,234,362,596
SIAYA,SIAYA,70-74,1610,2458,4068
SIAYA,SIAYA,75,193,346,539
SIAYA,SIAYA,76,169,250,419
SIAYA,SIAYA,77,221,397,618
SIAYA,SIAYA,78,103,142,245
SIAYA,SIAYA,79,162,354,516
SIAYA,SIAYA,75-79,848,1489,2337
SIAYA,SIAYA,80,192,387,579
SIAYA,SIAYA,81,108,220,328
SIAYA,SIAYA,82,128,164,292
SIAYA,SIAYA,83,116,168,284
SIAYA,SIAYA,84,96,156,252
SIAYA,SIAYA,80-84,640,1095,1735
SIAYA,SIAYA,85,82,146,228
SIAYA,SIAYA,86,70,98,168
SIAYA,SIAYA,87,74,158,232
SIAYA,SIAYA,88,30,76,106
SIAYA,SIAYA,89,68,181,249
SIAYA,SIAYA,85-89,324,659,983
SIAYA,SIAYA,90,36,91,127
SIAYA,SIAYA,91,34,68,102
SIAYA,SIAYA,92,19,29,48
SIAYA,SIAYA,93,12,28,40
SIAYA,SIAYA,94,13,20,33
SIAYA,SIAYA,90-94,114,236,350
SIAYA,SIAYA,95,7,19,26
SIAYA,SIAYA,96,6,12,18
SIAYA,SIAYA,97,11,15,26
SIAYA,SIAYA,98,5,10,15
SIAYA,SIAYA,99,3,11,14
SIAYA,SIAYA,95-99,32,67,99
SIAYA,SIAYA,100+,7,27,34
SIAYA,SIAYA,Not Stated,5,4,9
SIAYA,GEM,Total,85696,94092,179788
SIAYA,GEM,0,2156,2125,4281
SIAYA,GEM,1,2132,2166,4298
SIAYA,GEM,2,2055,2183,4238
SIAYA,GEM,3,2303,2200,4503
SIAYA,GEM,4,2293,2302,4595
SIAYA,GEM,0 - 4,10939,10976,21915
SIAYA,GEM,5,2409,2309,4718
SIAYA,GEM,6,2567,2524,5091
SIAYA,GEM,7,2433,2413,4846
SIAYA,GEM,8,2405,2424,4829
SIAYA,GEM,9,2642,2634,5276
SIAYA,GEM,05-Sep,12456,12304,24760
SIAYA,GEM,10,2925,2698,5623
SIAYA,GEM,11,2729,2743,5472
SIAYA,GEM,12,2944,2877,5821
SIAYA,GEM,13,2961,2877,5838
SIAYA,GEM,14,2669,2522,5191
SIAYA,GEM,Oct-14,14228,13717,27945
SIAYA,GEM,15,2580,2491,5071
SIAYA,GEM,16,2323,2226,4549
SIAYA,GEM,17,2247,2195,4442
SIAYA,GEM,18,1846,1789,3635
SIAYA,GEM,19,1890,1964,3854
SIAYA,GEM,15-19,10886,10665,21551
SIAYA,GEM,20,1563,1695,3258
SIAYA,GEM,21,1288,1463,2751
SIAYA,GEM,22,1117,1336,2453
SIAYA,GEM,23,1142,1429,2571
SIAYA,GEM,24,965,1319,2284
SIAYA,GEM,20-24,6075,7242,13317
SIAYA,GEM,25,1076,1402,2478
SIAYA,GEM,26,924,1295,2219
SIAYA,GEM,27,1032,1335,2367
SIAYA,GEM,28,774,982,1756
SIAYA,GEM,29,833,1078,1911
SIAYA,GEM,25-29,4639,6092,10731
SIAYA,GEM,30,1117,1571,2688
SIAYA,GEM,31,856,964,1820
SIAYA,GEM,32,1029,1293,2322
SIAYA,GEM,33,926,1085,2011
SIAYA,GEM,34,853,1112,1965
SIAYA,GEM,30-34,4781,6025,10806
SIAYA,GEM,35,1076,1195,2271
SIAYA,GEM,36,828,864,1692
SIAYA,GEM,37,905,870,1775
SIAYA,GEM,38,603,585,1188
SIAYA,GEM,39,736,729,1465
SIAYA,GEM,35-39,4148,4243,8391
SIAYA,GEM,40,895,1025,1920
SIAYA,GEM,41,696,797,1493
SIAYA,GEM,42,756,721,1477
SIAYA,GEM,43,693,737,1430
SIAYA,GEM,44,614,667,1281
SIAYA,GEM,40-44,3654,3947,7601
SIAYA,GEM,45,740,881,1621
SIAYA,GEM,46,567,662,1229
SIAYA,GEM,47,575,702,1277
SIAYA,GEM,48,379,431,810
SIAYA,GEM,49,461,537,998
SIAYA,GEM,45-49,2722,3213,5935
SIAYA,GEM,50,600,831,1431
SIAYA,GEM,51,524,676,1200
SIAYA,GEM,52,405,580,985
SIAYA,GEM,53,364,478,842
SIAYA,GEM,54,400,452,852
SIAYA,GEM,50-54,2293,3017,5310
SIAYA,GEM,55,450,538,988
SIAYA,GEM,56,475,638,1113
SIAYA,GEM,57,490,762,1252
SIAYA,GEM,58,312,450,762
SIAYA,GEM,59,389,547,936
SIAYA,GEM,55-59,2116,2935,5051
SIAYA,GEM,60,553,798,1351
SIAYA,GEM,61,377,555,932
SIAYA,GEM,62,402,484,886
SIAYA,GEM,63,367,495,862
SIAYA,GEM,64,328,399,727
SIAYA,GEM,60-64,2027,2731,4758
SIAYA,GEM,65,377,567,944
SIAYA,GEM,66,334,484,818
SIAYA,GEM,67,452,644,1096
SIAYA,GEM,68,218,252,470
SIAYA,GEM,69,319,412,731
SIAYA,GEM,65-69,1700,2359,4059
SIAYA,GEM,70,406,695,1101
SIAYA,GEM,71,298,360,658
SIAYA,GEM,72,273,284,557
SIAYA,GEM,73,195,282,477
SIAYA,GEM,74,199,270,469
SIAYA,GEM,70-74,1371,1891,3262
SIAYA,GEM,75,169,260,429
SIAYA,GEM,76,154,240,394
SIAYA,GEM,77,180,314,494
SIAYA,GEM,78,86,139,225
SIAYA,GEM,79,126,229,355
SIAYA,GEM,75-79,715,1182,1897
SIAYA,GEM,80,150,304,454
SIAYA,GEM,81,96,169,265
SIAYA,GEM,82,95,136,231
SIAYA,GEM,83,88,129,217
SIAYA,GEM,84,87,128,215
SIAYA,GEM,80-84,516,866,1382
SIAYA,GEM,85,71,123,194
SIAYA,GEM,86,58,74,132
SIAYA,GEM,87,82,111,193
SIAYA,GEM,88,33,49,82
SIAYA,GEM,89,57,116,173
SIAYA,GEM,85-89,301,473,774
SIAYA,GEM,90,30,61,91
SIAYA,GEM,91,19,28,47
SIAYA,GEM,92,17,17,34
SIAYA,GEM,93,10,15,25
SIAYA,GEM,94,8,20,28
SIAYA,GEM,90-94,84,141,225
SIAYA,GEM,95,13,13,26
SIAYA,GEM,96,4,11,15
SIAYA,GEM,97,7,14,21
SIAYA,GEM,98,2,9,11
SIAYA,GEM,99,8,12,20
SIAYA,GEM,95-99,34,59,93
SIAYA,GEM,100+,9,13,22
SIAYA,GEM,Not Stated,2,1,3
SIAYA,UGENYA,Total,62624,71726,134350
SIAYA,UGENYA,0,1459,1507,2966
SIAYA,UGENYA,1,1448,1458,2906
SIAYA,UGENYA,2,1495,1534,3029
SIAYA,UGENYA,3,1718,1728,3446
SIAYA,UGENYA,4,1745,1700,3445
SIAYA,UGENYA,0 - 4,7865,7927,15792
SIAYA,UGENYA,5,1835,1767,3602
SIAYA,UGENYA,6,2032,1967,3999
SIAYA,UGENYA,7,1921,1877,3798
SIAYA,UGENYA,8,1805,1796,3601
SIAYA,UGENYA,9,2065,2071,4136
SIAYA,UGENYA,05-Sep,9658,9478,19136
SIAYA,UGENYA,10,2109,2112,4221
SIAYA,UGENYA,11,2009,1984,3993
SIAYA,UGENYA,12,2351,2211,4562
SIAYA,UGENYA,13,2169,2124,4293
SIAYA,UGENYA,14,2030,2008,4038
SIAYA,UGENYA,Oct-14,10668,10439,21107
SIAYA,UGENYA,15,2019,1914,3933
SIAYA,UGENYA,16,1882,1782,3664
SIAYA,UGENYA,17,1904,1691,3595
SIAYA,UGENYA,18,1438,1335,2773
SIAYA,UGENYA,19,1439,1458,2897
SIAYA,UGENYA,15-19,8682,8180,16862
SIAYA,UGENYA,20,1172,1293,2465
SIAYA,UGENYA,21,961,1040,2001
SIAYA,UGENYA,22,827,1032,1859
SIAYA,UGENYA,23,736,1037,1773
SIAYA,UGENYA,24,680,900,1580
SIAYA,UGENYA,20-24,4376,5302,9678
SIAYA,UGENYA,25,766,1036,1802
SIAYA,UGENYA,26,667,916,1583
SIAYA,UGENYA,27,689,962,1651
SIAYA,UGENYA,28,522,707,1229
SIAYA,UGENYA,29,551,712,1263
SIAYA,UGENYA,25-29,3195,4333,7528
SIAYA,UGENYA,30,798,1087,1885
SIAYA,UGENYA,31,569,772,1341
SIAYA,UGENYA,32,722,1012,1734
SIAYA,UGENYA,33,611,812,1423
SIAYA,UGENYA,34,668,794,1462
SIAYA,UGENYA,30-34,3368,4477,7845
SIAYA,UGENYA,35,674,930,1604
SIAYA,UGENYA,36,485,647,1132
SIAYA,UGENYA,37,611,664,1275
SIAYA,UGENYA,38,377,436,813
SIAYA,UGENYA,39,481,584,1065
SIAYA,UGENYA,35-39,2628,3261,5889
SIAYA,UGENYA,40,601,790,1391
SIAYA,UGENYA,41,542,648,1190
SIAYA,UGENYA,42,539,608,1147
SIAYA,UGENYA,43,427,547,974
SIAYA,UGENYA,44,389,453,842
SIAYA,UGENYA,40-44,2498,3046,5544
SIAYA,UGENYA,45,533,623,1156
SIAYA,UGENYA,46,399,473,872
SIAYA,UGENYA,47,432,530,962
SIAYA,UGENYA,48,277,399,676
SIAYA,UGENYA,49,295,391,686
SIAYA,UGENYA,45-49,1936,2416,4352
SIAYA,UGENYA,50,451,730,1181
SIAYA,UGENYA,51,326,563,889
SIAYA,UGENYA,52,275,422,697
SIAYA,UGENYA,53,247,354,601
SIAYA,UGENYA,54,304,355,659
SIAYA,UGENYA,50-54,1603,2424,4027
SIAYA,UGENYA,55,323,404,727
SIAYA,UGENYA,56,310,503,813
SIAYA,UGENYA,57,333,640,973
SIAYA,UGENYA,58,232,332,564
SIAYA,UGENYA,59,258,484,742
SIAYA,UGENYA,55-59,1456,2363,3819
SIAYA,UGENYA,60,342,641,983
SIAYA,UGENYA,61,284,454,738
SIAYA,UGENYA,62,248,370,618
SIAYA,UGENYA,63,224,399,623
SIAYA,UGENYA,64,188,362,550
SIAYA,UGENYA,60-64,1286,2226,3512
SIAYA,UGENYA,65,269,473,742
SIAYA,UGENYA,66,225,351,576
SIAYA,UGENYA,67,346,533,879
SIAYA,UGENYA,68,109,189,298
SIAYA,UGENYA,69,211,338,549
SIAYA,UGENYA,65-69,1160,1884,3044
SIAYA,UGENYA,70,287,611,898
SIAYA,UGENYA,71,191,315,506
SIAYA,UGENYA,72,200,244,444
SIAYA,UGENYA,73,135,205,340
SIAYA,UGENYA,74,139,235,374
SIAYA,UGENYA,70-74,952,1610,2562
SIAYA,UGENYA,75,102,219,321
SIAYA,UGENYA,76,103,170,273
SIAYA,UGENYA,77,129,274,403
SIAYA,UGENYA,78,75,131,206
SIAYA,UGENYA,79,83,218,301
SIAYA,UGENYA,75-79,492,1012,1504
SIAYA,UGENYA,80,125,264,389
SIAYA,UGENYA,81,93,152,245
SIAYA,UGENYA,82,80,105,185
SIAYA,UGENYA,83,72,108,180
SIAYA,UGENYA,84,68,105,173
SIAYA,UGENYA,80-84,438,734,1172
SIAYA,UGENYA,85,69,119,188
SIAYA,UGENYA,86,46,49,95
SIAYA,UGENYA,87,65,92,157
SIAYA,UGENYA,88,28,48,76
SIAYA,UGENYA,89,41,112,153
SIAYA,UGENYA,85-89,249,420,669
SIAYA,UGENYA,90,23,38,61
SIAYA,UGENYA,91,23,38,61
SIAYA,UGENYA,92,10,20,30
SIAYA,UGENYA,93,8,19,27
SIAYA,UGENYA,94,10,13,23
SIAYA,UGENYA,90-94,74,128,202
SIAYA,UGENYA,95,16,16,32
SIAYA,UGENYA,96,7,7,14
SIAYA,UGENYA,97,2,4,6
SIAYA,UGENYA,98,2,9,11
SIAYA,UGENYA,99,3,10,13
SIAYA,UGENYA,95-99,30,46,76
SIAYA,UGENYA,100+,9,19,28
SIAYA,UGENYA,Not Stated,1,1,2
SIAYA,UGUNJA,Total,48912,55329,104241
SIAYA,UGUNJA,0,1160,1128,2288
SIAYA,UGUNJA,1,1229,1170,2399
SIAYA,UGUNJA,2,1124,1215,2339
SIAYA,UGUNJA,3,1249,1252,2501
SIAYA,UGUNJA,4,1341,1342,2683
SIAYA,UGUNJA,0 - 4,6103,6107,12210
SIAYA,UGUNJA,5,1433,1387,2820
SIAYA,UGUNJA,6,1380,1485,2865
SIAYA,UGUNJA,7,1373,1479,2852
SIAYA,UGUNJA,8,1323,1509,2832
SIAYA,UGUNJA,9,1574,1572,3146
SIAYA,UGUNJA,05-Sep,7083,7432,14515
SIAYA,UGUNJA,10,1647,1629,3276
SIAYA,UGUNJA,11,1512,1562,3074
SIAYA,UGUNJA,12,1732,1692,3424
SIAYA,UGUNJA,13,1676,1692,3368
SIAYA,UGUNJA,14,1593,1489,3082
SIAYA,UGUNJA,Oct-14,8160,8064,16224
SIAYA,UGUNJA,15,1546,1488,3034
SIAYA,UGUNJA,16,1322,1345,2667
SIAYA,UGUNJA,17,1395,1299,2694
SIAYA,UGUNJA,18,1085,1054,2139
SIAYA,UGUNJA,19,1103,994,2097
SIAYA,UGUNJA,15-19,6451,6180,12631
SIAYA,UGUNJA,20,901,955,1856
SIAYA,UGUNJA,21,769,786,1555
SIAYA,UGUNJA,22,697,829,1526
SIAYA,UGUNJA,23,655,847,1502
SIAYA,UGUNJA,24,602,805,1407
SIAYA,UGUNJA,20-24,3624,4222,7846
SIAYA,UGUNJA,25,658,842,1500
SIAYA,UGUNJA,26,552,792,1344
SIAYA,UGUNJA,27,623,777,1400
SIAYA,UGUNJA,28,473,598,1071
SIAYA,UGUNJA,29,478,699,1177
SIAYA,UGUNJA,25-29,2784,3708,6492
SIAYA,UGUNJA,30,644,970,1614
SIAYA,UGUNJA,31,517,602,1119
SIAYA,UGUNJA,32,639,795,1434
SIAYA,UGUNJA,33,523,694,1217
SIAYA,UGUNJA,34,505,656,1161
SIAYA,UGUNJA,30-34,2828,3717,6545
SIAYA,UGUNJA,35,636,728,1364
SIAYA,UGUNJA,36,470,504,974
SIAYA,UGUNJA,37,476,537,1013
SIAYA,UGUNJA,38,355,385,740
SIAYA,UGUNJA,39,387,475,862
SIAYA,UGUNJA,35-39,2324,2629,4953
SIAYA,UGUNJA,40,519,569,1088
SIAYA,UGUNJA,41,471,464,935
SIAYA,UGUNJA,42,415,430,845
SIAYA,UGUNJA,43,395,439,834
SIAYA,UGUNJA,44,316,361,677
SIAYA,UGUNJA,40-44,2116,2263,4379
SIAYA,UGUNJA,45,425,454,879
SIAYA,UGUNJA,46,321,361,682
SIAYA,UGUNJA,47,330,368,698
SIAYA,UGUNJA,48,224,288,512
SIAYA,UGUNJA,49,254,310,564
SIAYA,UGUNJA,45-49,1554,1781,3335
SIAYA,UGUNJA,50,316,491,807
SIAYA,UGUNJA,51,266,390,656
SIAYA,UGUNJA,52,208,269,477
SIAYA,UGUNJA,53,188,260,448
SIAYA,UGUNJA,54,222,287,509
SIAYA,UGUNJA,50-54,1200,1697,2897
SIAYA,UGUNJA,55,241,332,573
SIAYA,UGUNJA,56,263,434,697
SIAYA,UGUNJA,57,244,437,681
SIAYA,UGUNJA,58,165,243,408
SIAYA,UGUNJA,59,211,331,542
SIAYA,UGUNJA,55-59,1124,1777,2901
SIAYA,UGUNJA,60,269,424,693
SIAYA,UGUNJA,61,208,309,517
SIAYA,UGUNJA,62,201,261,462
SIAYA,UGUNJA,63,177,306,483
SIAYA,UGUNJA,64,152,252,404
SIAYA,UGUNJA,60-64,1007,1552,2559
SIAYA,UGUNJA,65,212,351,563
SIAYA,UGUNJA,66,156,260,416
SIAYA,UGUNJA,67,216,394,610
SIAYA,UGUNJA,68,98,133,231
SIAYA,UGUNJA,69,171,242,413
SIAYA,UGUNJA,65-69,853,1380,2233
SIAYA,UGUNJA,70,204,396,600
SIAYA,UGUNJA,71,161,234,395
SIAYA,UGUNJA,72,128,195,323
SIAYA,UGUNJA,73,110,148,258
SIAYA,UGUNJA,74,126,170,296
SIAYA,UGUNJA,70-74,729,1143,1872
SIAYA,UGUNJA,75,82,162,244
SIAYA,UGUNJA,76,82,148,230
SIAYA,UGUNJA,77,127,196,323
SIAYA,UGUNJA,78,47,61,108
SIAYA,UGUNJA,79,65,158,223
SIAYA,UGUNJA,75-79,403,725,1128
SIAYA,UGUNJA,80,101,169,270
SIAYA,UGUNJA,81,56,106,162
SIAYA,UGUNJA,82,59,103,162
SIAYA,UGUNJA,83,44,83,127
SIAYA,UGUNJA,84,55,63,118
SIAYA,UGUNJA,80-84,315,524,839
SIAYA,UGUNJA,85,37,86,123
SIAYA,UGUNJA,86,30,57,87
SIAYA,UGUNJA,87,47,62,109
SIAYA,UGUNJA,88,23,36,59
SIAYA,UGUNJA,89,31,69,100
SIAYA,UGUNJA,85-89,168,310,478
SIAYA,UGUNJA,90,21,34,55
SIAYA,UGUNJA,91,13,16,29
SIAYA,UGUNJA,92,13,11,24
SIAYA,UGUNJA,93,11,7,18
SIAYA,UGUNJA,94,6,7,13
SIAYA,UGUNJA,90-94,64,75,139
SIAYA,UGUNJA,95,9,12,21
SIAYA,UGUNJA,96,1,2,3
SIAYA,UGUNJA,97,2,6,8
SIAYA,UGUNJA,98,1,5,6
SIAYA,UGUNJA,99,3,9,12
SIAYA,UGUNJA,95-99,16,34,50
SIAYA,UGUNJA,100+,5,9,14
SIAYA,UGUNJA,Not Stated,1,-,1
SIAYA,BONDO,Total,95962,101917,197879
SIAYA,BONDO,0,2500,2634,5134
SIAYA,BONDO,1,2477,2388,4865
SIAYA,BONDO,2,2511,2549,5060
SIAYA,BONDO,3,2747,2647,5394
SIAYA,BONDO,4,2542,2630,5172
SIAYA,BONDO,0 - 4,12777,12848,25625
SIAYA,BONDO,5,2689,2670,5359
SIAYA,BONDO,6,2805,2751,5556
SIAYA,BONDO,7,2725,2740,5465
SIAYA,BONDO,8,2443,2635,5078
SIAYA,BONDO,9,2753,2675,5428
SIAYA,BONDO,05-Sep,13415,13471,26886
SIAYA,BONDO,10,3019,2931,5950
SIAYA,BONDO,11,2788,2741,5529
SIAYA,BONDO,12,3003,3145,6148
SIAYA,BONDO,13,2897,3055,5952
SIAYA,BONDO,14,2618,2647,5265
SIAYA,BONDO,Oct-14,14325,14519,28844
SIAYA,BONDO,15,2490,2560,5050
SIAYA,BONDO,16,2282,2304,4586
SIAYA,BONDO,17,2323,2286,4609
SIAYA,BONDO,18,1869,1891,3760
SIAYA,BONDO,19,2121,2196,4317
SIAYA,BONDO,15-19,11085,11237,22322
SIAYA,BONDO,20,1920,2193,4113
SIAYA,BONDO,21,1769,2019,3788
SIAYA,BONDO,22,1628,2005,3633
SIAYA,BONDO,23,1722,2069,3791
SIAYA,BONDO,24,1694,1908,3602
SIAYA,BONDO,20-24,8733,10194,18927
SIAYA,BONDO,25,1848,2087,3935
SIAYA,BONDO,26,1532,1834,3366
SIAYA,BONDO,27,1655,1787,3442
SIAYA,BONDO,28,1172,1349,2521
SIAYA,BONDO,29,1238,1463,2701
SIAYA,BONDO,25-29,7445,8520,15965
SIAYA,BONDO,30,1782,2087,3869
SIAYA,BONDO,31,1212,1314,2526
SIAYA,BONDO,32,1568,1876,3444
SIAYA,BONDO,33,1377,1611,2988
SIAYA,BONDO,34,1314,1316,2630
SIAYA,BONDO,30-34,7253,8204,15457
SIAYA,BONDO,35,1573,1361,2934
SIAYA,BONDO,36,1116,897,2013
SIAYA,BONDO,37,1137,960,2097
SIAYA,BONDO,38,813,615,1428
SIAYA,BONDO,39,1013,772,1785
SIAYA,BONDO,35-39,5652,4605,10257
SIAYA,BONDO,40,1102,1092,2194
SIAYA,BONDO,41,953,782,1735
SIAYA,BONDO,42,822,732,1554
SIAYA,BONDO,43,818,683,1501
SIAYA,BONDO,44,619,617,1236
SIAYA,BONDO,40-44,4314,3906,8220
SIAYA,BONDO,45,805,803,1608
SIAYA,BONDO,46,550,561,1111
SIAYA,BONDO,47,603,597,1200
SIAYA,BONDO,48,362,342,704
SIAYA,BONDO,49,434,467,901
SIAYA,BONDO,45-49,2754,2770,5524
SIAYA,BONDO,50,533,688,1221
SIAYA,BONDO,51,410,541,951
SIAYA,BONDO,52,384,441,825
SIAYA,BONDO,53,282,347,629
SIAYA,BONDO,54,356,405,761
SIAYA,BONDO,50-54,1965,2422,4387
SIAYA,BONDO,55,356,451,807
SIAYA,BONDO,56,349,468,817
SIAYA,BONDO,57,371,569,940
SIAYA,BONDO,58,263,328,591
SIAYA,BONDO,59,301,452,753
SIAYA,BONDO,55-59,1640,2268,3908
SIAYA,BONDO,60,415,605,1020
SIAYA,BONDO,61,294,410,704
SIAYA,BONDO,62,254,374,628
SIAYA,BONDO,63,284,377,661
SIAYA,BONDO,64,225,296,521
SIAYA,BONDO,60-64,1472,2062,3534
SIAYA,BONDO,65,319,398,717
SIAYA,BONDO,66,237,356,593
SIAYA,BONDO,67,277,487,764
SIAYA,BONDO,68,154,187,341
SIAYA,BONDO,69,220,277,497
SIAYA,BONDO,65-69,1207,1705,2912
SIAYA,BONDO,70,283,446,729
SIAYA,BONDO,71,195,269,464
SIAYA,BONDO,72,175,224,399
SIAYA,BONDO,73,134,193,327
SIAYA,BONDO,74,117,210,327
SIAYA,BONDO,70-74,904,1342,2246
SIAYA,BONDO,75,105,154,259
SIAYA,BONDO,76,85,141,226
SIAYA,BONDO,77,127,188,315
SIAYA,BONDO,78,44,96,140
SIAYA,BONDO,79,74,150,224
SIAYA,BONDO,75-79,435,729,1164
SIAYA,BONDO,80,91,193,284
SIAYA,BONDO,81,57,119,176
SIAYA,BONDO,82,65,90,155
SIAYA,BONDO,83,68,105,173
SIAYA,BONDO,84,34,75,109
SIAYA,BONDO,80-84,315,582,897
SIAYA,BONDO,85,30,69,99
SIAYA,BONDO,86,22,63,85
SIAYA,BONDO,87,54,91,145
SIAYA,BONDO,88,27,40,67
SIAYA,BONDO,89,29,82,111
SIAYA,BONDO,85-89,162,345,507
SIAYA,BONDO,90,26,34,60
SIAYA,BONDO,91,22,34,56
SIAYA,BONDO,92,9,17,26
SIAYA,BONDO,93,11,13,24
SIAYA,BONDO,94,8,17,25
SIAYA,BONDO,90-94,76,115,191
SIAYA,BONDO,95,11,14,25
SIAYA,BONDO,96,5,7,12
SIAYA,BONDO,97,4,9,13
SIAYA,BONDO,98,2,6,8
SIAYA,BONDO,99,1,10,11
SIAYA,BONDO,95-99,23,46,69
SIAYA,BONDO,100+,6,25,31
SIAYA,BONDO,Not Stated,4,2,6
SIAYA,RARIEDA,Total,72569,79999,152568
SIAYA,RARIEDA,0,1641,1767,3408
SIAYA,RARIEDA,1,1760,1767,3527
SIAYA,RARIEDA,2,1838,1824,3662
SIAYA,RARIEDA,3,1960,2116,4076
SIAYA,RARIEDA,4,2092,1907,3999
SIAYA,RARIEDA,0 - 4,9291,9381,18672
SIAYA,RARIEDA,5,2058,1949,4007
SIAYA,RARIEDA,6,2153,2200,4353
SIAYA,RARIEDA,7,2079,2217,4296
SIAYA,RARIEDA,8,1922,2008,3930
SIAYA,RARIEDA,9,2289,2238,4527
SIAYA,RARIEDA,05-Sep,10501,10612,21113
SIAYA,RARIEDA,10,2465,2371,4836
SIAYA,RARIEDA,11,2191,2256,4447
SIAYA,RARIEDA,12,2562,2469,5031
SIAYA,RARIEDA,13,2486,2395,4881
SIAYA,RARIEDA,14,2209,2162,4371
SIAYA,RARIEDA,Oct-14,11913,11653,23566
SIAYA,RARIEDA,15,2261,2096,4357
SIAYA,RARIEDA,16,1886,1975,3861
SIAYA,RARIEDA,17,1999,1816,3815
SIAYA,RARIEDA,18,1535,1516,3051
SIAYA,RARIEDA,19,1579,1597,3176
SIAYA,RARIEDA,15-19,9260,9000,18260
SIAYA,RARIEDA,20,1373,1510,2883
SIAYA,RARIEDA,21,1173,1247,2420
SIAYA,RARIEDA,22,1053,1300,2353
SIAYA,RARIEDA,23,1000,1346,2346
SIAYA,RARIEDA,24,886,1237,2123
SIAYA,RARIEDA,20-24,5485,6640,12125
SIAYA,RARIEDA,25,1058,1312,2370
SIAYA,RARIEDA,26,890,1148,2038
SIAYA,RARIEDA,27,948,1230,2178
SIAYA,RARIEDA,28,679,823,1502
SIAYA,RARIEDA,29,709,979,1688
SIAYA,RARIEDA,25-29,4284,5492,9776
SIAYA,RARIEDA,30,1052,1469,2521
SIAYA,RARIEDA,31,754,907,1661
SIAYA,RARIEDA,32,976,1224,2200
SIAYA,RARIEDA,33,924,1204,2128
SIAYA,RARIEDA,34,854,976,1830
SIAYA,RARIEDA,30-34,4560,5780,10340
SIAYA,RARIEDA,35,1065,1083,2148
SIAYA,RARIEDA,36,732,734,1466
SIAYA,RARIEDA,37,840,675,1515
SIAYA,RARIEDA,38,531,424,955
SIAYA,RARIEDA,39,644,568,1212
SIAYA,RARIEDA,35-39,3812,3484,7296
SIAYA,RARIEDA,40,769,752,1521
SIAYA,RARIEDA,41,657,633,1290
SIAYA,RARIEDA,42,605,564,1169
SIAYA,RARIEDA,43,629,666,1295
SIAYA,RARIEDA,44,470,572,1042
SIAYA,RARIEDA,40-44,3130,3187,6317
SIAYA,RARIEDA,45,607,728,1335
SIAYA,RARIEDA,46,441,517,958
SIAYA,RARIEDA,47,481,512,993
SIAYA,RARIEDA,48,279,294,573
SIAYA,RARIEDA,49,309,379,688
SIAYA,RARIEDA,45-49,2117,2430,4547
SIAYA,RARIEDA,50,415,605,1020
SIAYA,RARIEDA,51,412,561,973
SIAYA,RARIEDA,52,270,360,630
SIAYA,RARIEDA,53,245,355,600
SIAYA,RARIEDA,54,295,420,715
SIAYA,RARIEDA,50-54,1637,2301,3938
SIAYA,RARIEDA,55,358,429,787
SIAYA,RARIEDA,56,298,487,785
SIAYA,RARIEDA,57,333,586,919
SIAYA,RARIEDA,58,242,286,528
SIAYA,RARIEDA,59,319,416,735
SIAYA,RARIEDA,55-59,1550,2204,3754
SIAYA,RARIEDA,60,431,684,1115
SIAYA,RARIEDA,61,334,443,777
SIAYA,RARIEDA,62,259,370,629
SIAYA,RARIEDA,63,254,418,672
SIAYA,RARIEDA,64,228,342,570
SIAYA,RARIEDA,60-64,1506,2257,3763
SIAYA,RARIEDA,65,286,413,699
SIAYA,RARIEDA,66,252,413,665
SIAYA,RARIEDA,67,341,545,886
SIAYA,RARIEDA,68,135,193,328
SIAYA,RARIEDA,69,241,281,522
SIAYA,RARIEDA,65-69,1255,1845,3100
SIAYA,RARIEDA,70,309,533,842
SIAYA,RARIEDA,71,256,277,533
SIAYA,RARIEDA,72,199,237,436
SIAYA,RARIEDA,73,183,200,383
SIAYA,RARIEDA,74,156,206,362
SIAYA,RARIEDA,70-74,1103,1453,2556
SIAYA,RARIEDA,75,109,197,306
SIAYA,RARIEDA,76,111,159,270
SIAYA,RARIEDA,77,113,252,365
SIAYA,RARIEDA,78,71,107,178
SIAYA,RARIEDA,79,86,206,292
SIAYA,RARIEDA,75-79,490,921,1411
SIAYA,RARIEDA,80,96,203,299
SIAYA,RARIEDA,81,65,141,206
SIAYA,RARIEDA,82,76,120,196
SIAYA,RARIEDA,83,80,118,198
SIAYA,RARIEDA,84,56,109,165
SIAYA,RARIEDA,80-84,373,691,1064
SIAYA,RARIEDA,85,43,121,164
SIAYA,RARIEDA,86,36,67,103
SIAYA,RARIEDA,87,59,110,169
SIAYA,RARIEDA,88,21,52,73
SIAYA,RARIEDA,89,35,84,119
SIAYA,RARIEDA,85-89,194,434,628
SIAYA,RARIEDA,90,27,61,88
SIAYA,RARIEDA,91,16,34,50
SIAYA,RARIEDA,92,9,23,32
SIAYA,RARIEDA,93,10,20,30
SIAYA,RARIEDA,94,12,17,29
SIAYA,RARIEDA,90-94,74,155,229
SIAYA,RARIEDA,95,9,23,32
SIAYA,RARIEDA,96,4,12,16
SIAYA,RARIEDA,97,2,6,8
SIAYA,RARIEDA,98,3,5,8
SIAYA,RARIEDA,99,8,9,17
SIAYA,RARIEDA,95-99,26,55,81
SIAYA,RARIEDA,100+,7,22,29
SIAYA,RARIEDA,Not Stated,1,2,3
TAITA/ TAVETA,ALL,Total,173337,167327,340664
TAITA/ TAVETA,ALL,0,3853,3895,7748
TAITA/ TAVETA,ALL,1,3918,3958,7876
TAITA/ TAVETA,ALL,2,3823,3804,7627
TAITA/ TAVETA,ALL,3,3939,3850,7789
TAITA/ TAVETA,ALL,4,3856,3793,7649
TAITA/ TAVETA,ALL,0 - 4,19389,19300,38689
TAITA/ TAVETA,ALL,5,3797,3689,7486
TAITA/ TAVETA,ALL,6,3627,3637,7264
TAITA/ TAVETA,ALL,7,3661,3640,7301
TAITA/ TAVETA,ALL,8,3744,3660,7404
TAITA/ TAVETA,ALL,9,3913,3995,7908
TAITA/ TAVETA,ALL,05-Sep,18742,18621,37363
TAITA/ TAVETA,ALL,10,3932,3894,7826
TAITA/ TAVETA,ALL,11,3952,3956,7908
TAITA/ TAVETA,ALL,12,4186,3942,8128
TAITA/ TAVETA,ALL,13,4108,4131,8239
TAITA/ TAVETA,ALL,14,3981,3748,7729
TAITA/ TAVETA,ALL,Oct-14,20159,19671,39830
TAITA/ TAVETA,ALL,15,3707,3642,7349
TAITA/ TAVETA,ALL,16,3623,3564,7187
TAITA/ TAVETA,ALL,17,3946,3562,7508
TAITA/ TAVETA,ALL,18,3325,2984,6309
TAITA/ TAVETA,ALL,19,3278,3195,6473
TAITA/ TAVETA,ALL,15-19,17879,16947,34826
TAITA/ TAVETA,ALL,20,3277,3206,6483
TAITA/ TAVETA,ALL,21,2823,2668,5491
TAITA/ TAVETA,ALL,22,2888,2847,5735
TAITA/ TAVETA,ALL,23,3009,2943,5952
TAITA/ TAVETA,ALL,24,2762,2792,5554
TAITA/ TAVETA,ALL,20-24,14759,14456,29215
TAITA/ TAVETA,ALL,25,3035,2774,5809
TAITA/ TAVETA,ALL,26,2532,2495,5027
TAITA/ TAVETA,ALL,27,2673,2625,5298
TAITA/ TAVETA,ALL,28,2433,2355,4788
TAITA/ TAVETA,ALL,29,2674,2561,5235
TAITA/ TAVETA,ALL,25-29,13347,12810,26157
TAITA/ TAVETA,ALL,30,3085,2840,5925
TAITA/ TAVETA,ALL,31,2373,2228,4601
TAITA/ TAVETA,ALL,32,2879,2597,5476
TAITA/ TAVETA,ALL,33,2299,2277,4576
TAITA/ TAVETA,ALL,34,2287,2018,4305
TAITA/ TAVETA,ALL,30-34,12923,11960,24883
TAITA/ TAVETA,ALL,35,2875,2487,5362
TAITA/ TAVETA,ALL,36,2353,2060,4413
TAITA/ TAVETA,ALL,37,2324,2003,4327
TAITA/ TAVETA,ALL,38,1919,1679,3598
TAITA/ TAVETA,ALL,39,2183,1932,4115
TAITA/ TAVETA,ALL,35-39,11654,10161,21815
TAITA/ TAVETA,ALL,40,2429,2063,4492
TAITA/ TAVETA,ALL,41,2136,1798,3934
TAITA/ TAVETA,ALL,42,2057,1728,3785
TAITA/ TAVETA,ALL,43,1827,1565,3392
TAITA/ TAVETA,ALL,44,1678,1460,3138
TAITA/ TAVETA,ALL,40-44,10127,8614,18741
TAITA/ TAVETA,ALL,45,2253,1878,4131
TAITA/ TAVETA,ALL,46,1714,1533,3247
TAITA/ TAVETA,ALL,47,1833,1657,3490
TAITA/ TAVETA,ALL,48,1382,1239,2621
TAITA/ TAVETA,ALL,49,1544,1422,2966
TAITA/ TAVETA,ALL,45-49,8726,7729,16455
TAITA/ TAVETA,ALL,50,1870,1560,3430
TAITA/ TAVETA,ALL,51,1361,1154,2515
TAITA/ TAVETA,ALL,52,1249,1080,2329
TAITA/ TAVETA,ALL,53,1064,926,1990
TAITA/ TAVETA,ALL,54,1228,1142,2370
TAITA/ TAVETA,ALL,50-54,6772,5862,12634
TAITA/ TAVETA,ALL,55,1222,1083,2305
TAITA/ TAVETA,ALL,56,1326,1172,2498
TAITA/ TAVETA,ALL,57,1135,1448,2583
TAITA/ TAVETA,ALL,58,838,966,1804
TAITA/ TAVETA,ALL,59,1011,1046,2057
TAITA/ TAVETA,ALL,55-59,5532,5715,11247
TAITA/ TAVETA,ALL,60,1148,1298,2446
TAITA/ TAVETA,ALL,61,904,935,1839
TAITA/ TAVETA,ALL,62,909,883,1792
TAITA/ TAVETA,ALL,63,844,823,1667
TAITA/ TAVETA,ALL,64,688,645,1333
TAITA/ TAVETA,ALL,60-64,4493,4584,9077
TAITA/ TAVETA,ALL,65,883,1028,1911
TAITA/ TAVETA,ALL,66,706,676,1382
TAITA/ TAVETA,ALL,67,858,785,1643
TAITA/ TAVETA,ALL,68,513,404,917
TAITA/ TAVETA,ALL,69,632,742,1374
TAITA/ TAVETA,ALL,65-69,3592,3635,7227
TAITA/ TAVETA,ALL,70,669,1062,1731
TAITA/ TAVETA,ALL,71,495,549,1044
TAITA/ TAVETA,ALL,72,449,392,841
TAITA/ TAVETA,ALL,73,376,370,746
TAITA/ TAVETA,ALL,74,364,494,858
TAITA/ TAVETA,ALL,70-74,2353,2867,5220
TAITA/ TAVETA,ALL,75,317,394,711
TAITA/ TAVETA,ALL,76,239,283,522
TAITA/ TAVETA,ALL,77,323,340,663
TAITA/ TAVETA,ALL,78,191,212,403
TAITA/ TAVETA,ALL,79,255,406,661
TAITA/ TAVETA,ALL,75-79,1325,1635,2960
TAITA/ TAVETA,ALL,80,283,446,729
TAITA/ TAVETA,ALL,81,168,253,421
TAITA/ TAVETA,ALL,82,134,169,303
TAITA/ TAVETA,ALL,83,156,224,380
TAITA/ TAVETA,ALL,84,119,217,336
TAITA/ TAVETA,ALL,80-84,860,1309,2169
TAITA/ TAVETA,ALL,85,115,193,308
TAITA/ TAVETA,ALL,86,81,97,178
TAITA/ TAVETA,ALL,87,80,183,263
TAITA/ TAVETA,ALL,88,60,85,145
TAITA/ TAVETA,ALL,89,85,279,364
TAITA/ TAVETA,ALL,85-89,421,837,1258
TAITA/ TAVETA,ALL,90,53,135,188
TAITA/ TAVETA,ALL,91,36,78,114
TAITA/ TAVETA,ALL,92,30,33,63
TAITA/ TAVETA,ALL,93,26,43,69
TAITA/ TAVETA,ALL,94,17,48,65
TAITA/ TAVETA,ALL,90-94,162,337,499
TAITA/ TAVETA,ALL,95,23,45,68
TAITA/ TAVETA,ALL,96,10,27,37
TAITA/ TAVETA,ALL,97,19,26,45
TAITA/ TAVETA,ALL,98,8,29,37
TAITA/ TAVETA,ALL,99,19,63,82
TAITA/ TAVETA,ALL,95-99,79,190,269
TAITA/ TAVETA,ALL,100+,41,86,127
TAITA/ TAVETA,ALL,Not Stated,2,1,3
TAITA/ TAVETA,MWATATE,Total,41426,40231,81657
TAITA/ TAVETA,MWATATE,0,842,976,1818
TAITA/ TAVETA,MWATATE,1,897,898,1795
TAITA/ TAVETA,MWATATE,2,873,831,1704
TAITA/ TAVETA,MWATATE,3,917,888,1805
TAITA/ TAVETA,MWATATE,4,902,884,1786
TAITA/ TAVETA,MWATATE,0 - 4,4431,4477,8908
TAITA/ TAVETA,MWATATE,5,884,889,1773
TAITA/ TAVETA,MWATATE,6,851,856,1707
TAITA/ TAVETA,MWATATE,7,915,874,1789
TAITA/ TAVETA,MWATATE,8,900,874,1774
TAITA/ TAVETA,MWATATE,9,902,931,1833
TAITA/ TAVETA,MWATATE,05-Sep,4452,4424,8876
TAITA/ TAVETA,MWATATE,10,980,969,1949
TAITA/ TAVETA,MWATATE,11,972,949,1921
TAITA/ TAVETA,MWATATE,12,1001,999,2000
TAITA/ TAVETA,MWATATE,13,1045,1010,2055
TAITA/ TAVETA,MWATATE,14,979,920,1899
TAITA/ TAVETA,MWATATE,Oct-14,4977,4847,9824
TAITA/ TAVETA,MWATATE,15,895,876,1771
TAITA/ TAVETA,MWATATE,16,908,870,1778
TAITA/ TAVETA,MWATATE,17,1007,893,1900
TAITA/ TAVETA,MWATATE,18,848,723,1571
TAITA/ TAVETA,MWATATE,19,764,740,1504
TAITA/ TAVETA,MWATATE,15-19,4422,4102,8524
TAITA/ TAVETA,MWATATE,20,814,688,1502
TAITA/ TAVETA,MWATATE,21,696,577,1273
TAITA/ TAVETA,MWATATE,22,738,602,1340
TAITA/ TAVETA,MWATATE,23,723,600,1323
TAITA/ TAVETA,MWATATE,24,628,558,1186
TAITA/ TAVETA,MWATATE,20-24,3599,3025,6624
TAITA/ TAVETA,MWATATE,25,578,546,1124
TAITA/ TAVETA,MWATATE,26,504,520,1024
TAITA/ TAVETA,MWATATE,27,550,524,1074
TAITA/ TAVETA,MWATATE,28,484,547,1031
TAITA/ TAVETA,MWATATE,29,561,517,1078
TAITA/ TAVETA,MWATATE,25-29,2677,2654,5331
TAITA/ TAVETA,MWATATE,30,599,580,1179
TAITA/ TAVETA,MWATATE,31,511,468,979
TAITA/ TAVETA,MWATATE,32,636,545,1181
TAITA/ TAVETA,MWATATE,33,510,510,1020
TAITA/ TAVETA,MWATATE,34,559,452,1011
TAITA/ TAVETA,MWATATE,30-34,2815,2555,5370
TAITA/ TAVETA,MWATATE,35,607,579,1186
TAITA/ TAVETA,MWATATE,36,535,490,1025
TAITA/ TAVETA,MWATATE,37,480,494,974
TAITA/ TAVETA,MWATATE,38,437,407,844
TAITA/ TAVETA,MWATATE,39,505,431,936
TAITA/ TAVETA,MWATATE,35-39,2564,2401,4965
TAITA/ TAVETA,MWATATE,40,575,502,1077
TAITA/ TAVETA,MWATATE,41,475,455,930
TAITA/ TAVETA,MWATATE,42,494,429,923
TAITA/ TAVETA,MWATATE,43,436,374,810
TAITA/ TAVETA,MWATATE,44,408,352,760
TAITA/ TAVETA,MWATATE,40-44,2388,2112,4500
TAITA/ TAVETA,MWATATE,45,544,422,966
TAITA/ TAVETA,MWATATE,46,448,365,813
TAITA/ TAVETA,MWATATE,47,443,409,852
TAITA/ TAVETA,MWATATE,48,339,352,691
TAITA/ TAVETA,MWATATE,49,376,363,739
TAITA/ TAVETA,MWATATE,45-49,2150,1911,4061
TAITA/ TAVETA,MWATATE,50,505,406,911
TAITA/ TAVETA,MWATATE,51,325,287,612
TAITA/ TAVETA,MWATATE,52,304,291,595
TAITA/ TAVETA,MWATATE,53,280,280,560
TAITA/ TAVETA,MWATATE,54,350,311,661
TAITA/ TAVETA,MWATATE,50-54,1764,1575,3339
TAITA/ TAVETA,MWATATE,55,291,292,583
TAITA/ TAVETA,MWATATE,56,348,320,668
TAITA/ TAVETA,MWATATE,57,294,408,702
TAITA/ TAVETA,MWATATE,58,221,273,494
TAITA/ TAVETA,MWATATE,59,271,292,563
TAITA/ TAVETA,MWATATE,55-59,1425,1585,3010
TAITA/ TAVETA,MWATATE,60,326,363,689
TAITA/ TAVETA,MWATATE,61,249,254,503
TAITA/ TAVETA,MWATATE,62,279,260,539
TAITA/ TAVETA,MWATATE,63,250,237,487
TAITA/ TAVETA,MWATATE,64,179,199,378
TAITA/ TAVETA,MWATATE,60-64,1283,1313,2596
TAITA/ TAVETA,MWATATE,65,253,304,557
TAITA/ TAVETA,MWATATE,66,206,207,413
TAITA/ TAVETA,MWATATE,67,232,239,471
TAITA/ TAVETA,MWATATE,68,145,107,252
TAITA/ TAVETA,MWATATE,69,174,206,380
TAITA/ TAVETA,MWATATE,65-69,1010,1063,2073
TAITA/ TAVETA,MWATATE,70,181,327,508
TAITA/ TAVETA,MWATATE,71,129,162,291
TAITA/ TAVETA,MWATATE,72,128,124,252
TAITA/ TAVETA,MWATATE,73,120,94,214
TAITA/ TAVETA,MWATATE,74,99,163,262
TAITA/ TAVETA,MWATATE,70-74,657,870,1527
TAITA/ TAVETA,MWATATE,75,89,119,208
TAITA/ TAVETA,MWATATE,76,66,85,151
TAITA/ TAVETA,MWATATE,77,93,103,196
TAITA/ TAVETA,MWATATE,78,67,67,134
TAITA/ TAVETA,MWATATE,79,61,123,184
TAITA/ TAVETA,MWATATE,75-79,376,497,873
TAITA/ TAVETA,MWATATE,80,86,133,219
TAITA/ TAVETA,MWATATE,81,51,89,140
TAITA/ TAVETA,MWATATE,82,33,59,92
TAITA/ TAVETA,MWATATE,83,44,66,110
TAITA/ TAVETA,MWATATE,84,36,68,104
TAITA/ TAVETA,MWATATE,80-84,250,415,665
TAITA/ TAVETA,MWATATE,85,31,67,98
TAITA/ TAVETA,MWATATE,86,19,28,47
TAITA/ TAVETA,MWATATE,87,25,56,81
TAITA/ TAVETA,MWATATE,88,17,24,41
TAITA/ TAVETA,MWATATE,89,30,79,109
TAITA/ TAVETA,MWATATE,85-89,122,254,376
TAITA/ TAVETA,MWATATE,90,9,36,45
TAITA/ TAVETA,MWATATE,91,8,11,19
TAITA/ TAVETA,MWATATE,92,7,11,18
TAITA/ TAVETA,MWATATE,93,8,11,19
TAITA/ TAVETA,MWATATE,94,4,13,17
TAITA/ TAVETA,MWATATE,90-94,36,82,118
TAITA/ TAVETA,MWATATE,95,5,10,15
TAITA/ TAVETA,MWATATE,96,4,12,16
TAITA/ TAVETA,MWATATE,97,7,8,15
TAITA/ TAVETA,MWATATE,98,2,5,7
TAITA/ TAVETA,MWATATE,99,3,14,17
TAITA/ TAVETA,MWATATE,95-99,21,49,70
TAITA/ TAVETA,MWATATE,100+,6,20,26
TAITA/ TAVETA,MWATATE,Not Stated,1,-,1
TAITA/ TAVETA,TAITA,Total,28386,27573,55959
TAITA/ TAVETA,TAITA,0,541,551,1092
TAITA/ TAVETA,TAITA,1,564,548,1112
TAITA/ TAVETA,TAITA,2,564,534,1098
TAITA/ TAVETA,TAITA,3,564,559,1123
TAITA/ TAVETA,TAITA,4,620,604,1224
TAITA/ TAVETA,TAITA,0 - 4,2853,2796,5649
TAITA/ TAVETA,TAITA,5,598,582,1180
TAITA/ TAVETA,TAITA,6,543,559,1102
TAITA/ TAVETA,TAITA,7,582,571,1153
TAITA/ TAVETA,TAITA,8,634,627,1261
TAITA/ TAVETA,TAITA,9,670,641,1311
TAITA/ TAVETA,TAITA,05-Sep,3027,2980,6007
TAITA/ TAVETA,TAITA,10,626,622,1248
TAITA/ TAVETA,TAITA,11,664,668,1332
TAITA/ TAVETA,TAITA,12,743,670,1413
TAITA/ TAVETA,TAITA,13,707,702,1409
TAITA/ TAVETA,TAITA,14,688,622,1310
TAITA/ TAVETA,TAITA,Oct-14,3428,3284,6712
TAITA/ TAVETA,TAITA,15,596,627,1223
TAITA/ TAVETA,TAITA,16,588,579,1167
TAITA/ TAVETA,TAITA,17,663,651,1314
TAITA/ TAVETA,TAITA,18,568,463,1031
TAITA/ TAVETA,TAITA,19,582,458,1040
TAITA/ TAVETA,TAITA,15-19,2997,2778,5775
TAITA/ TAVETA,TAITA,20,496,423,919
TAITA/ TAVETA,TAITA,21,441,345,786
TAITA/ TAVETA,TAITA,22,417,358,775
TAITA/ TAVETA,TAITA,23,435,358,793
TAITA/ TAVETA,TAITA,24,368,360,728
TAITA/ TAVETA,TAITA,20-24,2157,1844,4001
TAITA/ TAVETA,TAITA,25,356,338,694
TAITA/ TAVETA,TAITA,26,371,288,659
TAITA/ TAVETA,TAITA,27,347,319,666
TAITA/ TAVETA,TAITA,28,296,278,574
TAITA/ TAVETA,TAITA,29,361,311,672
TAITA/ TAVETA,TAITA,25-29,1731,1534,3265
TAITA/ TAVETA,TAITA,30,400,340,740
TAITA/ TAVETA,TAITA,31,291,284,575
TAITA/ TAVETA,TAITA,32,405,342,747
TAITA/ TAVETA,TAITA,33,329,328,657
TAITA/ TAVETA,TAITA,34,345,314,659
TAITA/ TAVETA,TAITA,30-34,1770,1608,3378
TAITA/ TAVETA,TAITA,35,467,406,873
TAITA/ TAVETA,TAITA,36,355,324,679
TAITA/ TAVETA,TAITA,37,371,306,677
TAITA/ TAVETA,TAITA,38,331,253,584
TAITA/ TAVETA,TAITA,39,359,312,671
TAITA/ TAVETA,TAITA,35-39,1883,1601,3484
TAITA/ TAVETA,TAITA,40,387,332,719
TAITA/ TAVETA,TAITA,41,366,279,645
TAITA/ TAVETA,TAITA,42,323,296,619
TAITA/ TAVETA,TAITA,43,278,276,554
TAITA/ TAVETA,TAITA,44,273,278,551
TAITA/ TAVETA,TAITA,40-44,1627,1461,3088
TAITA/ TAVETA,TAITA,45,358,324,682
TAITA/ TAVETA,TAITA,46,297,274,571
TAITA/ TAVETA,TAITA,47,289,316,605
TAITA/ TAVETA,TAITA,48,235,243,478
TAITA/ TAVETA,TAITA,49,282,270,552
TAITA/ TAVETA,TAITA,45-49,1461,1427,2888
TAITA/ TAVETA,TAITA,50,320,320,640
TAITA/ TAVETA,TAITA,51,245,222,467
TAITA/ TAVETA,TAITA,52,256,229,485
TAITA/ TAVETA,TAITA,53,207,211,418
TAITA/ TAVETA,TAITA,54,223,251,474
TAITA/ TAVETA,TAITA,50-54,1251,1233,2484
TAITA/ TAVETA,TAITA,55,228,223,451
TAITA/ TAVETA,TAITA,56,254,253,507
TAITA/ TAVETA,TAITA,57,259,375,634
TAITA/ TAVETA,TAITA,58,175,221,396
TAITA/ TAVETA,TAITA,59,213,232,445
TAITA/ TAVETA,TAITA,55-59,1129,1304,2433
TAITA/ TAVETA,TAITA,60,237,309,546
TAITA/ TAVETA,TAITA,61,180,205,385
TAITA/ TAVETA,TAITA,62,178,201,379
TAITA/ TAVETA,TAITA,63,178,197,375
TAITA/ TAVETA,TAITA,64,151,155,306
TAITA/ TAVETA,TAITA,60-64,924,1067,1991
TAITA/ TAVETA,TAITA,65,206,227,433
TAITA/ TAVETA,TAITA,66,174,173,347
TAITA/ TAVETA,TAITA,67,195,178,373
TAITA/ TAVETA,TAITA,68,127,94,221
TAITA/ TAVETA,TAITA,69,145,178,323
TAITA/ TAVETA,TAITA,65-69,847,850,1697
TAITA/ TAVETA,TAITA,70,151,230,381
TAITA/ TAVETA,TAITA,71,122,155,277
TAITA/ TAVETA,TAITA,72,119,90,209
TAITA/ TAVETA,TAITA,73,101,95,196
TAITA/ TAVETA,TAITA,74,93,143,236
TAITA/ TAVETA,TAITA,70-74,586,713,1299
TAITA/ TAVETA,TAITA,75,82,96,178
TAITA/ TAVETA,TAITA,76,62,79,141
TAITA/ TAVETA,TAITA,77,83,79,162
TAITA/ TAVETA,TAITA,78,42,58,100
TAITA/ TAVETA,TAITA,79,57,97,154
TAITA/ TAVETA,TAITA,75-79,326,409,735
TAITA/ TAVETA,TAITA,80,76,108,184
TAITA/ TAVETA,TAITA,81,56,77,133
TAITA/ TAVETA,TAITA,82,23,45,68
TAITA/ TAVETA,TAITA,83,35,52,87
TAITA/ TAVETA,TAITA,84,29,46,75
TAITA/ TAVETA,TAITA,80-84,219,328,547
TAITA/ TAVETA,TAITA,85,32,39,71
TAITA/ TAVETA,TAITA,86,27,26,53
TAITA/ TAVETA,TAITA,87,25,59,84
TAITA/ TAVETA,TAITA,88,12,24,36
TAITA/ TAVETA,TAITA,89,17,65,82
TAITA/ TAVETA,TAITA,85-89,113,213,326
TAITA/ TAVETA,TAITA,90,13,34,47
TAITA/ TAVETA,TAITA,91,8,31,39
TAITA/ TAVETA,TAITA,92,5,6,11
TAITA/ TAVETA,TAITA,93,3,7,10
TAITA/ TAVETA,TAITA,94,3,10,13
TAITA/ TAVETA,TAITA,90-94,32,88,120
TAITA/ TAVETA,TAITA,95,6,12,18
TAITA/ TAVETA,TAITA,96,-,3,3
TAITA/ TAVETA,TAITA,97,2,5,7
TAITA/ TAVETA,TAITA,98,1,7,8
TAITA/ TAVETA,TAITA,99,7,15,22
TAITA/ TAVETA,TAITA,95-99,16,42,58
TAITA/ TAVETA,TAITA,100+,9,12,21
TAITA/ TAVETA,TAITA,Not Stated,-,1,1
TAITA/ TAVETA,TAVETA,Total,47410,43812,91222
TAITA/ TAVETA,TAVETA,0,1058,1000,2058
TAITA/ TAVETA,TAVETA,1,1099,1219,2318
TAITA/ TAVETA,TAVETA,2,1101,1079,2180
TAITA/ TAVETA,TAVETA,3,1192,1093,2285
TAITA/ TAVETA,TAVETA,4,1041,1093,2134
TAITA/ TAVETA,TAVETA,0 - 4,5491,5484,10975
TAITA/ TAVETA,TAVETA,5,1065,1019,2084
TAITA/ TAVETA,TAVETA,6,1023,1037,2060
TAITA/ TAVETA,TAVETA,7,1015,986,2001
TAITA/ TAVETA,TAVETA,8,1053,1014,2067
TAITA/ TAVETA,TAVETA,9,1144,1183,2327
TAITA/ TAVETA,TAVETA,05-Sep,5300,5239,10539
TAITA/ TAVETA,TAVETA,10,1117,1087,2204
TAITA/ TAVETA,TAVETA,11,1118,1091,2209
TAITA/ TAVETA,TAVETA,12,1188,1047,2235
TAITA/ TAVETA,TAVETA,13,1156,1146,2302
TAITA/ TAVETA,TAVETA,14,1105,1051,2156
TAITA/ TAVETA,TAVETA,Oct-14,5684,5422,11106
TAITA/ TAVETA,TAVETA,15,1067,1040,2107
TAITA/ TAVETA,TAVETA,16,998,951,1949
TAITA/ TAVETA,TAVETA,17,1090,928,2018
TAITA/ TAVETA,TAVETA,18,928,867,1795
TAITA/ TAVETA,TAVETA,19,889,889,1778
TAITA/ TAVETA,TAVETA,15-19,4972,4675,9647
TAITA/ TAVETA,TAVETA,20,909,939,1848
TAITA/ TAVETA,TAVETA,21,704,720,1424
TAITA/ TAVETA,TAVETA,22,771,804,1575
TAITA/ TAVETA,TAVETA,23,820,830,1650
TAITA/ TAVETA,TAVETA,24,744,790,1534
TAITA/ TAVETA,TAVETA,20-24,3948,4083,8031
TAITA/ TAVETA,TAVETA,25,953,825,1778
TAITA/ TAVETA,TAVETA,26,711,710,1421
TAITA/ TAVETA,TAVETA,27,819,757,1576
TAITA/ TAVETA,TAVETA,28,726,621,1347
TAITA/ TAVETA,TAVETA,29,784,744,1528
TAITA/ TAVETA,TAVETA,25-29,3993,3657,7650
TAITA/ TAVETA,TAVETA,30,962,860,1822
TAITA/ TAVETA,TAVETA,31,687,654,1341
TAITA/ TAVETA,TAVETA,32,855,720,1575
TAITA/ TAVETA,TAVETA,33,659,605,1264
TAITA/ TAVETA,TAVETA,34,619,512,1131
TAITA/ TAVETA,TAVETA,30-34,3782,3351,7133
TAITA/ TAVETA,TAVETA,35,829,657,1486
TAITA/ TAVETA,TAVETA,36,628,562,1190
TAITA/ TAVETA,TAVETA,37,661,554,1215
TAITA/ TAVETA,TAVETA,38,518,402,920
TAITA/ TAVETA,TAVETA,39,625,543,1168
TAITA/ TAVETA,TAVETA,35-39,3261,2718,5979
TAITA/ TAVETA,TAVETA,40,695,570,1265
TAITA/ TAVETA,TAVETA,41,597,483,1080
TAITA/ TAVETA,TAVETA,42,592,408,1000
TAITA/ TAVETA,TAVETA,43,490,356,846
TAITA/ TAVETA,TAVETA,44,449,344,793
TAITA/ TAVETA,TAVETA,40-44,2823,2161,4984
TAITA/ TAVETA,TAVETA,45,638,472,1110
TAITA/ TAVETA,TAVETA,46,432,389,821
TAITA/ TAVETA,TAVETA,47,525,402,927
TAITA/ TAVETA,TAVETA,48,362,260,622
TAITA/ TAVETA,TAVETA,49,412,338,750
TAITA/ TAVETA,TAVETA,45-49,2369,1861,4230
TAITA/ TAVETA,TAVETA,50,465,353,818
TAITA/ TAVETA,TAVETA,51,384,282,666
TAITA/ TAVETA,TAVETA,52,311,216,527
TAITA/ TAVETA,TAVETA,53,235,171,406
TAITA/ TAVETA,TAVETA,54,309,247,556
TAITA/ TAVETA,TAVETA,50-54,1704,1269,2973
TAITA/ TAVETA,TAVETA,55,329,255,584
TAITA/ TAVETA,TAVETA,56,331,241,572
TAITA/ TAVETA,TAVETA,57,215,249,464
TAITA/ TAVETA,TAVETA,58,192,183,375
TAITA/ TAVETA,TAVETA,59,244,213,457
TAITA/ TAVETA,TAVETA,55-59,1311,1141,2452
TAITA/ TAVETA,TAVETA,60,280,245,525
TAITA/ TAVETA,TAVETA,61,208,186,394
TAITA/ TAVETA,TAVETA,62,190,159,349
TAITA/ TAVETA,TAVETA,63,188,161,349
TAITA/ TAVETA,TAVETA,64,138,108,246
TAITA/ TAVETA,TAVETA,60-64,1004,859,1863
TAITA/ TAVETA,TAVETA,65,176,212,388
TAITA/ TAVETA,TAVETA,66,121,113,234
TAITA/ TAVETA,TAVETA,67,189,152,341
TAITA/ TAVETA,TAVETA,68,91,87,178
TAITA/ TAVETA,TAVETA,69,127,135,262
TAITA/ TAVETA,TAVETA,65-69,704,699,1403
TAITA/ TAVETA,TAVETA,70,137,182,319
TAITA/ TAVETA,TAVETA,71,109,95,204
TAITA/ TAVETA,TAVETA,72,93,62,155
TAITA/ TAVETA,TAVETA,73,61,65,126
TAITA/ TAVETA,TAVETA,74,66,57,123
TAITA/ TAVETA,TAVETA,70-74,466,461,927
TAITA/ TAVETA,TAVETA,75,73,68,141
TAITA/ TAVETA,TAVETA,76,47,35,82
TAITA/ TAVETA,TAVETA,77,66,57,123
TAITA/ TAVETA,TAVETA,78,29,26,55
TAITA/ TAVETA,TAVETA,79,53,63,116
TAITA/ TAVETA,TAVETA,75-79,268,249,517
TAITA/ TAVETA,TAVETA,80,51,77,128
TAITA/ TAVETA,TAVETA,81,26,30,56
TAITA/ TAVETA,TAVETA,82,33,26,59
TAITA/ TAVETA,TAVETA,83,30,34,64
TAITA/ TAVETA,TAVETA,84,21,28,49
TAITA/ TAVETA,TAVETA,80-84,161,195,356
TAITA/ TAVETA,TAVETA,85,22,38,60
TAITA/ TAVETA,TAVETA,86,17,12,29
TAITA/ TAVETA,TAVETA,87,14,30,44
TAITA/ TAVETA,TAVETA,88,13,17,30
TAITA/ TAVETA,TAVETA,89,25,59,84
TAITA/ TAVETA,TAVETA,85-89,91,156,247
TAITA/ TAVETA,TAVETA,90,19,33,52
TAITA/ TAVETA,TAVETA,91,8,18,26
TAITA/ TAVETA,TAVETA,92,10,6,16
TAITA/ TAVETA,TAVETA,93,5,5,10
TAITA/ TAVETA,TAVETA,94,4,7,11
TAITA/ TAVETA,TAVETA,90-94,46,69,115
TAITA/ TAVETA,TAVETA,95,2,12,14
TAITA/ TAVETA,TAVETA,96,2,5,7
TAITA/ TAVETA,TAVETA,97,7,5,12
TAITA/ TAVETA,TAVETA,98,2,4,6
TAITA/ TAVETA,TAVETA,99,6,10,16
TAITA/ TAVETA,TAVETA,95-99,19,36,55
TAITA/ TAVETA,TAVETA,100+,12,27,39
TAITA/ TAVETA,TAVETA,Not Stated,1,-,1
TAITA/ TAVETA,VOI,Total,56115,55711,111826
TAITA/ TAVETA,VOI,0,1412,1368,2780
TAITA/ TAVETA,VOI,1,1358,1293,2651
TAITA/ TAVETA,VOI,2,1285,1360,2645
TAITA/ TAVETA,VOI,3,1266,1310,2576
TAITA/ TAVETA,VOI,4,1293,1212,2505
TAITA/ TAVETA,VOI,0 - 4,6614,6543,13157
TAITA/ TAVETA,VOI,5,1250,1199,2449
TAITA/ TAVETA,VOI,6,1210,1185,2395
TAITA/ TAVETA,VOI,7,1149,1209,2358
TAITA/ TAVETA,VOI,8,1157,1145,2302
TAITA/ TAVETA,VOI,9,1197,1240,2437
TAITA/ TAVETA,VOI,05-Sep,5963,5978,11941
TAITA/ TAVETA,VOI,10,1209,1216,2425
TAITA/ TAVETA,VOI,11,1198,1248,2446
TAITA/ TAVETA,VOI,12,1254,1226,2480
TAITA/ TAVETA,VOI,13,1200,1273,2473
TAITA/ TAVETA,VOI,14,1209,1155,2364
TAITA/ TAVETA,VOI,Oct-14,6070,6118,12188
TAITA/ TAVETA,VOI,15,1149,1099,2248
TAITA/ TAVETA,VOI,16,1129,1164,2293
TAITA/ TAVETA,VOI,17,1186,1090,2276
TAITA/ TAVETA,VOI,18,981,931,1912
TAITA/ TAVETA,VOI,19,1043,1108,2151
TAITA/ TAVETA,VOI,15-19,5488,5392,10880
TAITA/ TAVETA,VOI,20,1058,1156,2214
TAITA/ TAVETA,VOI,21,982,1026,2008
TAITA/ TAVETA,VOI,22,962,1083,2045
TAITA/ TAVETA,VOI,23,1031,1155,2186
TAITA/ TAVETA,VOI,24,1022,1084,2106
TAITA/ TAVETA,VOI,20-24,5055,5504,10559
TAITA/ TAVETA,VOI,25,1148,1065,2213
TAITA/ TAVETA,VOI,26,946,977,1923
TAITA/ TAVETA,VOI,27,957,1025,1982
TAITA/ TAVETA,VOI,28,927,909,1836
TAITA/ TAVETA,VOI,29,968,989,1957
TAITA/ TAVETA,VOI,25-29,4946,4965,9911
TAITA/ TAVETA,VOI,30,1124,1060,2184
TAITA/ TAVETA,VOI,31,884,822,1706
TAITA/ TAVETA,VOI,32,983,990,1973
TAITA/ TAVETA,VOI,33,801,834,1635
TAITA/ TAVETA,VOI,34,764,740,1504
TAITA/ TAVETA,VOI,30-34,4556,4446,9002
TAITA/ TAVETA,VOI,35,972,845,1817
TAITA/ TAVETA,VOI,36,835,684,1519
TAITA/ TAVETA,VOI,37,812,649,1461
TAITA/ TAVETA,VOI,38,633,617,1250
TAITA/ TAVETA,VOI,39,694,646,1340
TAITA/ TAVETA,VOI,35-39,3946,3441,7387
TAITA/ TAVETA,VOI,40,772,659,1431
TAITA/ TAVETA,VOI,41,698,581,1279
TAITA/ TAVETA,VOI,42,648,595,1243
TAITA/ TAVETA,VOI,43,623,559,1182
TAITA/ TAVETA,VOI,44,548,486,1034
TAITA/ TAVETA,VOI,40-44,3289,2880,6169
TAITA/ TAVETA,VOI,45,713,660,1373
TAITA/ TAVETA,VOI,46,537,505,1042
TAITA/ TAVETA,VOI,47,576,530,1106
TAITA/ TAVETA,VOI,48,446,384,830
TAITA/ TAVETA,VOI,49,474,451,925
TAITA/ TAVETA,VOI,45-49,2746,2530,5276
TAITA/ TAVETA,VOI,50,580,481,1061
TAITA/ TAVETA,VOI,51,407,363,770
TAITA/ TAVETA,VOI,52,378,344,722
TAITA/ TAVETA,VOI,53,342,264,606
TAITA/ TAVETA,VOI,54,346,333,679
TAITA/ TAVETA,VOI,50-54,2053,1785,3838
TAITA/ TAVETA,VOI,55,374,313,687
TAITA/ TAVETA,VOI,56,393,358,751
TAITA/ TAVETA,VOI,57,367,416,783
TAITA/ TAVETA,VOI,58,250,289,539
TAITA/ TAVETA,VOI,59,283,309,592
TAITA/ TAVETA,VOI,55-59,1667,1685,3352
TAITA/ TAVETA,VOI,60,305,381,686
TAITA/ TAVETA,VOI,61,267,290,557
TAITA/ TAVETA,VOI,62,262,263,525
TAITA/ TAVETA,VOI,63,228,228,456
TAITA/ TAVETA,VOI,64,220,183,403
TAITA/ TAVETA,VOI,60-64,1282,1345,2627
TAITA/ TAVETA,VOI,65,248,285,533
TAITA/ TAVETA,VOI,66,205,183,388
TAITA/ TAVETA,VOI,67,242,216,458
TAITA/ TAVETA,VOI,68,150,116,266
TAITA/ TAVETA,VOI,69,186,223,409
TAITA/ TAVETA,VOI,65-69,1031,1023,2054
TAITA/ TAVETA,VOI,70,200,323,523
TAITA/ TAVETA,VOI,71,135,137,272
TAITA/ TAVETA,VOI,72,109,116,225
TAITA/ TAVETA,VOI,73,94,116,210
TAITA/ TAVETA,VOI,74,106,131,237
TAITA/ TAVETA,VOI,70-74,644,823,1467
TAITA/ TAVETA,VOI,75,73,111,184
TAITA/ TAVETA,VOI,76,64,84,148
TAITA/ TAVETA,VOI,77,81,101,182
TAITA/ TAVETA,VOI,78,53,61,114
TAITA/ TAVETA,VOI,79,84,123,207
TAITA/ TAVETA,VOI,75-79,355,480,835
TAITA/ TAVETA,VOI,80,70,128,198
TAITA/ TAVETA,VOI,81,35,57,92
TAITA/ TAVETA,VOI,82,45,39,84
TAITA/ TAVETA,VOI,83,47,72,119
TAITA/ TAVETA,VOI,84,33,75,108
TAITA/ TAVETA,VOI,80-84,230,371,601
TAITA/ TAVETA,VOI,85,30,49,79
TAITA/ TAVETA,VOI,86,18,31,49
TAITA/ TAVETA,VOI,87,16,38,54
TAITA/ TAVETA,VOI,88,18,20,38
TAITA/ TAVETA,VOI,89,13,76,89
TAITA/ TAVETA,VOI,85-89,95,214,309
TAITA/ TAVETA,VOI,90,12,32,44
TAITA/ TAVETA,VOI,91,12,18,30
TAITA/ TAVETA,VOI,92,8,10,18
TAITA/ TAVETA,VOI,93,10,20,30
TAITA/ TAVETA,VOI,94,6,18,24
TAITA/ TAVETA,VOI,90-94,48,98,146
TAITA/ TAVETA,VOI,95,10,11,21
TAITA/ TAVETA,VOI,96,4,7,11
TAITA/ TAVETA,VOI,97,3,8,11
TAITA/ TAVETA,VOI,98,3,13,16
TAITA/ TAVETA,VOI,99,3,24,27
TAITA/ TAVETA,VOI,95-99,23,63,86
TAITA/ TAVETA,VOI,100+,14,27,41
TAITA/ TAVETA,VOI,Not Stated,-,-,-
TANA RIVER,ALL,Total,158550,157391,315941
TANA RIVER,ALL,0,4867,4775,9642
TANA RIVER,ALL,1,4934,4600,9534
TANA RIVER,ALL,2,5639,5317,10956
TANA RIVER,ALL,3,5663,5573,11236
TANA RIVER,ALL,4,6069,5741,11810
TANA RIVER,ALL,0 - 4,27172,26006,53178
TANA RIVER,ALL,5,5797,5524,11321
TANA RIVER,ALL,6,5768,5646,11414
TANA RIVER,ALL,7,5531,5026,10557
TANA RIVER,ALL,8,5508,5261,10769
TANA RIVER,ALL,9,4487,4421,8908
TANA RIVER,ALL,05-Sep,27091,25878,52969
TANA RIVER,ALL,10,5919,5787,11706
TANA RIVER,ALL,11,3965,3890,7855
TANA RIVER,ALL,12,5339,4949,10288
TANA RIVER,ALL,13,4358,4357,8715
TANA RIVER,ALL,14,4138,3988,8126
TANA RIVER,ALL,Oct-14,23719,22971,46690
TANA RIVER,ALL,15,4265,4049,8314
TANA RIVER,ALL,16,3350,3136,6486
TANA RIVER,ALL,17,3352,2935,6287
TANA RIVER,ALL,18,3307,3163,6470
TANA RIVER,ALL,19,2598,2777,5375
TANA RIVER,ALL,15-19,16872,16060,32932
TANA RIVER,ALL,20,3315,3742,7057
TANA RIVER,ALL,21,2192,2515,4707
TANA RIVER,ALL,22,2639,2900,5539
TANA RIVER,ALL,23,2558,2601,5159
TANA RIVER,ALL,24,2254,2460,4714
TANA RIVER,ALL,20-24,12958,14218,27176
TANA RIVER,ALL,25,3229,3564,6793
TANA RIVER,ALL,26,2022,2160,4182
TANA RIVER,ALL,27,1879,2269,4148
TANA RIVER,ALL,28,1736,2098,3834
TANA RIVER,ALL,29,1554,1649,3203
TANA RIVER,ALL,25-29,10420,11740,22160
TANA RIVER,ALL,30,2976,3463,6439
TANA RIVER,ALL,31,1396,1597,2993
TANA RIVER,ALL,32,1706,1905,3611
TANA RIVER,ALL,33,1174,1402,2576
TANA RIVER,ALL,34,1176,1124,2300
TANA RIVER,ALL,30-34,8428,9491,17919
TANA RIVER,ALL,35,2486,2510,4996
TANA RIVER,ALL,36,1278,1284,2562
TANA RIVER,ALL,37,1296,1200,2496
TANA RIVER,ALL,38,939,902,1841
TANA RIVER,ALL,39,877,728,1605
TANA RIVER,ALL,35-39,6876,6624,13500
TANA RIVER,ALL,40,2197,2112,4309
TANA RIVER,ALL,41,1249,1276,2525
TANA RIVER,ALL,42,1026,884,1910
TANA RIVER,ALL,43,696,648,1344
TANA RIVER,ALL,44,605,467,1072
TANA RIVER,ALL,40-44,5773,5387,11160
TANA RIVER,ALL,45,1801,1855,3656
TANA RIVER,ALL,46,952,1040,1992
TANA RIVER,ALL,47,835,781,1616
TANA RIVER,ALL,48,663,576,1239
TANA RIVER,ALL,49,656,543,1199
TANA RIVER,ALL,45-49,4907,4795,9702
TANA RIVER,ALL,50,1426,1371,2797
TANA RIVER,ALL,51,538,547,1085
TANA RIVER,ALL,52,626,588,1214
TANA RIVER,ALL,53,483,396,879
TANA RIVER,ALL,54,570,548,1118
TANA RIVER,ALL,50-54,3643,3450,7093
TANA RIVER,ALL,55,681,548,1229
TANA RIVER,ALL,56,689,541,1230
TANA RIVER,ALL,57,606,617,1223
TANA RIVER,ALL,58,566,630,1196
TANA RIVER,ALL,59,581,591,1172
TANA RIVER,ALL,55-59,3123,2927,6050
TANA RIVER,ALL,60,1056,1151,2207
TANA RIVER,ALL,61,522,450,972
TANA RIVER,ALL,62,472,422,894
TANA RIVER,ALL,63,466,449,915
TANA RIVER,ALL,64,327,287,614
TANA RIVER,ALL,60-64,2843,2759,5602
TANA RIVER,ALL,65,545,631,1176
TANA RIVER,ALL,66,272,314,586
TANA RIVER,ALL,67,347,310,657
TANA RIVER,ALL,68,268,226,494
TANA RIVER,ALL,69,319,384,703
TANA RIVER,ALL,65-69,1751,1865,3616
TANA RIVER,ALL,70,611,815,1426
TANA RIVER,ALL,71,229,274,503
TANA RIVER,ALL,72,188,158,346
TANA RIVER,ALL,73,189,156,345
TANA RIVER,ALL,74,145,139,284
TANA RIVER,ALL,70-74,1362,1542,2904
TANA RIVER,ALL,75,205,232,437
TANA RIVER,ALL,76,135,139,274
TANA RIVER,ALL,77,113,86,199
TANA RIVER,ALL,78,115,82,197
TANA RIVER,ALL,79,140,115,255
TANA RIVER,ALL,75-79,708,654,1362
TANA RIVER,ALL,80,243,307,550
TANA RIVER,ALL,81,62,72,134
TANA RIVER,ALL,82,70,42,112
TANA RIVER,ALL,83,54,56,110
TANA RIVER,ALL,84,52,45,97
TANA RIVER,ALL,80-84,481,522,1003
TANA RIVER,ALL,85,82,64,146
TANA RIVER,ALL,86,38,33,71
TANA RIVER,ALL,87,53,46,99
TANA RIVER,ALL,88,36,14,50
TANA RIVER,ALL,89,46,72,118
TANA RIVER,ALL,85-89,255,229,484
TANA RIVER,ALL,90,53,95,148
TANA RIVER,ALL,91,11,29,40
TANA RIVER,ALL,92,9,14,23
TANA RIVER,ALL,93,9,13,22
TANA RIVER,ALL,94,7,4,11
TANA RIVER,ALL,90-94,89,155,244
TANA RIVER,ALL,95,11,22,33
TANA RIVER,ALL,96,8,11,19
TANA RIVER,ALL,97,3,10,13
TANA RIVER,ALL,98,6,10,16
TANA RIVER,ALL,99,9,14,23
TANA RIVER,ALL,95-99,37,67,104
TANA RIVER,ALL,100+,37,50,87
TANA RIVER,ALL,Not Stated,5,1,6
TANA RIVER,TANA DELTA,Total,55716,54924,110640
TANA RIVER,TANA DELTA,0,1725,1731,3456
TANA RIVER,TANA DELTA,1,1711,1603,3314
TANA RIVER,TANA DELTA,2,1932,1812,3744
TANA RIVER,TANA DELTA,3,1949,1858,3807
TANA RIVER,TANA DELTA,4,2168,1914,4082
TANA RIVER,TANA DELTA,0 - 4,9485,8918,18403
TANA RIVER,TANA DELTA,5,1985,1937,3922
TANA RIVER,TANA DELTA,6,1973,1956,3929
TANA RIVER,TANA DELTA,7,1952,1802,3754
TANA RIVER,TANA DELTA,8,1890,1751,3641
TANA RIVER,TANA DELTA,9,1709,1662,3371
TANA RIVER,TANA DELTA,05-Sep,9509,9108,18617
TANA RIVER,TANA DELTA,10,1990,1910,3900
TANA RIVER,TANA DELTA,11,1524,1482,3006
TANA RIVER,TANA DELTA,12,1870,1651,3521
TANA RIVER,TANA DELTA,13,1592,1610,3202
TANA RIVER,TANA DELTA,14,1480,1421,2901
TANA RIVER,TANA DELTA,Oct-14,8456,8074,16530
TANA RIVER,TANA DELTA,15,1549,1430,2979
TANA RIVER,TANA DELTA,16,1234,1134,2368
TANA RIVER,TANA DELTA,17,1321,1118,2439
TANA RIVER,TANA DELTA,18,1236,1062,2298
TANA RIVER,TANA DELTA,19,1018,953,1971
TANA RIVER,TANA DELTA,15-19,6358,5697,12055
TANA RIVER,TANA DELTA,20,1096,1081,2177
TANA RIVER,TANA DELTA,21,770,902,1672
TANA RIVER,TANA DELTA,22,841,956,1797
TANA RIVER,TANA DELTA,23,826,794,1620
TANA RIVER,TANA DELTA,24,655,807,1462
TANA RIVER,TANA DELTA,20-24,4188,4540,8728
TANA RIVER,TANA DELTA,25,932,1054,1986
TANA RIVER,TANA DELTA,26,689,745,1434
TANA RIVER,TANA DELTA,27,596,701,1297
TANA RIVER,TANA DELTA,28,514,623,1137
TANA RIVER,TANA DELTA,29,563,560,1123
TANA RIVER,TANA DELTA,25-29,3294,3683,6977
TANA RIVER,TANA DELTA,30,807,954,1761
TANA RIVER,TANA DELTA,31,487,620,1107
TANA RIVER,TANA DELTA,32,577,703,1280
TANA RIVER,TANA DELTA,33,421,538,959
TANA RIVER,TANA DELTA,34,404,390,794
TANA RIVER,TANA DELTA,30-34,2696,3205,5901
TANA RIVER,TANA DELTA,35,730,807,1537
TANA RIVER,TANA DELTA,36,465,475,940
TANA RIVER,TANA DELTA,37,470,445,915
TANA RIVER,TANA DELTA,38,289,258,547
TANA RIVER,TANA DELTA,39,295,251,546
TANA RIVER,TANA DELTA,35-39,2249,2236,4485
TANA RIVER,TANA DELTA,40,605,612,1217
TANA RIVER,TANA DELTA,41,471,592,1063
TANA RIVER,TANA DELTA,42,359,328,687
TANA RIVER,TANA DELTA,43,251,258,509
TANA RIVER,TANA DELTA,44,219,185,404
TANA RIVER,TANA DELTA,40-44,1905,1975,3880
TANA RIVER,TANA DELTA,45,656,740,1396
TANA RIVER,TANA DELTA,46,383,448,831
TANA RIVER,TANA DELTA,47,365,362,727
TANA RIVER,TANA DELTA,48,255,236,491
TANA RIVER,TANA DELTA,49,277,225,502
TANA RIVER,TANA DELTA,45-49,1936,2011,3947
TANA RIVER,TANA DELTA,50,462,455,917
TANA RIVER,TANA DELTA,51,252,258,510
TANA RIVER,TANA DELTA,52,264,223,487
TANA RIVER,TANA DELTA,53,226,178,404
TANA RIVER,TANA DELTA,54,258,246,504
TANA RIVER,TANA DELTA,50-54,1462,1360,2822
TANA RIVER,TANA DELTA,55,198,185,383
TANA RIVER,TANA DELTA,56,307,241,548
TANA RIVER,TANA DELTA,57,227,230,457
TANA RIVER,TANA DELTA,58,213,239,452
TANA RIVER,TANA DELTA,59,248,246,494
TANA RIVER,TANA DELTA,55-59,1193,1141,2334
TANA RIVER,TANA DELTA,60,375,360,735
TANA RIVER,TANA DELTA,61,225,176,401
TANA RIVER,TANA DELTA,62,198,169,367
TANA RIVER,TANA DELTA,63,214,196,410
TANA RIVER,TANA DELTA,64,129,111,240
TANA RIVER,TANA DELTA,60-64,1141,1012,2153
TANA RIVER,TANA DELTA,65,196,259,455
TANA RIVER,TANA DELTA,66,114,113,227
TANA RIVER,TANA DELTA,67,130,133,263
TANA RIVER,TANA DELTA,68,116,91,207
TANA RIVER,TANA DELTA,69,141,176,317
TANA RIVER,TANA DELTA,65-69,697,772,1469
TANA RIVER,TANA DELTA,70,190,269,459
TANA RIVER,TANA DELTA,71,97,110,207
TANA RIVER,TANA DELTA,72,90,69,159
TANA RIVER,TANA DELTA,73,93,83,176
TANA RIVER,TANA DELTA,74,53,46,99
TANA RIVER,TANA DELTA,70-74,523,577,1100
TANA RIVER,TANA DELTA,75,73,74,147
TANA RIVER,TANA DELTA,76,59,49,108
TANA RIVER,TANA DELTA,77,48,41,89
TANA RIVER,TANA DELTA,78,39,31,70
TANA RIVER,TANA DELTA,79,68,63,131
TANA RIVER,TANA DELTA,75-79,287,258,545
TANA RIVER,TANA DELTA,80,83,86,169
TANA RIVER,TANA DELTA,81,23,29,52
TANA RIVER,TANA DELTA,82,29,11,40
TANA RIVER,TANA DELTA,83,23,25,48
TANA RIVER,TANA DELTA,84,22,19,41
TANA RIVER,TANA DELTA,80-84,180,170,350
TANA RIVER,TANA DELTA,85,26,21,47
TANA RIVER,TANA DELTA,86,17,15,32
TANA RIVER,TANA DELTA,87,24,19,43
TANA RIVER,TANA DELTA,88,16,7,23
TANA RIVER,TANA DELTA,89,15,29,44
TANA RIVER,TANA DELTA,85-89,98,91,189
TANA RIVER,TANA DELTA,90,16,29,45
TANA RIVER,TANA DELTA,91,3,12,15
TANA RIVER,TANA DELTA,92,2,7,9
TANA RIVER,TANA DELTA,93,4,9,13
TANA RIVER,TANA DELTA,94,2,2,4
TANA RIVER,TANA DELTA,90-94,27,59,86
TANA RIVER,TANA DELTA,95,7,6,13
TANA RIVER,TANA DELTA,96,3,6,9
TANA RIVER,TANA DELTA,97,1,4,5
TANA RIVER,TANA DELTA,98,2,3,5
TANA RIVER,TANA DELTA,99,5,7,12
TANA RIVER,TANA DELTA,95-99,18,26,44
TANA RIVER,TANA DELTA,100+,11,11,22
TANA RIVER,TANA DELTA,Not Stated,3,-,3
TANA RIVER,TANA NORTH,Total,59123,57632,116755
TANA RIVER,TANA NORTH,0,1724,1658,3382
TANA RIVER,TANA NORTH,1,1769,1650,3419
TANA RIVER,TANA NORTH,2,2172,1996,4168
TANA RIVER,TANA NORTH,3,2096,2135,4231
TANA RIVER,TANA NORTH,4,2220,2182,4402
TANA RIVER,TANA NORTH,0 - 4,9981,9621,19602
TANA RIVER,TANA NORTH,5,2137,2011,4148
TANA RIVER,TANA NORTH,6,2158,2137,4295
TANA RIVER,TANA NORTH,7,1956,1746,3702
TANA RIVER,TANA NORTH,8,2169,2013,4182
TANA RIVER,TANA NORTH,9,1514,1518,3032
TANA RIVER,TANA NORTH,05-Sep,9934,9425,19359
TANA RIVER,TANA NORTH,10,2320,2188,4508
TANA RIVER,TANA NORTH,11,1310,1257,2567
TANA RIVER,TANA NORTH,12,1951,1848,3799
TANA RIVER,TANA NORTH,13,1577,1498,3075
TANA RIVER,TANA NORTH,14,1452,1461,2913
TANA RIVER,TANA NORTH,Oct-14,8610,8252,16862
TANA RIVER,TANA NORTH,15,1499,1463,2962
TANA RIVER,TANA NORTH,16,1240,1174,2414
TANA RIVER,TANA NORTH,17,1128,1014,2142
TANA RIVER,TANA NORTH,18,1272,1234,2506
TANA RIVER,TANA NORTH,19,856,1000,1856
TANA RIVER,TANA NORTH,15-19,5995,5885,11880
TANA RIVER,TANA NORTH,20,1399,1653,3052
TANA RIVER,TANA NORTH,21,869,852,1721
TANA RIVER,TANA NORTH,22,1085,1145,2230
TANA RIVER,TANA NORTH,23,1021,951,1972
TANA RIVER,TANA NORTH,24,938,925,1863
TANA RIVER,TANA NORTH,20-24,5312,5526,10838
TANA RIVER,TANA NORTH,25,1402,1453,2855
TANA RIVER,TANA NORTH,26,748,795,1543
TANA RIVER,TANA NORTH,27,732,856,1588
TANA RIVER,TANA NORTH,28,749,851,1600
TANA RIVER,TANA NORTH,29,539,604,1143
TANA RIVER,TANA NORTH,25-29,4170,4559,8729
TANA RIVER,TANA NORTH,30,1413,1632,3045
TANA RIVER,TANA NORTH,31,565,557,1122
TANA RIVER,TANA NORTH,32,709,768,1477
TANA RIVER,TANA NORTH,33,437,497,934
TANA RIVER,TANA NORTH,34,454,402,856
TANA RIVER,TANA NORTH,30-34,3578,3856,7434
TANA RIVER,TANA NORTH,35,1100,994,2094
TANA RIVER,TANA NORTH,36,443,425,868
TANA RIVER,TANA NORTH,37,495,394,889
TANA RIVER,TANA NORTH,38,386,374,760
TANA RIVER,TANA NORTH,39,324,252,576
TANA RIVER,TANA NORTH,35-39,2748,2439,5187
TANA RIVER,TANA NORTH,40,1052,986,2038
TANA RIVER,TANA NORTH,41,434,345,779
TANA RIVER,TANA NORTH,42,381,319,700
TANA RIVER,TANA NORTH,43,257,217,474
TANA RIVER,TANA NORTH,44,230,150,380
TANA RIVER,TANA NORTH,40-44,2354,2017,4371
TANA RIVER,TANA NORTH,45,667,578,1245
TANA RIVER,TANA NORTH,46,310,262,572
TANA RIVER,TANA NORTH,47,209,221,430
TANA RIVER,TANA NORTH,48,230,175,405
TANA RIVER,TANA NORTH,49,205,165,370
TANA RIVER,TANA NORTH,45-49,1621,1401,3022
TANA RIVER,TANA NORTH,50,614,588,1202
TANA RIVER,TANA NORTH,51,145,149,294
TANA RIVER,TANA NORTH,52,214,189,403
TANA RIVER,TANA NORTH,53,131,110,241
TANA RIVER,TANA NORTH,54,171,134,305
TANA RIVER,TANA NORTH,50-54,1275,1170,2445
TANA RIVER,TANA NORTH,55,266,210,476
TANA RIVER,TANA NORTH,56,203,149,352
TANA RIVER,TANA NORTH,57,205,157,362
TANA RIVER,TANA NORTH,58,172,173,345
TANA RIVER,TANA NORTH,59,154,156,310
TANA RIVER,TANA NORTH,55-59,1000,845,1845
TANA RIVER,TANA NORTH,60,434,481,915
TANA RIVER,TANA NORTH,61,144,113,257
TANA RIVER,TANA NORTH,62,151,133,284
TANA RIVER,TANA NORTH,63,130,107,237
TANA RIVER,TANA NORTH,64,118,88,206
TANA RIVER,TANA NORTH,60-64,977,922,1899
TANA RIVER,TANA NORTH,65,197,212,409
TANA RIVER,TANA NORTH,66,88,99,187
TANA RIVER,TANA NORTH,67,109,86,195
TANA RIVER,TANA NORTH,68,76,72,148
TANA RIVER,TANA NORTH,69,84,104,188
TANA RIVER,TANA NORTH,65-69,554,573,1127
TANA RIVER,TANA NORTH,70,266,351,617
TANA RIVER,TANA NORTH,71,56,65,121
TANA RIVER,TANA NORTH,72,51,39,90
TANA RIVER,TANA NORTH,73,52,27,79
TANA RIVER,TANA NORTH,74,44,48,92
TANA RIVER,TANA NORTH,70-74,469,530,999
TANA RIVER,TANA NORTH,75,75,95,170
TANA RIVER,TANA NORTH,76,33,37,70
TANA RIVER,TANA NORTH,77,37,17,54
TANA RIVER,TANA NORTH,78,40,25,65
TANA RIVER,TANA NORTH,79,29,20,49
TANA RIVER,TANA NORTH,75-79,214,194,408
TANA RIVER,TANA NORTH,80,105,153,258
TANA RIVER,TANA NORTH,81,14,14,28
TANA RIVER,TANA NORTH,82,26,15,41
TANA RIVER,TANA NORTH,83,16,20,36
TANA RIVER,TANA NORTH,84,19,12,31
TANA RIVER,TANA NORTH,80-84,180,214,394
TANA RIVER,TANA NORTH,85,33,26,59
TANA RIVER,TANA NORTH,86,8,11,19
TANA RIVER,TANA NORTH,87,17,13,30
TANA RIVER,TANA NORTH,88,7,4,11
TANA RIVER,TANA NORTH,89,17,25,42
TANA RIVER,TANA NORTH,85-89,82,79,161
TANA RIVER,TANA NORTH,90,28,51,79
TANA RIVER,TANA NORTH,91,5,11,16
TANA RIVER,TANA NORTH,92,5,6,11
TANA RIVER,TANA NORTH,93,3,2,5
TANA RIVER,TANA NORTH,94,1,2,3
TANA RIVER,TANA NORTH,90-94,42,72,114
TANA RIVER,TANA NORTH,95,-,10,10
TANA RIVER,TANA NORTH,96,3,5,8
TANA RIVER,TANA NORTH,97,2,4,6
TANA RIVER,TANA NORTH,98,3,4,7
TANA RIVER,TANA NORTH,99,1,2,3
TANA RIVER,TANA NORTH,95-99,9,25,34
TANA RIVER,TANA NORTH,100+,17,27,44
TANA RIVER,TANA NORTH,Not Stated,1,-,1
TANA RIVER,TANA RIVER,Total,43711,44835,88546
TANA RIVER,TANA RIVER,0,1418,1386,2804
TANA RIVER,TANA RIVER,1,1454,1347,2801
TANA RIVER,TANA RIVER,2,1535,1509,3044
TANA RIVER,TANA RIVER,3,1618,1580,3198
TANA RIVER,TANA RIVER,4,1681,1645,3326
TANA RIVER,TANA RIVER,0 - 4,7706,7467,15173
TANA RIVER,TANA RIVER,5,1675,1576,3251
TANA RIVER,TANA RIVER,6,1637,1553,3190
TANA RIVER,TANA RIVER,7,1623,1478,3101
TANA RIVER,TANA RIVER,8,1449,1497,2946
TANA RIVER,TANA RIVER,9,1264,1241,2505
TANA RIVER,TANA RIVER,05-Sep,7648,7345,14993
TANA RIVER,TANA RIVER,10,1609,1689,3298
TANA RIVER,TANA RIVER,11,1131,1151,2282
TANA RIVER,TANA RIVER,12,1518,1450,2968
TANA RIVER,TANA RIVER,13,1189,1249,2438
TANA RIVER,TANA RIVER,14,1206,1106,2312
TANA RIVER,TANA RIVER,Oct-14,6653,6645,13298
TANA RIVER,TANA RIVER,15,1217,1156,2373
TANA RIVER,TANA RIVER,16,876,828,1704
TANA RIVER,TANA RIVER,17,903,803,1706
TANA RIVER,TANA RIVER,18,799,867,1666
TANA RIVER,TANA RIVER,19,724,824,1548
TANA RIVER,TANA RIVER,15-19,4519,4478,8997
TANA RIVER,TANA RIVER,20,820,1008,1828
TANA RIVER,TANA RIVER,21,553,761,1314
TANA RIVER,TANA RIVER,22,713,799,1512
TANA RIVER,TANA RIVER,23,711,856,1567
TANA RIVER,TANA RIVER,24,661,728,1389
TANA RIVER,TANA RIVER,20-24,3458,4152,7610
TANA RIVER,TANA RIVER,25,895,1057,1952
TANA RIVER,TANA RIVER,26,585,620,1205
TANA RIVER,TANA RIVER,27,551,712,1263
TANA RIVER,TANA RIVER,28,473,624,1097
TANA RIVER,TANA RIVER,29,452,485,937
TANA RIVER,TANA RIVER,25-29,2956,3498,6454
TANA RIVER,TANA RIVER,30,756,877,1633
TANA RIVER,TANA RIVER,31,344,420,764
TANA RIVER,TANA RIVER,32,420,434,854
TANA RIVER,TANA RIVER,33,316,367,683
TANA RIVER,TANA RIVER,34,318,332,650
TANA RIVER,TANA RIVER,30-34,2154,2430,4584
TANA RIVER,TANA RIVER,35,656,709,1365
TANA RIVER,TANA RIVER,36,370,384,754
TANA RIVER,TANA RIVER,37,331,361,692
TANA RIVER,TANA RIVER,38,264,270,534
TANA RIVER,TANA RIVER,39,258,225,483
TANA RIVER,TANA RIVER,35-39,1879,1949,3828
TANA RIVER,TANA RIVER,40,540,514,1054
TANA RIVER,TANA RIVER,41,344,339,683
TANA RIVER,TANA RIVER,42,286,237,523
TANA RIVER,TANA RIVER,43,188,173,361
TANA RIVER,TANA RIVER,44,156,132,288
TANA RIVER,TANA RIVER,40-44,1514,1395,2909
TANA RIVER,TANA RIVER,45,478,537,1015
TANA RIVER,TANA RIVER,46,259,330,589
TANA RIVER,TANA RIVER,47,261,198,459
TANA RIVER,TANA RIVER,48,178,165,343
TANA RIVER,TANA RIVER,49,174,153,327
TANA RIVER,TANA RIVER,45-49,1350,1383,2733
TANA RIVER,TANA RIVER,50,350,328,678
TANA RIVER,TANA RIVER,51,141,140,281
TANA RIVER,TANA RIVER,52,148,176,324
TANA RIVER,TANA RIVER,53,126,108,234
TANA RIVER,TANA RIVER,54,141,168,309
TANA RIVER,TANA RIVER,50-54,906,920,1826
TANA RIVER,TANA RIVER,55,217,153,370
TANA RIVER,TANA RIVER,56,179,151,330
TANA RIVER,TANA RIVER,57,174,230,404
TANA RIVER,TANA RIVER,58,181,218,399
TANA RIVER,TANA RIVER,59,179,189,368
TANA RIVER,TANA RIVER,55-59,930,941,1871
TANA RIVER,TANA RIVER,60,247,310,557
TANA RIVER,TANA RIVER,61,153,161,314
TANA RIVER,TANA RIVER,62,123,120,243
TANA RIVER,TANA RIVER,63,122,146,268
TANA RIVER,TANA RIVER,64,80,88,168
TANA RIVER,TANA RIVER,60-64,725,825,1550
TANA RIVER,TANA RIVER,65,152,160,312
TANA RIVER,TANA RIVER,66,70,102,172
TANA RIVER,TANA RIVER,67,108,91,199
TANA RIVER,TANA RIVER,68,76,63,139
TANA RIVER,TANA RIVER,69,94,104,198
TANA RIVER,TANA RIVER,65-69,500,520,1020
TANA RIVER,TANA RIVER,70,155,195,350
TANA RIVER,TANA RIVER,71,76,99,175
TANA RIVER,TANA RIVER,72,47,50,97
TANA RIVER,TANA RIVER,73,44,46,90
TANA RIVER,TANA RIVER,74,48,45,93
TANA RIVER,TANA RIVER,70-74,370,435,805
TANA RIVER,TANA RIVER,75,57,63,120
TANA RIVER,TANA RIVER,76,43,53,96
TANA RIVER,TANA RIVER,77,28,28,56
TANA RIVER,TANA RIVER,78,36,26,62
TANA RIVER,TANA RIVER,79,43,32,75
TANA RIVER,TANA RIVER,75-79,207,202,409
TANA RIVER,TANA RIVER,80,55,68,123
TANA RIVER,TANA RIVER,81,25,29,54
TANA RIVER,TANA RIVER,82,15,16,31
TANA RIVER,TANA RIVER,83,15,11,26
TANA RIVER,TANA RIVER,84,11,14,25
TANA RIVER,TANA RIVER,80-84,121,138,259
TANA RIVER,TANA RIVER,85,23,17,40
TANA RIVER,TANA RIVER,86,13,7,20
TANA RIVER,TANA RIVER,87,12,14,26
TANA RIVER,TANA RIVER,88,13,3,16
TANA RIVER,TANA RIVER,89,14,18,32
TANA RIVER,TANA RIVER,85-89,75,59,134
TANA RIVER,TANA RIVER,90,9,15,24
TANA RIVER,TANA RIVER,91,3,6,9
TANA RIVER,TANA RIVER,92,2,1,3
TANA RIVER,TANA RIVER,93,2,2,4
TANA RIVER,TANA RIVER,94,4,-,4
TANA RIVER,TANA RIVER,90-94,20,24,44
TANA RIVER,TANA RIVER,95,4,6,10
TANA RIVER,TANA RIVER,96,2,-,2
TANA RIVER,TANA RIVER,97,-,2,2
TANA RIVER,TANA RIVER,98,1,3,4
TANA RIVER,TANA RIVER,99,3,5,8
TANA RIVER,TANA RIVER,95-99,10,16,26
TANA RIVER,TANA RIVER,100+,9,12,21
TANA RIVER,TANA RIVER,Not Stated,1,1,2
THARAKA-NITHI,ALL,Total,193764,199406,393170
THARAKA-NITHI,ALL,0,3902,3889,7791
THARAKA-NITHI,ALL,1,3951,3974,7925
THARAKA-NITHI,ALL,2,4091,4017,8108
THARAKA-NITHI,ALL,3,4143,4257,8400
THARAKA-NITHI,ALL,4,4082,4078,8160
THARAKA-NITHI,ALL,0 - 4,20169,20215,40384
THARAKA-NITHI,ALL,5,4272,4140,8412
THARAKA-NITHI,ALL,6,4175,4220,8395
THARAKA-NITHI,ALL,7,4382,4269,8651
THARAKA-NITHI,ALL,8,4302,4311,8613
THARAKA-NITHI,ALL,9,4583,4548,9131
THARAKA-NITHI,ALL,05-Sep,21714,21488,43202
THARAKA-NITHI,ALL,10,4811,4628,9439
THARAKA-NITHI,ALL,11,4447,4544,8991
THARAKA-NITHI,ALL,12,5048,4960,10008
THARAKA-NITHI,ALL,13,5045,4998,10043
THARAKA-NITHI,ALL,14,4889,4754,9643
THARAKA-NITHI,ALL,Oct-14,24240,23884,48124
THARAKA-NITHI,ALL,15,4656,4716,9372
THARAKA-NITHI,ALL,16,4489,4589,9078
THARAKA-NITHI,ALL,17,4662,4333,8995
THARAKA-NITHI,ALL,18,3811,3667,7478
THARAKA-NITHI,ALL,19,3930,3848,7778
THARAKA-NITHI,ALL,15-19,21548,21153,42701
THARAKA-NITHI,ALL,20,3395,3590,6985
THARAKA-NITHI,ALL,21,3074,3132,6206
THARAKA-NITHI,ALL,22,2978,3144,6122
THARAKA-NITHI,ALL,23,3100,3394,6494
THARAKA-NITHI,ALL,24,2839,2996,5835
THARAKA-NITHI,ALL,20-24,15386,16256,31642
THARAKA-NITHI,ALL,25,3054,3045,6099
THARAKA-NITHI,ALL,26,2490,2655,5145
THARAKA-NITHI,ALL,27,2691,2835,5526
THARAKA-NITHI,ALL,28,2243,2463,4706
THARAKA-NITHI,ALL,29,2582,2791,5373
THARAKA-NITHI,ALL,25-29,13060,13789,26849
THARAKA-NITHI,ALL,30,3136,3556,6692
THARAKA-NITHI,ALL,31,2481,2441,4922
THARAKA-NITHI,ALL,32,2846,3195,6041
THARAKA-NITHI,ALL,33,2656,2958,5614
THARAKA-NITHI,ALL,34,2175,2468,4643
THARAKA-NITHI,ALL,30-34,13294,14618,27912
THARAKA-NITHI,ALL,35,3218,3356,6574
THARAKA-NITHI,ALL,36,2226,2256,4482
THARAKA-NITHI,ALL,37,2376,2261,4637
THARAKA-NITHI,ALL,38,1941,1968,3909
THARAKA-NITHI,ALL,39,2379,2442,4821
THARAKA-NITHI,ALL,35-39,12140,12283,24423
THARAKA-NITHI,ALL,40,2712,2641,5353
THARAKA-NITHI,ALL,41,2336,2146,4482
THARAKA-NITHI,ALL,42,2130,2029,4159
THARAKA-NITHI,ALL,43,1857,1934,3791
THARAKA-NITHI,ALL,44,1714,1749,3463
THARAKA-NITHI,ALL,40-44,10749,10499,21248
THARAKA-NITHI,ALL,45,2447,2589,5036
THARAKA-NITHI,ALL,46,2102,2143,4245
THARAKA-NITHI,ALL,47,1953,1950,3903
THARAKA-NITHI,ALL,48,1535,1516,3051
THARAKA-NITHI,ALL,49,1858,1897,3755
THARAKA-NITHI,ALL,45-49,9895,10095,19990
THARAKA-NITHI,ALL,50,1956,2111,4067
THARAKA-NITHI,ALL,51,1583,1470,3053
THARAKA-NITHI,ALL,52,1211,1069,2280
THARAKA-NITHI,ALL,53,960,933,1893
THARAKA-NITHI,ALL,54,1302,1154,2456
THARAKA-NITHI,ALL,50-54,7012,6737,13749
THARAKA-NITHI,ALL,55,1449,1319,2768
THARAKA-NITHI,ALL,56,1599,1522,3121
THARAKA-NITHI,ALL,57,1215,1468,2683
THARAKA-NITHI,ALL,58,1195,1261,2456
THARAKA-NITHI,ALL,59,1406,1480,2886
THARAKA-NITHI,ALL,55-59,6864,7050,13914
THARAKA-NITHI,ALL,60,1676,1705,3381
THARAKA-NITHI,ALL,61,1197,1226,2423
THARAKA-NITHI,ALL,62,1042,975,2017
THARAKA-NITHI,ALL,63,937,999,1936
THARAKA-NITHI,ALL,64,679,671,1350
THARAKA-NITHI,ALL,60-64,5531,5576,11107
THARAKA-NITHI,ALL,65,1014,1168,2182
THARAKA-NITHI,ALL,66,707,728,1435
THARAKA-NITHI,ALL,67,1191,1234,2425
THARAKA-NITHI,ALL,68,578,619,1197
THARAKA-NITHI,ALL,69,855,1099,1954
THARAKA-NITHI,ALL,65-69,4345,4848,9193
THARAKA-NITHI,ALL,70,1107,1539,2646
THARAKA-NITHI,ALL,71,807,900,1707
THARAKA-NITHI,ALL,72,574,667,1241
THARAKA-NITHI,ALL,73,415,545,960
THARAKA-NITHI,ALL,74,462,644,1106
THARAKA-NITHI,ALL,70-74,3365,4295,7660
THARAKA-NITHI,ALL,75,435,517,952
THARAKA-NITHI,ALL,76,289,352,641
THARAKA-NITHI,ALL,77,431,539,970
THARAKA-NITHI,ALL,78,278,277,555
THARAKA-NITHI,ALL,79,347,618,965
THARAKA-NITHI,ALL,75-79,1780,2303,4083
THARAKA-NITHI,ALL,80,474,714,1188
THARAKA-NITHI,ALL,81,205,373,578
THARAKA-NITHI,ALL,82,180,196,376
THARAKA-NITHI,ALL,83,232,286,518
THARAKA-NITHI,ALL,84,180,305,485
THARAKA-NITHI,ALL,80-84,1271,1874,3145
THARAKA-NITHI,ALL,85,173,257,430
THARAKA-NITHI,ALL,86,125,152,277
THARAKA-NITHI,ALL,87,174,247,421
THARAKA-NITHI,ALL,88,96,115,211
THARAKA-NITHI,ALL,89,209,437,646
THARAKA-NITHI,ALL,85-89,777,1208,1985
THARAKA-NITHI,ALL,90,96,206,302
THARAKA-NITHI,ALL,91,83,155,238
THARAKA-NITHI,ALL,92,39,64,103
THARAKA-NITHI,ALL,93,42,69,111
THARAKA-NITHI,ALL,94,51,76,127
THARAKA-NITHI,ALL,90-94,311,570,881
THARAKA-NITHI,ALL,95,46,87,133
THARAKA-NITHI,ALL,96,20,51,71
THARAKA-NITHI,ALL,97,70,83,153
THARAKA-NITHI,ALL,98,26,45,71
THARAKA-NITHI,ALL,99,59,151,210
THARAKA-NITHI,ALL,95-99,221,417,638
THARAKA-NITHI,ALL,100+,87,243,330
THARAKA-NITHI,ALL,Not Stated,5,5,10
THARAKA-NITHI,IGAMBANG'OMBE,Total,26464,26745,53209
THARAKA-NITHI,IGAMBANG'OMBE,0,571,575,1146
THARAKA-NITHI,IGAMBANG'OMBE,1,552,565,1117
THARAKA-NITHI,IGAMBANG'OMBE,2,620,559,1179
THARAKA-NITHI,IGAMBANG'OMBE,3,583,610,1193
THARAKA-NITHI,IGAMBANG'OMBE,4,602,594,1196
THARAKA-NITHI,IGAMBANG'OMBE,0 - 4,2928,2903,5831
THARAKA-NITHI,IGAMBANG'OMBE,5,642,608,1250
THARAKA-NITHI,IGAMBANG'OMBE,6,631,609,1240
THARAKA-NITHI,IGAMBANG'OMBE,7,596,631,1227
THARAKA-NITHI,IGAMBANG'OMBE,8,627,630,1257
THARAKA-NITHI,IGAMBANG'OMBE,9,635,604,1239
THARAKA-NITHI,IGAMBANG'OMBE,05-Sep,3131,3082,6213
THARAKA-NITHI,IGAMBANG'OMBE,10,753,692,1445
THARAKA-NITHI,IGAMBANG'OMBE,11,692,651,1343
THARAKA-NITHI,IGAMBANG'OMBE,12,714,706,1420
THARAKA-NITHI,IGAMBANG'OMBE,13,749,772,1521
THARAKA-NITHI,IGAMBANG'OMBE,14,723,647,1370
THARAKA-NITHI,IGAMBANG'OMBE,Oct-14,3631,3468,7099
THARAKA-NITHI,IGAMBANG'OMBE,15,741,682,1423
THARAKA-NITHI,IGAMBANG'OMBE,16,650,670,1320
THARAKA-NITHI,IGAMBANG'OMBE,17,657,598,1255
THARAKA-NITHI,IGAMBANG'OMBE,18,471,503,974
THARAKA-NITHI,IGAMBANG'OMBE,19,526,526,1052
THARAKA-NITHI,IGAMBANG'OMBE,15-19,3045,2979,6024
THARAKA-NITHI,IGAMBANG'OMBE,20,438,496,934
THARAKA-NITHI,IGAMBANG'OMBE,21,400,387,787
THARAKA-NITHI,IGAMBANG'OMBE,22,380,393,773
THARAKA-NITHI,IGAMBANG'OMBE,23,385,423,808
THARAKA-NITHI,IGAMBANG'OMBE,24,354,389,743
THARAKA-NITHI,IGAMBANG'OMBE,20-24,1957,2088,4045
THARAKA-NITHI,IGAMBANG'OMBE,25,436,414,850
THARAKA-NITHI,IGAMBANG'OMBE,26,301,326,627
THARAKA-NITHI,IGAMBANG'OMBE,27,366,373,739
THARAKA-NITHI,IGAMBANG'OMBE,28,307,305,612
THARAKA-NITHI,IGAMBANG'OMBE,29,351,375,726
THARAKA-NITHI,IGAMBANG'OMBE,25-29,1761,1793,3554
THARAKA-NITHI,IGAMBANG'OMBE,30,436,479,915
THARAKA-NITHI,IGAMBANG'OMBE,31,326,318,644
THARAKA-NITHI,IGAMBANG'OMBE,32,424,440,864
THARAKA-NITHI,IGAMBANG'OMBE,33,356,406,762
THARAKA-NITHI,IGAMBANG'OMBE,34,294,333,627
THARAKA-NITHI,IGAMBANG'OMBE,30-34,1836,1976,3812
THARAKA-NITHI,IGAMBANG'OMBE,35,380,436,816
THARAKA-NITHI,IGAMBANG'OMBE,36,260,272,532
THARAKA-NITHI,IGAMBANG'OMBE,37,330,253,583
THARAKA-NITHI,IGAMBANG'OMBE,38,247,244,491
THARAKA-NITHI,IGAMBANG'OMBE,39,292,301,593
THARAKA-NITHI,IGAMBANG'OMBE,35-39,1509,1506,3015
THARAKA-NITHI,IGAMBANG'OMBE,40,338,319,657
THARAKA-NITHI,IGAMBANG'OMBE,41,311,230,541
THARAKA-NITHI,IGAMBANG'OMBE,42,271,247,518
THARAKA-NITHI,IGAMBANG'OMBE,43,230,195,425
THARAKA-NITHI,IGAMBANG'OMBE,44,208,186,394
THARAKA-NITHI,IGAMBANG'OMBE,40-44,1358,1177,2535
THARAKA-NITHI,IGAMBANG'OMBE,45,293,355,648
THARAKA-NITHI,IGAMBANG'OMBE,46,258,249,507
THARAKA-NITHI,IGAMBANG'OMBE,47,225,245,470
THARAKA-NITHI,IGAMBANG'OMBE,48,196,191,387
THARAKA-NITHI,IGAMBANG'OMBE,49,250,215,465
THARAKA-NITHI,IGAMBANG'OMBE,45-49,1222,1255,2477
THARAKA-NITHI,IGAMBANG'OMBE,50,267,263,530
THARAKA-NITHI,IGAMBANG'OMBE,51,183,189,372
THARAKA-NITHI,IGAMBANG'OMBE,52,139,133,272
THARAKA-NITHI,IGAMBANG'OMBE,53,136,123,259
THARAKA-NITHI,IGAMBANG'OMBE,54,132,136,268
THARAKA-NITHI,IGAMBANG'OMBE,50-54,857,844,1701
THARAKA-NITHI,IGAMBANG'OMBE,55,189,152,341
THARAKA-NITHI,IGAMBANG'OMBE,56,213,210,423
THARAKA-NITHI,IGAMBANG'OMBE,57,146,187,333
THARAKA-NITHI,IGAMBANG'OMBE,58,143,147,290
THARAKA-NITHI,IGAMBANG'OMBE,59,139,173,312
THARAKA-NITHI,IGAMBANG'OMBE,55-59,830,869,1699
THARAKA-NITHI,IGAMBANG'OMBE,60,189,209,398
THARAKA-NITHI,IGAMBANG'OMBE,61,139,121,260
THARAKA-NITHI,IGAMBANG'OMBE,62,163,124,287
THARAKA-NITHI,IGAMBANG'OMBE,63,120,135,255
THARAKA-NITHI,IGAMBANG'OMBE,64,92,70,162
THARAKA-NITHI,IGAMBANG'OMBE,60-64,703,659,1362
THARAKA-NITHI,IGAMBANG'OMBE,65,135,172,307
THARAKA-NITHI,IGAMBANG'OMBE,66,90,83,173
THARAKA-NITHI,IGAMBANG'OMBE,67,192,194,386
THARAKA-NITHI,IGAMBANG'OMBE,68,100,93,193
THARAKA-NITHI,IGAMBANG'OMBE,69,97,146,243
THARAKA-NITHI,IGAMBANG'OMBE,65-69,614,688,1302
THARAKA-NITHI,IGAMBANG'OMBE,70,134,223,357
THARAKA-NITHI,IGAMBANG'OMBE,71,128,103,231
THARAKA-NITHI,IGAMBANG'OMBE,72,87,83,170
THARAKA-NITHI,IGAMBANG'OMBE,73,59,70,129
THARAKA-NITHI,IGAMBANG'OMBE,74,69,88,157
THARAKA-NITHI,IGAMBANG'OMBE,70-74,477,567,1044
THARAKA-NITHI,IGAMBANG'OMBE,75,63,75,138
THARAKA-NITHI,IGAMBANG'OMBE,76,24,43,67
THARAKA-NITHI,IGAMBANG'OMBE,77,61,56,117
THARAKA-NITHI,IGAMBANG'OMBE,78,39,40,79
THARAKA-NITHI,IGAMBANG'OMBE,79,48,84,132
THARAKA-NITHI,IGAMBANG'OMBE,75-79,235,298,533
THARAKA-NITHI,IGAMBANG'OMBE,80,76,104,180
THARAKA-NITHI,IGAMBANG'OMBE,81,28,52,80
THARAKA-NITHI,IGAMBANG'OMBE,82,26,24,50
THARAKA-NITHI,IGAMBANG'OMBE,83,32,36,68
THARAKA-NITHI,IGAMBANG'OMBE,84,25,41,66
THARAKA-NITHI,IGAMBANG'OMBE,80-84,187,257,444
THARAKA-NITHI,IGAMBANG'OMBE,85,18,36,54
THARAKA-NITHI,IGAMBANG'OMBE,86,10,22,32
THARAKA-NITHI,IGAMBANG'OMBE,87,25,37,62
THARAKA-NITHI,IGAMBANG'OMBE,88,16,20,36
THARAKA-NITHI,IGAMBANG'OMBE,89,26,55,81
THARAKA-NITHI,IGAMBANG'OMBE,85-89,95,170,265
THARAKA-NITHI,IGAMBANG'OMBE,90,20,37,57
THARAKA-NITHI,IGAMBANG'OMBE,91,12,18,30
THARAKA-NITHI,IGAMBANG'OMBE,92,7,14,21
THARAKA-NITHI,IGAMBANG'OMBE,93,3,12,15
THARAKA-NITHI,IGAMBANG'OMBE,94,7,11,18
THARAKA-NITHI,IGAMBANG'OMBE,90-94,49,92,141
THARAKA-NITHI,IGAMBANG'OMBE,95,8,11,19
THARAKA-NITHI,IGAMBANG'OMBE,96,-,5,5
THARAKA-NITHI,IGAMBANG'OMBE,97,7,5,12
THARAKA-NITHI,IGAMBANG'OMBE,98,3,7,10
THARAKA-NITHI,IGAMBANG'OMBE,99,8,14,22
THARAKA-NITHI,IGAMBANG'OMBE,95-99,26,42,68
THARAKA-NITHI,IGAMBANG'OMBE,100+,11,31,42
THARAKA-NITHI,IGAMBANG'OMBE,Not Stated,2,1,3
THARAKA-NITHI,MAARA,Total,57689,57205,114894
THARAKA-NITHI,MAARA,0,982,976,1958
THARAKA-NITHI,MAARA,1,1035,1109,2144
THARAKA-NITHI,MAARA,2,1076,1048,2124
THARAKA-NITHI,MAARA,3,1108,1108,2216
THARAKA-NITHI,MAARA,4,1125,1060,2185
THARAKA-NITHI,MAARA,0 - 4,5326,5301,10627
THARAKA-NITHI,MAARA,5,1126,1022,2148
THARAKA-NITHI,MAARA,6,1045,1135,2180
THARAKA-NITHI,MAARA,7,1136,1121,2257
THARAKA-NITHI,MAARA,8,1117,1144,2261
THARAKA-NITHI,MAARA,9,1255,1193,2448
THARAKA-NITHI,MAARA,05-Sep,5679,5615,11294
THARAKA-NITHI,MAARA,10,1215,1176,2391
THARAKA-NITHI,MAARA,11,1143,1195,2338
THARAKA-NITHI,MAARA,12,1325,1290,2615
THARAKA-NITHI,MAARA,13,1339,1305,2644
THARAKA-NITHI,MAARA,14,1243,1229,2472
THARAKA-NITHI,MAARA,Oct-14,6265,6195,12460
THARAKA-NITHI,MAARA,15,1165,1239,2404
THARAKA-NITHI,MAARA,16,1204,1172,2376
THARAKA-NITHI,MAARA,17,1316,1109,2425
THARAKA-NITHI,MAARA,18,1052,961,2013
THARAKA-NITHI,MAARA,19,1042,953,1995
THARAKA-NITHI,MAARA,15-19,5779,5434,11213
THARAKA-NITHI,MAARA,20,904,854,1758
THARAKA-NITHI,MAARA,21,865,773,1638
THARAKA-NITHI,MAARA,22,867,787,1654
THARAKA-NITHI,MAARA,23,880,885,1765
THARAKA-NITHI,MAARA,24,794,782,1576
THARAKA-NITHI,MAARA,20-24,4310,4081,8391
THARAKA-NITHI,MAARA,25,805,724,1529
THARAKA-NITHI,MAARA,26,734,720,1454
THARAKA-NITHI,MAARA,27,753,751,1504
THARAKA-NITHI,MAARA,28,656,691,1347
THARAKA-NITHI,MAARA,29,785,773,1558
THARAKA-NITHI,MAARA,25-29,3733,3659,7392
THARAKA-NITHI,MAARA,30,892,1067,1959
THARAKA-NITHI,MAARA,31,732,686,1418
THARAKA-NITHI,MAARA,32,886,936,1822
THARAKA-NITHI,MAARA,33,852,849,1701
THARAKA-NITHI,MAARA,34,736,713,1449
THARAKA-NITHI,MAARA,30-34,4098,4251,8349
THARAKA-NITHI,MAARA,35,992,928,1920
THARAKA-NITHI,MAARA,36,710,648,1358
THARAKA-NITHI,MAARA,37,753,635,1388
THARAKA-NITHI,MAARA,38,638,609,1247
THARAKA-NITHI,MAARA,39,784,711,1495
THARAKA-NITHI,MAARA,35-39,3877,3531,7408
THARAKA-NITHI,MAARA,40,935,847,1782
THARAKA-NITHI,MAARA,41,765,696,1461
THARAKA-NITHI,MAARA,42,696,652,1348
THARAKA-NITHI,MAARA,43,619,625,1244
THARAKA-NITHI,MAARA,44,660,578,1238
THARAKA-NITHI,MAARA,40-44,3675,3398,7073
THARAKA-NITHI,MAARA,45,816,791,1607
THARAKA-NITHI,MAARA,46,731,683,1414
THARAKA-NITHI,MAARA,47,633,658,1291
THARAKA-NITHI,MAARA,48,563,546,1109
THARAKA-NITHI,MAARA,49,656,683,1339
THARAKA-NITHI,MAARA,45-49,3399,3361,6760
THARAKA-NITHI,MAARA,50,659,746,1405
THARAKA-NITHI,MAARA,51,544,494,1038
THARAKA-NITHI,MAARA,52,456,358,814
THARAKA-NITHI,MAARA,53,379,339,718
THARAKA-NITHI,MAARA,54,473,403,876
THARAKA-NITHI,MAARA,50-54,2511,2340,4851
THARAKA-NITHI,MAARA,55,544,459,1003
THARAKA-NITHI,MAARA,56,537,488,1025
THARAKA-NITHI,MAARA,57,448,542,990
THARAKA-NITHI,MAARA,58,451,437,888
THARAKA-NITHI,MAARA,59,556,519,1075
THARAKA-NITHI,MAARA,55-59,2536,2445,4981
THARAKA-NITHI,MAARA,60,602,611,1213
THARAKA-NITHI,MAARA,61,444,478,922
THARAKA-NITHI,MAARA,62,379,392,771
THARAKA-NITHI,MAARA,63,373,350,723
THARAKA-NITHI,MAARA,64,274,261,535
THARAKA-NITHI,MAARA,60-64,2072,2092,4164
THARAKA-NITHI,MAARA,65,409,421,830
THARAKA-NITHI,MAARA,66,305,301,606
THARAKA-NITHI,MAARA,67,416,423,839
THARAKA-NITHI,MAARA,68,230,217,447
THARAKA-NITHI,MAARA,69,356,378,734
THARAKA-NITHI,MAARA,65-69,1716,1740,3456
THARAKA-NITHI,MAARA,70,404,536,940
THARAKA-NITHI,MAARA,71,269,273,542
THARAKA-NITHI,MAARA,72,195,224,419
THARAKA-NITHI,MAARA,73,145,185,330
THARAKA-NITHI,MAARA,74,173,236,409
THARAKA-NITHI,MAARA,70-74,1186,1454,2640
THARAKA-NITHI,MAARA,75,157,161,318
THARAKA-NITHI,MAARA,76,101,136,237
THARAKA-NITHI,MAARA,77,151,209,360
THARAKA-NITHI,MAARA,78,70,91,161
THARAKA-NITHI,MAARA,79,110,166,276
THARAKA-NITHI,MAARA,75-79,589,763,1352
THARAKA-NITHI,MAARA,80,156,263,419
THARAKA-NITHI,MAARA,81,79,131,210
THARAKA-NITHI,MAARA,82,69,79,148
THARAKA-NITHI,MAARA,83,84,119,203
THARAKA-NITHI,MAARA,84,61,110,171
THARAKA-NITHI,MAARA,80-84,449,702,1151
THARAKA-NITHI,MAARA,85,67,77,144
THARAKA-NITHI,MAARA,86,41,69,110
THARAKA-NITHI,MAARA,87,65,79,144
THARAKA-NITHI,MAARA,88,26,36,62
THARAKA-NITHI,MAARA,89,68,140,208
THARAKA-NITHI,MAARA,85-89,267,401,668
THARAKA-NITHI,MAARA,90,23,75,98
THARAKA-NITHI,MAARA,91,29,47,76
THARAKA-NITHI,MAARA,92,20,19,39
THARAKA-NITHI,MAARA,93,13,23,36
THARAKA-NITHI,MAARA,94,18,30,48
THARAKA-NITHI,MAARA,90-94,103,194,297
THARAKA-NITHI,MAARA,95,14,35,49
THARAKA-NITHI,MAARA,96,8,20,28
THARAKA-NITHI,MAARA,97,39,34,73
THARAKA-NITHI,MAARA,98,10,17,27
THARAKA-NITHI,MAARA,99,19,52,71
THARAKA-NITHI,MAARA,95-99,90,158,248
THARAKA-NITHI,MAARA,100+,29,88,117
THARAKA-NITHI,MAARA,Not Stated,-,2,2
THARAKA-NITHI,MERU SOUTH,Total,44923,46155,91078
THARAKA-NITHI,MERU SOUTH,0,961,923,1884
THARAKA-NITHI,MERU SOUTH,1,897,861,1758
THARAKA-NITHI,MERU SOUTH,2,858,834,1692
THARAKA-NITHI,MERU SOUTH,3,889,912,1801
THARAKA-NITHI,MERU SOUTH,4,848,920,1768
THARAKA-NITHI,MERU SOUTH,0 - 4,4453,4450,8903
THARAKA-NITHI,MERU SOUTH,5,801,815,1616
THARAKA-NITHI,MERU SOUTH,6,836,795,1631
THARAKA-NITHI,MERU SOUTH,7,907,851,1758
THARAKA-NITHI,MERU SOUTH,8,846,778,1624
THARAKA-NITHI,MERU SOUTH,9,884,963,1847
THARAKA-NITHI,MERU SOUTH,05-Sep,4274,4202,8476
THARAKA-NITHI,MERU SOUTH,10,985,883,1868
THARAKA-NITHI,MERU SOUTH,11,826,918,1744
THARAKA-NITHI,MERU SOUTH,12,1029,1032,2061
THARAKA-NITHI,MERU SOUTH,13,1068,1003,2071
THARAKA-NITHI,MERU SOUTH,14,1006,951,1957
THARAKA-NITHI,MERU SOUTH,Oct-14,4914,4787,9701
THARAKA-NITHI,MERU SOUTH,15,932,944,1876
THARAKA-NITHI,MERU SOUTH,16,901,914,1815
THARAKA-NITHI,MERU SOUTH,17,905,916,1821
THARAKA-NITHI,MERU SOUTH,18,806,792,1598
THARAKA-NITHI,MERU SOUTH,19,858,857,1715
THARAKA-NITHI,MERU SOUTH,15-19,4402,4423,8825
THARAKA-NITHI,MERU SOUTH,20,806,814,1620
THARAKA-NITHI,MERU SOUTH,21,741,773,1514
THARAKA-NITHI,MERU SOUTH,22,764,799,1563
THARAKA-NITHI,MERU SOUTH,23,889,887,1776
THARAKA-NITHI,MERU SOUTH,24,814,763,1577
THARAKA-NITHI,MERU SOUTH,20-24,4014,4036,8050
THARAKA-NITHI,MERU SOUTH,25,807,745,1552
THARAKA-NITHI,MERU SOUTH,26,673,662,1335
THARAKA-NITHI,MERU SOUTH,27,710,688,1398
THARAKA-NITHI,MERU SOUTH,28,599,645,1244
THARAKA-NITHI,MERU SOUTH,29,626,716,1342
THARAKA-NITHI,MERU SOUTH,25-29,3415,3456,6871
THARAKA-NITHI,MERU SOUTH,30,790,830,1620
THARAKA-NITHI,MERU SOUTH,31,654,605,1259
THARAKA-NITHI,MERU SOUTH,32,727,841,1568
THARAKA-NITHI,MERU SOUTH,33,659,685,1344
THARAKA-NITHI,MERU SOUTH,34,506,608,1114
THARAKA-NITHI,MERU SOUTH,30-34,3336,3569,6905
THARAKA-NITHI,MERU SOUTH,35,771,797,1568
THARAKA-NITHI,MERU SOUTH,36,593,584,1177
THARAKA-NITHI,MERU SOUTH,37,581,556,1137
THARAKA-NITHI,MERU SOUTH,38,558,524,1082
THARAKA-NITHI,MERU SOUTH,39,633,615,1248
THARAKA-NITHI,MERU SOUTH,35-39,3136,3076,6212
THARAKA-NITHI,MERU SOUTH,40,695,722,1417
THARAKA-NITHI,MERU SOUTH,41,609,560,1169
THARAKA-NITHI,MERU SOUTH,42,539,529,1068
THARAKA-NITHI,MERU SOUTH,43,466,481,947
THARAKA-NITHI,MERU SOUTH,44,390,438,828
THARAKA-NITHI,MERU SOUTH,40-44,2699,2730,5429
THARAKA-NITHI,MERU SOUTH,45,599,629,1228
THARAKA-NITHI,MERU SOUTH,46,499,529,1028
THARAKA-NITHI,MERU SOUTH,47,486,486,972
THARAKA-NITHI,MERU SOUTH,48,375,381,756
THARAKA-NITHI,MERU SOUTH,49,445,435,880
THARAKA-NITHI,MERU SOUTH,45-49,2404,2460,4864
THARAKA-NITHI,MERU SOUTH,50,483,564,1047
THARAKA-NITHI,MERU SOUTH,51,430,370,800
THARAKA-NITHI,MERU SOUTH,52,328,341,669
THARAKA-NITHI,MERU SOUTH,53,237,272,509
THARAKA-NITHI,MERU SOUTH,54,359,322,681
THARAKA-NITHI,MERU SOUTH,50-54,1837,1869,3706
THARAKA-NITHI,MERU SOUTH,55,355,382,737
THARAKA-NITHI,MERU SOUTH,56,449,416,865
THARAKA-NITHI,MERU SOUTH,57,343,439,782
THARAKA-NITHI,MERU SOUTH,58,291,309,600
THARAKA-NITHI,MERU SOUTH,59,391,383,774
THARAKA-NITHI,MERU SOUTH,55-59,1829,1929,3758
THARAKA-NITHI,MERU SOUTH,60,421,414,835
THARAKA-NITHI,MERU SOUTH,61,290,297,587
THARAKA-NITHI,MERU SOUTH,62,278,261,539
THARAKA-NITHI,MERU SOUTH,63,227,249,476
THARAKA-NITHI,MERU SOUTH,64,147,165,312
THARAKA-NITHI,MERU SOUTH,60-64,1363,1386,2749
THARAKA-NITHI,MERU SOUTH,65,254,285,539
THARAKA-NITHI,MERU SOUTH,66,178,210,388
THARAKA-NITHI,MERU SOUTH,67,279,313,592
THARAKA-NITHI,MERU SOUTH,68,128,155,283
THARAKA-NITHI,MERU SOUTH,69,191,227,418
THARAKA-NITHI,MERU SOUTH,65-69,1030,1190,2220
THARAKA-NITHI,MERU SOUTH,70,264,367,631
THARAKA-NITHI,MERU SOUTH,71,152,205,357
THARAKA-NITHI,MERU SOUTH,72,127,176,303
THARAKA-NITHI,MERU SOUTH,73,101,124,225
THARAKA-NITHI,MERU SOUTH,74,105,158,263
THARAKA-NITHI,MERU SOUTH,70-74,749,1030,1779
THARAKA-NITHI,MERU SOUTH,75,100,134,234
THARAKA-NITHI,MERU SOUTH,76,75,78,153
THARAKA-NITHI,MERU SOUTH,77,102,160,262
THARAKA-NITHI,MERU SOUTH,78,80,71,151
THARAKA-NITHI,MERU SOUTH,79,67,132,199
THARAKA-NITHI,MERU SOUTH,75-79,424,575,999
THARAKA-NITHI,MERU SOUTH,80,116,142,258
THARAKA-NITHI,MERU SOUTH,81,55,84,139
THARAKA-NITHI,MERU SOUTH,82,40,41,81
THARAKA-NITHI,MERU SOUTH,83,64,62,126
THARAKA-NITHI,MERU SOUTH,84,52,91,143
THARAKA-NITHI,MERU SOUTH,80-84,327,420,747
THARAKA-NITHI,MERU SOUTH,85,32,71,103
THARAKA-NITHI,MERU SOUTH,86,35,29,64
THARAKA-NITHI,MERU SOUTH,87,35,52,87
THARAKA-NITHI,MERU SOUTH,88,27,21,48
THARAKA-NITHI,MERU SOUTH,89,39,94,133
THARAKA-NITHI,MERU SOUTH,85-89,168,267,435
THARAKA-NITHI,MERU SOUTH,90,24,52,76
THARAKA-NITHI,MERU SOUTH,91,21,44,65
THARAKA-NITHI,MERU SOUTH,92,7,12,19
THARAKA-NITHI,MERU SOUTH,93,16,17,33
THARAKA-NITHI,MERU SOUTH,94,12,27,39
THARAKA-NITHI,MERU SOUTH,90-94,80,152,232
THARAKA-NITHI,MERU SOUTH,95,9,23,32
THARAKA-NITHI,MERU SOUTH,96,6,12,18
THARAKA-NITHI,MERU SOUTH,97,14,20,34
THARAKA-NITHI,MERU SOUTH,98,6,11,17
THARAKA-NITHI,MERU SOUTH,99,13,34,47
THARAKA-NITHI,MERU SOUTH,95-99,48,100,148
THARAKA-NITHI,MERU SOUTH,100+,19,46,65
THARAKA-NITHI,MERU SOUTH,Not Stated,2,2,4
THARAKA-NITHI,THARAKA NORTH,Total,28290,30053,58343
THARAKA-NITHI,THARAKA NORTH,0,583,616,1199
THARAKA-NITHI,THARAKA NORTH,1,667,657,1324
THARAKA-NITHI,THARAKA NORTH,2,700,711,1411
THARAKA-NITHI,THARAKA NORTH,3,709,747,1456
THARAKA-NITHI,THARAKA NORTH,4,705,699,1404
THARAKA-NITHI,THARAKA NORTH,0 - 4,3364,3430,6794
THARAKA-NITHI,THARAKA NORTH,5,786,830,1616
THARAKA-NITHI,THARAKA NORTH,6,756,837,1593
THARAKA-NITHI,THARAKA NORTH,7,813,806,1619
THARAKA-NITHI,THARAKA NORTH,8,814,783,1597
THARAKA-NITHI,THARAKA NORTH,9,823,822,1645
THARAKA-NITHI,THARAKA NORTH,05-Sep,3992,4078,8070
THARAKA-NITHI,THARAKA NORTH,10,909,897,1806
THARAKA-NITHI,THARAKA NORTH,11,808,823,1631
THARAKA-NITHI,THARAKA NORTH,12,876,883,1759
THARAKA-NITHI,THARAKA NORTH,13,825,827,1652
THARAKA-NITHI,THARAKA NORTH,14,870,866,1736
THARAKA-NITHI,THARAKA NORTH,Oct-14,4288,4296,8584
THARAKA-NITHI,THARAKA NORTH,15,851,787,1638
THARAKA-NITHI,THARAKA NORTH,16,749,801,1550
THARAKA-NITHI,THARAKA NORTH,17,750,734,1484
THARAKA-NITHI,THARAKA NORTH,18,618,622,1240
THARAKA-NITHI,THARAKA NORTH,19,634,643,1277
THARAKA-NITHI,THARAKA NORTH,15-19,3602,3587,7189
THARAKA-NITHI,THARAKA NORTH,20,539,632,1171
THARAKA-NITHI,THARAKA NORTH,21,412,504,916
THARAKA-NITHI,THARAKA NORTH,22,405,521,926
THARAKA-NITHI,THARAKA NORTH,23,376,491,867
THARAKA-NITHI,THARAKA NORTH,24,381,481,862
THARAKA-NITHI,THARAKA NORTH,20-24,2113,2629,4742
THARAKA-NITHI,THARAKA NORTH,25,443,481,924
THARAKA-NITHI,THARAKA NORTH,26,333,361,694
THARAKA-NITHI,THARAKA NORTH,27,350,441,791
THARAKA-NITHI,THARAKA NORTH,28,272,334,606
THARAKA-NITHI,THARAKA NORTH,29,349,393,742
THARAKA-NITHI,THARAKA NORTH,25-29,1747,2010,3757
THARAKA-NITHI,THARAKA NORTH,30,463,521,984
THARAKA-NITHI,THARAKA NORTH,31,311,338,649
THARAKA-NITHI,THARAKA NORTH,32,328,385,713
THARAKA-NITHI,THARAKA NORTH,33,343,408,751
THARAKA-NITHI,THARAKA NORTH,34,258,298,556
THARAKA-NITHI,THARAKA NORTH,30-34,1703,1950,3653
THARAKA-NITHI,THARAKA NORTH,35,486,555,1041
THARAKA-NITHI,THARAKA NORTH,36,267,298,565
THARAKA-NITHI,THARAKA NORTH,37,267,363,630
THARAKA-NITHI,THARAKA NORTH,38,208,247,455
THARAKA-NITHI,THARAKA NORTH,39,277,389,666
THARAKA-NITHI,THARAKA NORTH,35-39,1505,1852,3357
THARAKA-NITHI,THARAKA NORTH,40,385,364,749
THARAKA-NITHI,THARAKA NORTH,41,280,272,552
THARAKA-NITHI,THARAKA NORTH,42,265,238,503
THARAKA-NITHI,THARAKA NORTH,43,236,274,510
THARAKA-NITHI,THARAKA NORTH,44,173,235,408
THARAKA-NITHI,THARAKA NORTH,40-44,1339,1383,2722
THARAKA-NITHI,THARAKA NORTH,45,367,354,721
THARAKA-NITHI,THARAKA NORTH,46,263,274,537
THARAKA-NITHI,THARAKA NORTH,47,245,210,455
THARAKA-NITHI,THARAKA NORTH,48,156,159,315
THARAKA-NITHI,THARAKA NORTH,49,237,218,455
THARAKA-NITHI,THARAKA NORTH,45-49,1268,1215,2483
THARAKA-NITHI,THARAKA NORTH,50,261,221,482
THARAKA-NITHI,THARAKA NORTH,51,176,155,331
THARAKA-NITHI,THARAKA NORTH,52,104,81,185
THARAKA-NITHI,THARAKA NORTH,53,88,85,173
THARAKA-NITHI,THARAKA NORTH,54,131,110,241
THARAKA-NITHI,THARAKA NORTH,50-54,760,652,1412
THARAKA-NITHI,THARAKA NORTH,55,153,136,289
THARAKA-NITHI,THARAKA NORTH,56,177,156,333
THARAKA-NITHI,THARAKA NORTH,57,119,108,227
THARAKA-NITHI,THARAKA NORTH,58,123,146,269
THARAKA-NITHI,THARAKA NORTH,59,136,174,310
THARAKA-NITHI,THARAKA NORTH,55-59,708,720,1428
THARAKA-NITHI,THARAKA NORTH,60,231,209,440
THARAKA-NITHI,THARAKA NORTH,61,139,143,282
THARAKA-NITHI,THARAKA NORTH,62,86,83,169
THARAKA-NITHI,THARAKA NORTH,63,82,111,193
THARAKA-NITHI,THARAKA NORTH,64,73,65,138
THARAKA-NITHI,THARAKA NORTH,60-64,611,611,1222
THARAKA-NITHI,THARAKA NORTH,65,90,120,210
THARAKA-NITHI,THARAKA NORTH,66,54,45,99
THARAKA-NITHI,THARAKA NORTH,67,128,124,252
THARAKA-NITHI,THARAKA NORTH,68,43,62,105
THARAKA-NITHI,THARAKA NORTH,69,90,154,244
THARAKA-NITHI,THARAKA NORTH,65-69,405,505,910
THARAKA-NITHI,THARAKA NORTH,70,132,178,310
THARAKA-NITHI,THARAKA NORTH,71,132,106,238
THARAKA-NITHI,THARAKA NORTH,72,73,80,153
THARAKA-NITHI,THARAKA NORTH,73,41,66,107
THARAKA-NITHI,THARAKA NORTH,74,47,69,116
THARAKA-NITHI,THARAKA NORTH,70-74,425,499,924
THARAKA-NITHI,THARAKA NORTH,75,49,44,93
THARAKA-NITHI,THARAKA NORTH,76,32,29,61
THARAKA-NITHI,THARAKA NORTH,77,35,30,65
THARAKA-NITHI,THARAKA NORTH,78,34,26,60
THARAKA-NITHI,THARAKA NORTH,79,53,98,151
THARAKA-NITHI,THARAKA NORTH,75-79,203,227,430
THARAKA-NITHI,THARAKA NORTH,80,53,83,136
THARAKA-NITHI,THARAKA NORTH,81,14,32,46
THARAKA-NITHI,THARAKA NORTH,82,16,6,22
THARAKA-NITHI,THARAKA NORTH,83,21,13,34
THARAKA-NITHI,THARAKA NORTH,84,15,29,44
THARAKA-NITHI,THARAKA NORTH,80-84,119,163,282
THARAKA-NITHI,THARAKA NORTH,85,19,17,36
THARAKA-NITHI,THARAKA NORTH,86,12,9,21
THARAKA-NITHI,THARAKA NORTH,87,11,14,25
THARAKA-NITHI,THARAKA NORTH,88,8,15,23
THARAKA-NITHI,THARAKA NORTH,89,27,58,85
THARAKA-NITHI,THARAKA NORTH,85-89,77,113,190
THARAKA-NITHI,THARAKA NORTH,90,15,17,32
THARAKA-NITHI,THARAKA NORTH,91,6,14,20
THARAKA-NITHI,THARAKA NORTH,92,1,2,3
THARAKA-NITHI,THARAKA NORTH,93,2,2,4
THARAKA-NITHI,THARAKA NORTH,94,1,2,3
THARAKA-NITHI,THARAKA NORTH,90-94,25,37,62
THARAKA-NITHI,THARAKA NORTH,95,4,6,10
THARAKA-NITHI,THARAKA NORTH,96,-,4,4
THARAKA-NITHI,THARAKA NORTH,97,7,13,20
THARAKA-NITHI,THARAKA NORTH,98,4,4,8
THARAKA-NITHI,THARAKA NORTH,99,8,29,37
THARAKA-NITHI,THARAKA NORTH,95-99,23,56,79
THARAKA-NITHI,THARAKA NORTH,100+,12,40,52
THARAKA-NITHI,THARAKA NORTH,Not Stated,1,-,1
THARAKA-NITHI,THARAKA SOUTH,Total,36190,39058,75248
THARAKA-NITHI,THARAKA SOUTH,0,795,790,1585
THARAKA-NITHI,THARAKA SOUTH,1,797,778,1575
THARAKA-NITHI,THARAKA SOUTH,2,837,863,1700
THARAKA-NITHI,THARAKA SOUTH,3,850,877,1727
THARAKA-NITHI,THARAKA SOUTH,4,800,803,1603
THARAKA-NITHI,THARAKA SOUTH,0 - 4,4079,4111,8190
THARAKA-NITHI,THARAKA SOUTH,5,917,863,1780
THARAKA-NITHI,THARAKA SOUTH,6,902,843,1745
THARAKA-NITHI,THARAKA SOUTH,7,927,858,1785
THARAKA-NITHI,THARAKA SOUTH,8,897,974,1871
THARAKA-NITHI,THARAKA SOUTH,9,983,964,1947
THARAKA-NITHI,THARAKA SOUTH,05-Sep,4626,4502,9128
THARAKA-NITHI,THARAKA SOUTH,10,948,979,1927
THARAKA-NITHI,THARAKA SOUTH,11,978,955,1933
THARAKA-NITHI,THARAKA SOUTH,12,1103,1048,2151
THARAKA-NITHI,THARAKA SOUTH,13,1064,1090,2154
THARAKA-NITHI,THARAKA SOUTH,14,1045,1061,2106
THARAKA-NITHI,THARAKA SOUTH,Oct-14,5138,5133,10271
THARAKA-NITHI,THARAKA SOUTH,15,965,1064,2029
THARAKA-NITHI,THARAKA SOUTH,16,985,1031,2016
THARAKA-NITHI,THARAKA SOUTH,17,1033,975,2008
THARAKA-NITHI,THARAKA SOUTH,18,862,788,1650
THARAKA-NITHI,THARAKA SOUTH,19,868,867,1735
THARAKA-NITHI,THARAKA SOUTH,15-19,4713,4725,9438
THARAKA-NITHI,THARAKA SOUTH,20,706,791,1497
THARAKA-NITHI,THARAKA SOUTH,21,655,684,1339
THARAKA-NITHI,THARAKA SOUTH,22,562,631,1193
THARAKA-NITHI,THARAKA SOUTH,23,570,695,1265
THARAKA-NITHI,THARAKA SOUTH,24,495,572,1067
THARAKA-NITHI,THARAKA SOUTH,20-24,2988,3373,6361
THARAKA-NITHI,THARAKA SOUTH,25,560,677,1237
THARAKA-NITHI,THARAKA SOUTH,26,446,578,1024
THARAKA-NITHI,THARAKA SOUTH,27,503,577,1080
THARAKA-NITHI,THARAKA SOUTH,28,397,483,880
THARAKA-NITHI,THARAKA SOUTH,29,463,531,994
THARAKA-NITHI,THARAKA SOUTH,25-29,2369,2846,5215
THARAKA-NITHI,THARAKA SOUTH,30,552,655,1207
THARAKA-NITHI,THARAKA SOUTH,31,456,490,946
THARAKA-NITHI,THARAKA SOUTH,32,476,587,1063
THARAKA-NITHI,THARAKA SOUTH,33,441,608,1049
THARAKA-NITHI,THARAKA SOUTH,34,374,511,885
THARAKA-NITHI,THARAKA SOUTH,30-34,2299,2851,5150
THARAKA-NITHI,THARAKA SOUTH,35,582,633,1215
THARAKA-NITHI,THARAKA SOUTH,36,389,452,841
THARAKA-NITHI,THARAKA SOUTH,37,443,450,893
THARAKA-NITHI,THARAKA SOUTH,38,282,344,626
THARAKA-NITHI,THARAKA SOUTH,39,388,422,810
THARAKA-NITHI,THARAKA SOUTH,35-39,2084,2301,4385
THARAKA-NITHI,THARAKA SOUTH,40,354,388,742
THARAKA-NITHI,THARAKA SOUTH,41,369,387,756
THARAKA-NITHI,THARAKA SOUTH,42,355,362,717
THARAKA-NITHI,THARAKA SOUTH,43,304,357,661
THARAKA-NITHI,THARAKA SOUTH,44,282,311,593
THARAKA-NITHI,THARAKA SOUTH,40-44,1664,1805,3469
THARAKA-NITHI,THARAKA SOUTH,45,369,460,829
THARAKA-NITHI,THARAKA SOUTH,46,349,407,756
THARAKA-NITHI,THARAKA SOUTH,47,361,351,712
THARAKA-NITHI,THARAKA SOUTH,48,241,237,478
THARAKA-NITHI,THARAKA SOUTH,49,267,344,611
THARAKA-NITHI,THARAKA SOUTH,45-49,1587,1799,3386
THARAKA-NITHI,THARAKA SOUTH,50,283,315,598
THARAKA-NITHI,THARAKA SOUTH,51,249,260,509
THARAKA-NITHI,THARAKA SOUTH,52,183,156,339
THARAKA-NITHI,THARAKA SOUTH,53,118,114,232
THARAKA-NITHI,THARAKA SOUTH,54,205,183,388
THARAKA-NITHI,THARAKA SOUTH,50-54,1038,1028,2066
THARAKA-NITHI,THARAKA SOUTH,55,207,189,396
THARAKA-NITHI,THARAKA SOUTH,56,223,251,474
THARAKA-NITHI,THARAKA SOUTH,57,157,191,348
THARAKA-NITHI,THARAKA SOUTH,58,184,222,406
THARAKA-NITHI,THARAKA SOUTH,59,182,231,413
THARAKA-NITHI,THARAKA SOUTH,55-59,953,1084,2037
THARAKA-NITHI,THARAKA SOUTH,60,232,259,491
THARAKA-NITHI,THARAKA SOUTH,61,184,186,370
THARAKA-NITHI,THARAKA SOUTH,62,136,114,250
THARAKA-NITHI,THARAKA SOUTH,63,131,154,285
THARAKA-NITHI,THARAKA SOUTH,64,93,110,203
THARAKA-NITHI,THARAKA SOUTH,60-64,776,823,1599
THARAKA-NITHI,THARAKA SOUTH,65,126,168,294
THARAKA-NITHI,THARAKA SOUTH,66,80,89,169
THARAKA-NITHI,THARAKA SOUTH,67,174,179,353
THARAKA-NITHI,THARAKA SOUTH,68,74,92,166
THARAKA-NITHI,THARAKA SOUTH,69,120,194,314
THARAKA-NITHI,THARAKA SOUTH,65-69,574,722,1296
THARAKA-NITHI,THARAKA SOUTH,70,169,235,404
THARAKA-NITHI,THARAKA SOUTH,71,125,213,338
THARAKA-NITHI,THARAKA SOUTH,72,92,102,194
THARAKA-NITHI,THARAKA SOUTH,73,68,100,168
THARAKA-NITHI,THARAKA SOUTH,74,66,92,158
THARAKA-NITHI,THARAKA SOUTH,70-74,520,742,1262
THARAKA-NITHI,THARAKA SOUTH,75,66,103,169
THARAKA-NITHI,THARAKA SOUTH,76,57,65,122
THARAKA-NITHI,THARAKA SOUTH,77,81,84,165
THARAKA-NITHI,THARAKA SOUTH,78,55,49,104
THARAKA-NITHI,THARAKA SOUTH,79,68,137,205
THARAKA-NITHI,THARAKA SOUTH,75-79,327,438,765
THARAKA-NITHI,THARAKA SOUTH,80,72,120,192
THARAKA-NITHI,THARAKA SOUTH,81,28,73,101
THARAKA-NITHI,THARAKA SOUTH,82,29,46,75
THARAKA-NITHI,THARAKA SOUTH,83,31,56,87
THARAKA-NITHI,THARAKA SOUTH,84,27,34,61
THARAKA-NITHI,THARAKA SOUTH,80-84,187,329,516
THARAKA-NITHI,THARAKA SOUTH,85,36,55,91
THARAKA-NITHI,THARAKA SOUTH,86,27,22,49
THARAKA-NITHI,THARAKA SOUTH,87,38,64,102
THARAKA-NITHI,THARAKA SOUTH,88,18,22,40
THARAKA-NITHI,THARAKA SOUTH,89,48,89,137
THARAKA-NITHI,THARAKA SOUTH,85-89,167,252,419
THARAKA-NITHI,THARAKA SOUTH,90,14,25,39
THARAKA-NITHI,THARAKA SOUTH,91,15,32,47
THARAKA-NITHI,THARAKA SOUTH,92,4,17,21
THARAKA-NITHI,THARAKA SOUTH,93,8,15,23
THARAKA-NITHI,THARAKA SOUTH,94,12,6,18
THARAKA-NITHI,THARAKA SOUTH,90-94,53,95,148
THARAKA-NITHI,THARAKA SOUTH,95,11,12,23
THARAKA-NITHI,THARAKA SOUTH,96,4,10,14
THARAKA-NITHI,THARAKA SOUTH,97,3,11,14
THARAKA-NITHI,THARAKA SOUTH,98,3,6,9
THARAKA-NITHI,THARAKA SOUTH,99,11,22,33
THARAKA-NITHI,THARAKA SOUTH,95-99,32,61,93
THARAKA-NITHI,THARAKA SOUTH,100+,16,38,54
THARAKA-NITHI,MT. KENYA FOREST,Total,208,190,398
THARAKA-NITHI,MT. KENYA FOREST,0,10,9,19
THARAKA-NITHI,MT. KENYA FOREST,1,3,4,7
THARAKA-NITHI,MT. KENYA FOREST,2,-,2,2
THARAKA-NITHI,MT. KENYA FOREST,3,4,3,7
THARAKA-NITHI,MT. KENYA FOREST,4,2,2,4
THARAKA-NITHI,MT. KENYA FOREST,0 - 4,19,20,39
THARAKA-NITHI,MT. KENYA FOREST,5,-,2,2
THARAKA-NITHI,MT. KENYA FOREST,6,5,1,6
THARAKA-NITHI,MT. KENYA FOREST,7,3,2,5
THARAKA-NITHI,MT. KENYA FOREST,8,1,2,3
THARAKA-NITHI,MT. KENYA FOREST,9,3,2,5
THARAKA-NITHI,MT. KENYA FOREST,05-Sep,12,9,21
THARAKA-NITHI,MT. KENYA FOREST,10,1,1,2
THARAKA-NITHI,MT. KENYA FOREST,11,-,2,2
THARAKA-NITHI,MT. KENYA FOREST,12,1,1,2
THARAKA-NITHI,MT. KENYA FOREST,13,-,1,1
THARAKA-NITHI,MT. KENYA FOREST,14,2,-,2
THARAKA-NITHI,MT. KENYA FOREST,Oct-14,4,5,9
THARAKA-NITHI,MT. KENYA FOREST,15,2,-,2
THARAKA-NITHI,MT. KENYA FOREST,16,-,1,1
THARAKA-NITHI,MT. KENYA FOREST,17,1,1,2
THARAKA-NITHI,MT. KENYA FOREST,18,2,1,3
THARAKA-NITHI,MT. KENYA FOREST,19,2,2,4
THARAKA-NITHI,MT. KENYA FOREST,15-19,7,5,12
THARAKA-NITHI,MT. KENYA FOREST,20,2,3,5
THARAKA-NITHI,MT. KENYA FOREST,21,1,11,12
THARAKA-NITHI,MT. KENYA FOREST,22,-,13,13
THARAKA-NITHI,MT. KENYA FOREST,23,-,13,13
THARAKA-NITHI,MT. KENYA FOREST,24,1,9,10
THARAKA-NITHI,MT. KENYA FOREST,20-24,4,49,53
THARAKA-NITHI,MT. KENYA FOREST,25,3,4,7
THARAKA-NITHI,MT. KENYA FOREST,26,3,8,11
THARAKA-NITHI,MT. KENYA FOREST,27,9,5,14
THARAKA-NITHI,MT. KENYA FOREST,28,12,5,17
THARAKA-NITHI,MT. KENYA FOREST,29,8,3,11
THARAKA-NITHI,MT. KENYA FOREST,25-29,35,25,60
THARAKA-NITHI,MT. KENYA FOREST,30,3,4,7
THARAKA-NITHI,MT. KENYA FOREST,31,2,4,6
THARAKA-NITHI,MT. KENYA FOREST,32,5,6,11
THARAKA-NITHI,MT. KENYA FOREST,33,5,2,7
THARAKA-NITHI,MT. KENYA FOREST,34,7,5,12
THARAKA-NITHI,MT. KENYA FOREST,30-34,22,21,43
THARAKA-NITHI,MT. KENYA FOREST,35,7,7,14
THARAKA-NITHI,MT. KENYA FOREST,36,7,2,9
THARAKA-NITHI,MT. KENYA FOREST,37,2,4,6
THARAKA-NITHI,MT. KENYA FOREST,38,8,-,8
THARAKA-NITHI,MT. KENYA FOREST,39,5,4,9
THARAKA-NITHI,MT. KENYA FOREST,35-39,29,17,46
THARAKA-NITHI,MT. KENYA FOREST,40,5,1,6
THARAKA-NITHI,MT. KENYA FOREST,41,2,1,3
THARAKA-NITHI,MT. KENYA FOREST,42,4,1,5
THARAKA-NITHI,MT. KENYA FOREST,43,2,2,4
THARAKA-NITHI,MT. KENYA FOREST,44,1,1,2
THARAKA-NITHI,MT. KENYA FOREST,40-44,14,6,20
THARAKA-NITHI,MT. KENYA FOREST,45,3,-,3
THARAKA-NITHI,MT. KENYA FOREST,46,2,1,3
THARAKA-NITHI,MT. KENYA FOREST,47,3,-,3
THARAKA-NITHI,MT. KENYA FOREST,48,4,2,6
THARAKA-NITHI,MT. KENYA FOREST,49,3,2,5
THARAKA-NITHI,MT. KENYA FOREST,45-49,15,5,20
THARAKA-NITHI,MT. KENYA FOREST,50,3,2,5
THARAKA-NITHI,MT. KENYA FOREST,51,1,2,3
THARAKA-NITHI,MT. KENYA FOREST,52,1,-,1
THARAKA-NITHI,MT. KENYA FOREST,53,2,-,2
THARAKA-NITHI,MT. KENYA FOREST,54,2,-,2
THARAKA-NITHI,MT. KENYA FOREST,50-54,9,4,13
THARAKA-NITHI,MT. KENYA FOREST,55,1,1,2
THARAKA-NITHI,MT. KENYA FOREST,56,-,1,1
THARAKA-NITHI,MT. KENYA FOREST,57,2,1,3
THARAKA-NITHI,MT. KENYA FOREST,58,3,-,3
THARAKA-NITHI,MT. KENYA FOREST,59,2,-,2
THARAKA-NITHI,MT. KENYA FOREST,55-59,8,3,11
THARAKA-NITHI,MT. KENYA FOREST,60,1,3,4
THARAKA-NITHI,MT. KENYA FOREST,61,1,1,2
THARAKA-NITHI,MT. KENYA FOREST,62,-,1,1
THARAKA-NITHI,MT. KENYA FOREST,63,4,-,4
THARAKA-NITHI,MT. KENYA FOREST,64,-,-,-
THARAKA-NITHI,MT. KENYA FOREST,60-64,6,5,11
THARAKA-NITHI,MT. KENYA FOREST,65,-,2,2
THARAKA-NITHI,MT. KENYA FOREST,66,-,-,0
THARAKA-NITHI,MT. KENYA FOREST,67,2,1,3
THARAKA-NITHI,MT. KENYA FOREST,68,3,-,3
THARAKA-NITHI,MT. KENYA FOREST,69,1,-,1
THARAKA-NITHI,MT. KENYA FOREST,65-69,6,3,9
THARAKA-NITHI,MT. KENYA FOREST,70,4,-,4
THARAKA-NITHI,MT. KENYA FOREST,71,1,-,1
THARAKA-NITHI,MT. KENYA FOREST,72,-,2,2
THARAKA-NITHI,MT. KENYA FOREST,73,1,-,1
THARAKA-NITHI,MT. KENYA FOREST,74,2,1,3
THARAKA-NITHI,MT. KENYA FOREST,70-74,8,3,11
THARAKA-NITHI,MT. KENYA FOREST,75,-,-,-
THARAKA-NITHI,MT. KENYA FOREST,76,-,1,1
THARAKA-NITHI,MT. KENYA FOREST,77,1,-,1
THARAKA-NITHI,MT. KENYA FOREST,78,-,-,-
THARAKA-NITHI,MT. KENYA FOREST,79,1,1,2
THARAKA-NITHI,MT. KENYA FOREST,75-79,2,2,4
THARAKA-NITHI,MT. KENYA FOREST,80,1,2,3
THARAKA-NITHI,MT. KENYA FOREST,81,1,1,2
THARAKA-NITHI,MT. KENYA FOREST,82,-,-,-
THARAKA-NITHI,MT. KENYA FOREST,83,-,-,-
THARAKA-NITHI,MT. KENYA FOREST,84,-,-,-
THARAKA-NITHI,MT. KENYA FOREST,80-84,2,3,5
THARAKA-NITHI,MT. KENYA FOREST,85,1,1,2
THARAKA-NITHI,MT. KENYA FOREST,86,-,1,1
THARAKA-NITHI,MT. KENYA FOREST,87,-,1,1
THARAKA-NITHI,MT. KENYA FOREST,88,1,1,2
THARAKA-NITHI,MT. KENYA FOREST,89,1,1,2
THARAKA-NITHI,MT. KENYA FOREST,85-89,3,5,8
THARAKA-NITHI,MT. KENYA FOREST,90,-,-,-
THARAKA-NITHI,MT. KENYA FOREST,91,-,-,-
THARAKA-NITHI,MT. KENYA FOREST,92,-,-,-
THARAKA-NITHI,MT. KENYA FOREST,93,-,-,-
THARAKA-NITHI,MT. KENYA FOREST,94,1,-,1
THARAKA-NITHI,MT. KENYA FOREST,90-94,1,-,1
THARAKA-NITHI,MT. KENYA FOREST,95,-,-,-
THARAKA-NITHI,MT. KENYA FOREST,96,2,-,2
THARAKA-NITHI,MT. KENYA FOREST,97,-,-,-
THARAKA-NITHI,MT. KENYA FOREST,98,-,-,-
THARAKA-NITHI,MT. KENYA FOREST,99,-,-,-
THARAKA-NITHI,MT. KENYA FOREST,95-99,2,-,2
THARAKA-NITHI,MT. KENYA FOREST,100+,-,-,-
THARAKA-NITHI,MT. KENYA FOREST,Not Stated,-,-,-
TRANS NZOIA,ALL,Total,489107,501206,990313
TRANS NZOIA,ALL,0,11952,11755,23707
TRANS NZOIA,ALL,1,12652,12595,25247
TRANS NZOIA,ALL,2,12779,12530,25309
TRANS NZOIA,ALL,3,13852,13781,27633
TRANS NZOIA,ALL,4,14091,13571,27662
TRANS NZOIA,ALL,0 - 4,65326,64232,129558
TRANS NZOIA,ALL,5,14281,13811,28092
TRANS NZOIA,ALL,6,14377,14325,28702
TRANS NZOIA,ALL,7,14186,14298,28484
TRANS NZOIA,ALL,8,13427,13642,27069
TRANS NZOIA,ALL,9,15364,15211,30575
TRANS NZOIA,ALL,05-Sep,71635,71287,142922
TRANS NZOIA,ALL,10,15532,14796,30328
TRANS NZOIA,ALL,11,13934,14535,28469
TRANS NZOIA,ALL,12,15568,15057,30625
TRANS NZOIA,ALL,13,15319,15296,30615
TRANS NZOIA,ALL,14,14803,14508,29311
TRANS NZOIA,ALL,Oct-14,75156,74192,149348
TRANS NZOIA,ALL,15,14321,13981,28302
TRANS NZOIA,ALL,16,13191,13001,26192
TRANS NZOIA,ALL,17,13947,13013,26960
TRANS NZOIA,ALL,18,10561,9909,20470
TRANS NZOIA,ALL,19,11609,11011,22620
TRANS NZOIA,ALL,15-19,63629,60915,124544
TRANS NZOIA,ALL,20,9718,10000,19718
TRANS NZOIA,ALL,21,8222,8662,16884
TRANS NZOIA,ALL,22,7874,8675,16549
TRANS NZOIA,ALL,23,7892,8990,16882
TRANS NZOIA,ALL,24,7051,8024,15075
TRANS NZOIA,ALL,20-24,40757,44351,85108
TRANS NZOIA,ALL,25,7691,8648,16339
TRANS NZOIA,ALL,26,6134,7340,13474
TRANS NZOIA,ALL,27,6768,7506,14274
TRANS NZOIA,ALL,28,5195,6051,11246
TRANS NZOIA,ALL,29,5937,6679,12616
TRANS NZOIA,ALL,25-29,31725,36224,67949
TRANS NZOIA,ALL,30,7110,8123,15233
TRANS NZOIA,ALL,31,5327,6067,11394
TRANS NZOIA,ALL,32,6924,7811,14735
TRANS NZOIA,ALL,33,5557,6669,12226
TRANS NZOIA,ALL,34,5197,5755,10952
TRANS NZOIA,ALL,30-34,30115,34425,64540
TRANS NZOIA,ALL,35,6596,6582,13178
TRANS NZOIA,ALL,36,4668,4713,9381
TRANS NZOIA,ALL,37,4868,4491,9359
TRANS NZOIA,ALL,38,3769,3575,7344
TRANS NZOIA,ALL,39,4154,3892,8046
TRANS NZOIA,ALL,35-39,24055,23253,47308
TRANS NZOIA,ALL,40,4910,4809,9719
TRANS NZOIA,ALL,41,4599,4866,9465
TRANS NZOIA,ALL,42,4821,4851,9672
TRANS NZOIA,ALL,43,4270,4524,8794
TRANS NZOIA,ALL,44,3186,3234,6420
TRANS NZOIA,ALL,40-44,21786,22284,44070
TRANS NZOIA,ALL,45,4688,4650,9338
TRANS NZOIA,ALL,46,3380,3312,6692
TRANS NZOIA,ALL,47,3478,3547,7025
TRANS NZOIA,ALL,48,2449,2451,4900
TRANS NZOIA,ALL,49,2872,2849,5721
TRANS NZOIA,ALL,45-49,16867,16809,33676
TRANS NZOIA,ALL,50,3124,3271,6395
TRANS NZOIA,ALL,51,2656,2881,5537
TRANS NZOIA,ALL,52,2367,2589,4956
TRANS NZOIA,ALL,53,2156,2294,4450
TRANS NZOIA,ALL,54,2216,2382,4598
TRANS NZOIA,ALL,50-54,12519,13417,25936
TRANS NZOIA,ALL,55,2273,2267,4540
TRANS NZOIA,ALL,56,2115,2434,4549
TRANS NZOIA,ALL,57,2206,2951,5157
TRANS NZOIA,ALL,58,1893,2146,4039
TRANS NZOIA,ALL,59,2401,2409,4810
TRANS NZOIA,ALL,55-59,10888,12207,23095
TRANS NZOIA,ALL,60,2329,2314,4643
TRANS NZOIA,ALL,61,1960,2023,3983
TRANS NZOIA,ALL,62,1573,1603,3176
TRANS NZOIA,ALL,63,1756,1829,3585
TRANS NZOIA,ALL,64,1189,1313,2502
TRANS NZOIA,ALL,60-64,8807,9082,17889
TRANS NZOIA,ALL,65,1676,1835,3511
TRANS NZOIA,ALL,66,998,1082,2080
TRANS NZOIA,ALL,67,1486,1686,3172
TRANS NZOIA,ALL,68,731,696,1427
TRANS NZOIA,ALL,69,1246,1241,2487
TRANS NZOIA,ALL,65-69,6137,6540,12677
TRANS NZOIA,ALL,70,1176,1371,2547
TRANS NZOIA,ALL,71,1039,1122,2161
TRANS NZOIA,ALL,72,812,754,1566
TRANS NZOIA,ALL,73,760,825,1585
TRANS NZOIA,ALL,74,584,706,1290
TRANS NZOIA,ALL,70-74,4371,4778,9149
TRANS NZOIA,ALL,75,601,739,1340
TRANS NZOIA,ALL,76,483,652,1135
TRANS NZOIA,ALL,77,584,733,1317
TRANS NZOIA,ALL,78,326,365,691
TRANS NZOIA,ALL,79,353,571,924
TRANS NZOIA,ALL,75-79,2347,3060,5407
TRANS NZOIA,ALL,80,457,582,1039
TRANS NZOIA,ALL,81,270,349,619
TRANS NZOIA,ALL,82,259,318,577
TRANS NZOIA,ALL,83,344,400,744
TRANS NZOIA,ALL,84,228,293,521
TRANS NZOIA,ALL,80-84,1558,1942,3500
TRANS NZOIA,ALL,85,216,326,542
TRANS NZOIA,ALL,86,151,214,365
TRANS NZOIA,ALL,87,231,334,565
TRANS NZOIA,ALL,88,108,114,222
TRANS NZOIA,ALL,89,180,330,510
TRANS NZOIA,ALL,85-89,886,1318,2204
TRANS NZOIA,ALL,90,60,150,210
TRANS NZOIA,ALL,91,102,121,223
TRANS NZOIA,ALL,92,64,51,115
TRANS NZOIA,ALL,93,58,80,138
TRANS NZOIA,ALL,94,38,52,90
TRANS NZOIA,ALL,90-94,322,454,776
TRANS NZOIA,ALL,95,84,119,203
TRANS NZOIA,ALL,96,25,51,76
TRANS NZOIA,ALL,97,41,52,93
TRANS NZOIA,ALL,98,15,26,41
TRANS NZOIA,ALL,99,24,60,84
TRANS NZOIA,ALL,95-99,189,308,497
TRANS NZOIA,ALL,100+,31,125,156
TRANS NZOIA,ALL,Not Stated,1,3,4
TRANS NZOIA,TRANS NZOIA WEST,Total,101198,101174,202372
TRANS NZOIA,TRANS NZOIA WEST,0,2503,2501,5004
TRANS NZOIA,TRANS NZOIA WEST,1,2715,2593,5308
TRANS NZOIA,TRANS NZOIA WEST,2,2631,2602,5233
TRANS NZOIA,TRANS NZOIA WEST,3,2911,2845,5756
TRANS NZOIA,TRANS NZOIA WEST,4,2919,2800,5719
TRANS NZOIA,TRANS NZOIA WEST,0 - 4,13679,13341,27020
TRANS NZOIA,TRANS NZOIA WEST,5,2943,2891,5834
TRANS NZOIA,TRANS NZOIA WEST,6,2954,2903,5857
TRANS NZOIA,TRANS NZOIA WEST,7,2801,2853,5654
TRANS NZOIA,TRANS NZOIA WEST,8,2654,2687,5341
TRANS NZOIA,TRANS NZOIA WEST,9,3026,3184,6210
TRANS NZOIA,TRANS NZOIA WEST,05-Sep,14378,14518,28896
TRANS NZOIA,TRANS NZOIA WEST,10,3059,2779,5838
TRANS NZOIA,TRANS NZOIA WEST,11,2704,2846,5550
TRANS NZOIA,TRANS NZOIA WEST,12,3098,2881,5979
TRANS NZOIA,TRANS NZOIA WEST,13,2901,3070,5971
TRANS NZOIA,TRANS NZOIA WEST,14,2832,2763,5595
TRANS NZOIA,TRANS NZOIA WEST,Oct-14,14594,14339,28933
TRANS NZOIA,TRANS NZOIA WEST,15,2846,2748,5594
TRANS NZOIA,TRANS NZOIA WEST,16,2525,2486,5011
TRANS NZOIA,TRANS NZOIA WEST,17,2706,2595,5301
TRANS NZOIA,TRANS NZOIA WEST,18,2058,2023,4081
TRANS NZOIA,TRANS NZOIA WEST,19,2211,2298,4509
TRANS NZOIA,TRANS NZOIA WEST,15-19,12346,12150,24496
TRANS NZOIA,TRANS NZOIA WEST,20,2007,2071,4078
TRANS NZOIA,TRANS NZOIA WEST,21,1754,1865,3619
TRANS NZOIA,TRANS NZOIA WEST,22,1760,1976,3736
TRANS NZOIA,TRANS NZOIA WEST,23,1841,2059,3900
TRANS NZOIA,TRANS NZOIA WEST,24,1657,1860,3517
TRANS NZOIA,TRANS NZOIA WEST,20-24,9019,9831,18850
TRANS NZOIA,TRANS NZOIA WEST,25,1855,2034,3889
TRANS NZOIA,TRANS NZOIA WEST,26,1535,1673,3208
TRANS NZOIA,TRANS NZOIA WEST,27,1751,1734,3485
TRANS NZOIA,TRANS NZOIA WEST,28,1273,1386,2659
TRANS NZOIA,TRANS NZOIA WEST,29,1400,1447,2847
TRANS NZOIA,TRANS NZOIA WEST,25-29,7814,8274,16088
TRANS NZOIA,TRANS NZOIA WEST,30,1786,1762,3548
TRANS NZOIA,TRANS NZOIA WEST,31,1271,1315,2586
TRANS NZOIA,TRANS NZOIA WEST,32,1655,1715,3370
TRANS NZOIA,TRANS NZOIA WEST,33,1291,1375,2666
TRANS NZOIA,TRANS NZOIA WEST,34,1178,1181,2359
TRANS NZOIA,TRANS NZOIA WEST,30-34,7181,7348,14529
TRANS NZOIA,TRANS NZOIA WEST,35,1432,1385,2817
TRANS NZOIA,TRANS NZOIA WEST,36,1050,904,1954
TRANS NZOIA,TRANS NZOIA WEST,37,1034,903,1937
TRANS NZOIA,TRANS NZOIA WEST,38,810,702,1512
TRANS NZOIA,TRANS NZOIA WEST,39,894,744,1638
TRANS NZOIA,TRANS NZOIA WEST,35-39,5220,4638,9858
TRANS NZOIA,TRANS NZOIA WEST,40,1025,957,1982
TRANS NZOIA,TRANS NZOIA WEST,41,1008,1019,2027
TRANS NZOIA,TRANS NZOIA WEST,42,1035,1031,2066
TRANS NZOIA,TRANS NZOIA WEST,43,936,923,1859
TRANS NZOIA,TRANS NZOIA WEST,44,683,604,1287
TRANS NZOIA,TRANS NZOIA WEST,40-44,4687,4534,9221
TRANS NZOIA,TRANS NZOIA WEST,45,1085,896,1981
TRANS NZOIA,TRANS NZOIA WEST,46,721,635,1356
TRANS NZOIA,TRANS NZOIA WEST,47,744,707,1451
TRANS NZOIA,TRANS NZOIA WEST,48,515,455,970
TRANS NZOIA,TRANS NZOIA WEST,49,603,520,1123
TRANS NZOIA,TRANS NZOIA WEST,45-49,3668,3213,6881
TRANS NZOIA,TRANS NZOIA WEST,50,599,556,1155
TRANS NZOIA,TRANS NZOIA WEST,51,562,512,1074
TRANS NZOIA,TRANS NZOIA WEST,52,447,477,924
TRANS NZOIA,TRANS NZOIA WEST,53,433,380,813
TRANS NZOIA,TRANS NZOIA WEST,54,434,405,839
TRANS NZOIA,TRANS NZOIA WEST,50-54,2475,2330,4805
TRANS NZOIA,TRANS NZOIA WEST,55,420,414,834
TRANS NZOIA,TRANS NZOIA WEST,56,416,446,862
TRANS NZOIA,TRANS NZOIA WEST,57,446,490,936
TRANS NZOIA,TRANS NZOIA WEST,58,345,331,676
TRANS NZOIA,TRANS NZOIA WEST,59,462,424,886
TRANS NZOIA,TRANS NZOIA WEST,55-59,2089,2105,4194
TRANS NZOIA,TRANS NZOIA WEST,60,428,346,774
TRANS NZOIA,TRANS NZOIA WEST,61,350,353,703
TRANS NZOIA,TRANS NZOIA WEST,62,256,254,510
TRANS NZOIA,TRANS NZOIA WEST,63,297,310,607
TRANS NZOIA,TRANS NZOIA WEST,64,193,212,405
TRANS NZOIA,TRANS NZOIA WEST,60-64,1524,1475,2999
TRANS NZOIA,TRANS NZOIA WEST,65,283,327,610
TRANS NZOIA,TRANS NZOIA WEST,66,160,182,342
TRANS NZOIA,TRANS NZOIA WEST,67,237,273,510
TRANS NZOIA,TRANS NZOIA WEST,68,95,101,196
TRANS NZOIA,TRANS NZOIA WEST,69,208,217,425
TRANS NZOIA,TRANS NZOIA WEST,65-69,983,1100,2083
TRANS NZOIA,TRANS NZOIA WEST,70,202,205,407
TRANS NZOIA,TRANS NZOIA WEST,71,167,178,345
TRANS NZOIA,TRANS NZOIA WEST,72,107,122,229
TRANS NZOIA,TRANS NZOIA WEST,73,114,137,251
TRANS NZOIA,TRANS NZOIA WEST,74,87,105,192
TRANS NZOIA,TRANS NZOIA WEST,70-74,677,747,1424
TRANS NZOIA,TRANS NZOIA WEST,75,100,131,231
TRANS NZOIA,TRANS NZOIA WEST,76,81,105,186
TRANS NZOIA,TRANS NZOIA WEST,77,106,145,251
TRANS NZOIA,TRANS NZOIA WEST,78,47,64,111
TRANS NZOIA,TRANS NZOIA WEST,79,59,78,137
TRANS NZOIA,TRANS NZOIA WEST,75-79,393,523,916
TRANS NZOIA,TRANS NZOIA WEST,80,62,81,143
TRANS NZOIA,TRANS NZOIA WEST,81,46,58,104
TRANS NZOIA,TRANS NZOIA WEST,82,43,42,85
TRANS NZOIA,TRANS NZOIA WEST,83,56,85,141
TRANS NZOIA,TRANS NZOIA WEST,84,39,45,84
TRANS NZOIA,TRANS NZOIA WEST,80-84,246,311,557
TRANS NZOIA,TRANS NZOIA WEST,85,34,58,92
TRANS NZOIA,TRANS NZOIA WEST,86,28,42,70
TRANS NZOIA,TRANS NZOIA WEST,87,31,67,98
TRANS NZOIA,TRANS NZOIA WEST,88,11,22,33
TRANS NZOIA,TRANS NZOIA WEST,89,26,53,79
TRANS NZOIA,TRANS NZOIA WEST,85-89,130,242,372
TRANS NZOIA,TRANS NZOIA WEST,90,11,24,35
TRANS NZOIA,TRANS NZOIA WEST,91,17,24,41
TRANS NZOIA,TRANS NZOIA WEST,92,15,6,21
TRANS NZOIA,TRANS NZOIA WEST,93,10,18,28
TRANS NZOIA,TRANS NZOIA WEST,94,7,4,11
TRANS NZOIA,TRANS NZOIA WEST,90-94,60,76,136
TRANS NZOIA,TRANS NZOIA WEST,95,16,21,37
TRANS NZOIA,TRANS NZOIA WEST,96,4,6,10
TRANS NZOIA,TRANS NZOIA WEST,97,7,12,19
TRANS NZOIA,TRANS NZOIA WEST,98,3,4,7
TRANS NZOIA,TRANS NZOIA WEST,99,3,16,19
TRANS NZOIA,TRANS NZOIA WEST,95-99,33,59,92
TRANS NZOIA,TRANS NZOIA WEST,100+,2,18,20
TRANS NZOIA,TRANS NZOIA WEST,Not Stated,-,2,2
TRANS NZOIA,TRANS NZOIA EAST,Total,113498,116029,229527
TRANS NZOIA,TRANS NZOIA EAST,0,2830,2639,5469
TRANS NZOIA,TRANS NZOIA EAST,1,2834,2691,5525
TRANS NZOIA,TRANS NZOIA EAST,2,2888,2823,5711
TRANS NZOIA,TRANS NZOIA EAST,3,3128,3074,6202
TRANS NZOIA,TRANS NZOIA EAST,4,3310,3054,6364
TRANS NZOIA,TRANS NZOIA EAST,0 - 4,14990,14281,29271
TRANS NZOIA,TRANS NZOIA EAST,5,3182,3059,6241
TRANS NZOIA,TRANS NZOIA EAST,6,3215,3299,6514
TRANS NZOIA,TRANS NZOIA EAST,7,3311,3270,6581
TRANS NZOIA,TRANS NZOIA EAST,8,3106,3052,6158
TRANS NZOIA,TRANS NZOIA EAST,9,3613,3570,7183
TRANS NZOIA,TRANS NZOIA EAST,05-Sep,16427,16250,32677
TRANS NZOIA,TRANS NZOIA EAST,10,3595,3438,7033
TRANS NZOIA,TRANS NZOIA EAST,11,3414,3360,6774
TRANS NZOIA,TRANS NZOIA EAST,12,3743,3606,7349
TRANS NZOIA,TRANS NZOIA EAST,13,3718,3596,7314
TRANS NZOIA,TRANS NZOIA EAST,14,3508,3550,7058
TRANS NZOIA,TRANS NZOIA EAST,Oct-14,17978,17550,35528
TRANS NZOIA,TRANS NZOIA EAST,15,3368,3287,6655
TRANS NZOIA,TRANS NZOIA EAST,16,3243,3166,6409
TRANS NZOIA,TRANS NZOIA EAST,17,3352,3076,6428
TRANS NZOIA,TRANS NZOIA EAST,18,2518,2377,4895
TRANS NZOIA,TRANS NZOIA EAST,19,2886,2530,5416
TRANS NZOIA,TRANS NZOIA EAST,15-19,15367,14436,29803
TRANS NZOIA,TRANS NZOIA EAST,20,2374,2270,4644
TRANS NZOIA,TRANS NZOIA EAST,21,1976,1976,3952
TRANS NZOIA,TRANS NZOIA EAST,22,1799,1843,3642
TRANS NZOIA,TRANS NZOIA EAST,23,1727,1864,3591
TRANS NZOIA,TRANS NZOIA EAST,24,1528,1735,3263
TRANS NZOIA,TRANS NZOIA EAST,20-24,9404,9688,19092
TRANS NZOIA,TRANS NZOIA EAST,25,1607,1782,3389
TRANS NZOIA,TRANS NZOIA EAST,26,1278,1573,2851
TRANS NZOIA,TRANS NZOIA EAST,27,1360,1498,2858
TRANS NZOIA,TRANS NZOIA EAST,28,1043,1238,2281
TRANS NZOIA,TRANS NZOIA EAST,29,1212,1397,2609
TRANS NZOIA,TRANS NZOIA EAST,25-29,6500,7488,13988
TRANS NZOIA,TRANS NZOIA EAST,30,1479,1761,3240
TRANS NZOIA,TRANS NZOIA EAST,31,1130,1323,2453
TRANS NZOIA,TRANS NZOIA EAST,32,1453,1713,3166
TRANS NZOIA,TRANS NZOIA EAST,33,1182,1547,2729
TRANS NZOIA,TRANS NZOIA EAST,34,1132,1334,2466
TRANS NZOIA,TRANS NZOIA EAST,30-34,6376,7678,14054
TRANS NZOIA,TRANS NZOIA EAST,35,1519,1578,3097
TRANS NZOIA,TRANS NZOIA EAST,36,1087,1081,2168
TRANS NZOIA,TRANS NZOIA EAST,37,1079,1030,2109
TRANS NZOIA,TRANS NZOIA EAST,38,821,851,1672
TRANS NZOIA,TRANS NZOIA EAST,39,849,888,1737
TRANS NZOIA,TRANS NZOIA EAST,35-39,5355,5428,10783
TRANS NZOIA,TRANS NZOIA EAST,40,1097,1208,2305
TRANS NZOIA,TRANS NZOIA EAST,41,1024,1112,2136
TRANS NZOIA,TRANS NZOIA EAST,42,1068,1091,2159
TRANS NZOIA,TRANS NZOIA EAST,43,956,1046,2002
TRANS NZOIA,TRANS NZOIA EAST,44,731,780,1511
TRANS NZOIA,TRANS NZOIA EAST,40-44,4876,5237,10113
TRANS NZOIA,TRANS NZOIA EAST,45,1091,1162,2253
TRANS NZOIA,TRANS NZOIA EAST,46,790,851,1641
TRANS NZOIA,TRANS NZOIA EAST,47,841,888,1729
TRANS NZOIA,TRANS NZOIA EAST,48,545,570,1115
TRANS NZOIA,TRANS NZOIA EAST,49,691,738,1429
TRANS NZOIA,TRANS NZOIA EAST,45-49,3958,4209,8167
TRANS NZOIA,TRANS NZOIA EAST,50,774,846,1620
TRANS NZOIA,TRANS NZOIA EAST,51,595,683,1278
TRANS NZOIA,TRANS NZOIA EAST,52,554,630,1184
TRANS NZOIA,TRANS NZOIA EAST,53,510,537,1047
TRANS NZOIA,TRANS NZOIA EAST,54,580,604,1184
TRANS NZOIA,TRANS NZOIA EAST,50-54,3013,3300,6313
TRANS NZOIA,TRANS NZOIA EAST,55,560,567,1127
TRANS NZOIA,TRANS NZOIA EAST,56,540,613,1153
TRANS NZOIA,TRANS NZOIA EAST,57,549,750,1299
TRANS NZOIA,TRANS NZOIA EAST,58,509,624,1133
TRANS NZOIA,TRANS NZOIA EAST,59,586,598,1184
TRANS NZOIA,TRANS NZOIA EAST,55-59,2744,3152,5896
TRANS NZOIA,TRANS NZOIA EAST,60,607,603,1210
TRANS NZOIA,TRANS NZOIA EAST,61,500,505,1005
TRANS NZOIA,TRANS NZOIA EAST,62,404,375,779
TRANS NZOIA,TRANS NZOIA EAST,63,433,394,827
TRANS NZOIA,TRANS NZOIA EAST,64,309,334,643
TRANS NZOIA,TRANS NZOIA EAST,60-64,2253,2211,4464
TRANS NZOIA,TRANS NZOIA EAST,65,433,478,911
TRANS NZOIA,TRANS NZOIA EAST,66,243,267,510
TRANS NZOIA,TRANS NZOIA EAST,67,397,439,836
TRANS NZOIA,TRANS NZOIA EAST,68,188,194,382
TRANS NZOIA,TRANS NZOIA EAST,69,315,333,648
TRANS NZOIA,TRANS NZOIA EAST,65-69,1576,1711,3287
TRANS NZOIA,TRANS NZOIA EAST,70,336,435,771
TRANS NZOIA,TRANS NZOIA EAST,71,290,315,605
TRANS NZOIA,TRANS NZOIA EAST,72,229,211,440
TRANS NZOIA,TRANS NZOIA EAST,73,207,206,413
TRANS NZOIA,TRANS NZOIA EAST,74,153,189,342
TRANS NZOIA,TRANS NZOIA EAST,70-74,1215,1356,2571
TRANS NZOIA,TRANS NZOIA EAST,75,144,200,344
TRANS NZOIA,TRANS NZOIA EAST,76,129,189,318
TRANS NZOIA,TRANS NZOIA EAST,77,148,179,327
TRANS NZOIA,TRANS NZOIA EAST,78,88,104,192
TRANS NZOIA,TRANS NZOIA EAST,79,103,189,292
TRANS NZOIA,TRANS NZOIA EAST,75-79,612,861,1473
TRANS NZOIA,TRANS NZOIA EAST,80,137,165,302
TRANS NZOIA,TRANS NZOIA EAST,81,74,91,165
TRANS NZOIA,TRANS NZOIA EAST,82,67,94,161
TRANS NZOIA,TRANS NZOIA EAST,83,90,104,194
TRANS NZOIA,TRANS NZOIA EAST,84,79,99,178
TRANS NZOIA,TRANS NZOIA EAST,80-84,447,553,1000
TRANS NZOIA,TRANS NZOIA EAST,85,46,85,131
TRANS NZOIA,TRANS NZOIA EAST,86,40,53,93
TRANS NZOIA,TRANS NZOIA EAST,87,67,91,158
TRANS NZOIA,TRANS NZOIA EAST,88,35,36,71
TRANS NZOIA,TRANS NZOIA EAST,89,47,97,144
TRANS NZOIA,TRANS NZOIA EAST,85-89,235,362,597
TRANS NZOIA,TRANS NZOIA EAST,90,23,55,78
TRANS NZOIA,TRANS NZOIA EAST,91,24,32,56
TRANS NZOIA,TRANS NZOIA EAST,92,19,18,37
TRANS NZOIA,TRANS NZOIA EAST,93,16,20,36
TRANS NZOIA,TRANS NZOIA EAST,94,12,19,31
TRANS NZOIA,TRANS NZOIA EAST,90-94,94,144,238
TRANS NZOIA,TRANS NZOIA EAST,95,30,37,67
TRANS NZOIA,TRANS NZOIA EAST,96,10,17,27
TRANS NZOIA,TRANS NZOIA EAST,97,14,17,31
TRANS NZOIA,TRANS NZOIA EAST,98,6,7,13
TRANS NZOIA,TRANS NZOIA EAST,99,9,19,28
TRANS NZOIA,TRANS NZOIA EAST,95-99,69,97,166
TRANS NZOIA,TRANS NZOIA EAST,100+,9,37,46
TRANS NZOIA,TRANS NZOIA EAST,Not Stated,-,-,-
TRANS NZOIA,KWANZA,Total,100234,103584,203818
TRANS NZOIA,KWANZA,0,2089,2083,4172
TRANS NZOIA,KWANZA,1,2770,2837,5607
TRANS NZOIA,KWANZA,2,2674,2671,5345
TRANS NZOIA,KWANZA,3,2973,2935,5908
TRANS NZOIA,KWANZA,4,2919,2952,5871
TRANS NZOIA,KWANZA,0 - 4,13425,13478,26903
TRANS NZOIA,KWANZA,5,3024,2841,5865
TRANS NZOIA,KWANZA,6,3009,2985,5994
TRANS NZOIA,KWANZA,7,3091,3076,6167
TRANS NZOIA,KWANZA,8,2891,2825,5716
TRANS NZOIA,KWANZA,9,3321,3173,6494
TRANS NZOIA,KWANZA,05-Sep,15336,14900,30236
TRANS NZOIA,KWANZA,10,3287,3060,6347
TRANS NZOIA,KWANZA,11,2981,3107,6088
TRANS NZOIA,KWANZA,12,3229,3123,6352
TRANS NZOIA,KWANZA,13,3187,3225,6412
TRANS NZOIA,KWANZA,14,3181,3075,6256
TRANS NZOIA,KWANZA,Oct-14,15865,15590,31455
TRANS NZOIA,KWANZA,15,2926,2931,5857
TRANS NZOIA,KWANZA,16,2693,2673,5366
TRANS NZOIA,KWANZA,17,2844,2600,5444
TRANS NZOIA,KWANZA,18,2089,2009,4098
TRANS NZOIA,KWANZA,19,2374,2193,4567
TRANS NZOIA,KWANZA,15-19,12926,12406,25332
TRANS NZOIA,KWANZA,20,1892,2045,3937
TRANS NZOIA,KWANZA,21,1612,1677,3289
TRANS NZOIA,KWANZA,22,1541,1700,3241
TRANS NZOIA,KWANZA,23,1495,1803,3298
TRANS NZOIA,KWANZA,24,1333,1588,2921
TRANS NZOIA,KWANZA,20-24,7873,8813,16686
TRANS NZOIA,KWANZA,25,1442,1777,3219
TRANS NZOIA,KWANZA,26,1189,1543,2732
TRANS NZOIA,KWANZA,27,1283,1548,2831
TRANS NZOIA,KWANZA,28,1077,1262,2339
TRANS NZOIA,KWANZA,29,1159,1386,2545
TRANS NZOIA,KWANZA,25-29,6150,7516,13666
TRANS NZOIA,KWANZA,30,1374,1695,3069
TRANS NZOIA,KWANZA,31,1005,1149,2154
TRANS NZOIA,KWANZA,32,1357,1562,2919
TRANS NZOIA,KWANZA,33,1025,1332,2357
TRANS NZOIA,KWANZA,34,1049,1175,2224
TRANS NZOIA,KWANZA,30-34,5810,6913,12723
TRANS NZOIA,KWANZA,35,1300,1364,2664
TRANS NZOIA,KWANZA,36,945,986,1931
TRANS NZOIA,KWANZA,37,1006,926,1932
TRANS NZOIA,KWANZA,38,763,746,1509
TRANS NZOIA,KWANZA,39,926,821,1747
TRANS NZOIA,KWANZA,35-39,4940,4843,9783
TRANS NZOIA,KWANZA,40,1078,990,2068
TRANS NZOIA,KWANZA,41,920,935,1855
TRANS NZOIA,KWANZA,42,1009,937,1946
TRANS NZOIA,KWANZA,43,859,866,1725
TRANS NZOIA,KWANZA,44,658,665,1323
TRANS NZOIA,KWANZA,40-44,4524,4393,8917
TRANS NZOIA,KWANZA,45,887,919,1806
TRANS NZOIA,KWANZA,46,652,635,1287
TRANS NZOIA,KWANZA,47,699,710,1409
TRANS NZOIA,KWANZA,48,518,545,1063
TRANS NZOIA,KWANZA,49,580,551,1131
TRANS NZOIA,KWANZA,45-49,3336,3360,6696
TRANS NZOIA,KWANZA,50,666,727,1393
TRANS NZOIA,KWANZA,51,505,599,1104
TRANS NZOIA,KWANZA,52,483,532,1015
TRANS NZOIA,KWANZA,53,451,506,957
TRANS NZOIA,KWANZA,54,440,468,908
TRANS NZOIA,KWANZA,50-54,2545,2832,5377
TRANS NZOIA,KWANZA,55,457,475,932
TRANS NZOIA,KWANZA,56,418,518,936
TRANS NZOIA,KWANZA,57,427,618,1045
TRANS NZOIA,KWANZA,58,358,470,828
TRANS NZOIA,KWANZA,59,461,458,919
TRANS NZOIA,KWANZA,55-59,2121,2539,4660
TRANS NZOIA,KWANZA,60,478,508,986
TRANS NZOIA,KWANZA,61,396,446,842
TRANS NZOIA,KWANZA,62,317,346,663
TRANS NZOIA,KWANZA,63,365,427,792
TRANS NZOIA,KWANZA,64,277,300,577
TRANS NZOIA,KWANZA,60-64,1833,2027,3860
TRANS NZOIA,KWANZA,65,364,379,743
TRANS NZOIA,KWANZA,66,221,246,467
TRANS NZOIA,KWANZA,67,337,373,710
TRANS NZOIA,KWANZA,68,164,137,301
TRANS NZOIA,KWANZA,69,277,268,545
TRANS NZOIA,KWANZA,65-69,1363,1403,2766
TRANS NZOIA,KWANZA,70,256,299,555
TRANS NZOIA,KWANZA,71,222,244,466
TRANS NZOIA,KWANZA,72,195,197,392
TRANS NZOIA,KWANZA,73,179,181,360
TRANS NZOIA,KWANZA,74,131,157,288
TRANS NZOIA,KWANZA,70-74,983,1078,2061
TRANS NZOIA,KWANZA,75,134,165,299
TRANS NZOIA,KWANZA,76,122,151,273
TRANS NZOIA,KWANZA,77,128,152,280
TRANS NZOIA,KWANZA,78,81,84,165
TRANS NZOIA,KWANZA,79,78,100,178
TRANS NZOIA,KWANZA,75-79,543,652,1195
TRANS NZOIA,KWANZA,80,105,135,240
TRANS NZOIA,KWANZA,81,64,75,139
TRANS NZOIA,KWANZA,82,58,67,125
TRANS NZOIA,KWANZA,83,77,91,168
TRANS NZOIA,KWANZA,84,48,52,100
TRANS NZOIA,KWANZA,80-84,352,420,772
TRANS NZOIA,KWANZA,85,51,58,109
TRANS NZOIA,KWANZA,86,36,48,84
TRANS NZOIA,KWANZA,87,44,62,106
TRANS NZOIA,KWANZA,88,23,22,45
TRANS NZOIA,KWANZA,89,46,68,114
TRANS NZOIA,KWANZA,85-89,200,258,458
TRANS NZOIA,KWANZA,90,12,29,41
TRANS NZOIA,KWANZA,91,24,26,50
TRANS NZOIA,KWANZA,92,15,15,30
TRANS NZOIA,KWANZA,93,9,11,20
TRANS NZOIA,KWANZA,94,6,11,17
TRANS NZOIA,KWANZA,90-94,66,92,158
TRANS NZOIA,KWANZA,95,14,20,34
TRANS NZOIA,KWANZA,96,5,9,14
TRANS NZOIA,KWANZA,97,6,11,17
TRANS NZOIA,KWANZA,98,2,3,5
TRANS NZOIA,KWANZA,99,6,7,13
TRANS NZOIA,KWANZA,95-99,33,50,83
TRANS NZOIA,KWANZA,100+,9,21,30
TRANS NZOIA,KWANZA,Not Stated,1,-,1
TRANS NZOIA,ENDEBESS,Total,56090,55689,111779
TRANS NZOIA,ENDEBESS,0,1579,1569,3148
TRANS NZOIA,ENDEBESS,1,1489,1519,3008
TRANS NZOIA,ENDEBESS,2,1533,1546,3079
TRANS NZOIA,ENDEBESS,3,1720,1704,3424
TRANS NZOIA,ENDEBESS,4,1757,1646,3403
TRANS NZOIA,ENDEBESS,0 - 4,8078,7984,16062
TRANS NZOIA,ENDEBESS,5,1877,1790,3667
TRANS NZOIA,ENDEBESS,6,1859,1819,3678
TRANS NZOIA,ENDEBESS,7,1686,1742,3428
TRANS NZOIA,ENDEBESS,8,1666,1727,3393
TRANS NZOIA,ENDEBESS,9,1890,1825,3715
TRANS NZOIA,ENDEBESS,05-Sep,8978,8903,17881
TRANS NZOIA,ENDEBESS,10,1905,1860,3765
TRANS NZOIA,ENDEBESS,11,1665,1720,3385
TRANS NZOIA,ENDEBESS,12,1924,1770,3694
TRANS NZOIA,ENDEBESS,13,1841,1756,3597
TRANS NZOIA,ENDEBESS,14,1724,1584,3308
TRANS NZOIA,ENDEBESS,Oct-14,9059,8690,17749
TRANS NZOIA,ENDEBESS,15,1724,1586,3310
TRANS NZOIA,ENDEBESS,16,1497,1481,2978
TRANS NZOIA,ENDEBESS,17,1572,1474,3046
TRANS NZOIA,ENDEBESS,18,1176,973,2149
TRANS NZOIA,ENDEBESS,19,1286,1233,2519
TRANS NZOIA,ENDEBESS,15-19,7255,6747,14002
TRANS NZOIA,ENDEBESS,20,1042,1132,2174
TRANS NZOIA,ENDEBESS,21,838,985,1823
TRANS NZOIA,ENDEBESS,22,851,969,1820
TRANS NZOIA,ENDEBESS,23,911,975,1886
TRANS NZOIA,ENDEBESS,24,783,789,1572
TRANS NZOIA,ENDEBESS,20-24,4425,4850,9275
TRANS NZOIA,ENDEBESS,25,899,865,1764
TRANS NZOIA,ENDEBESS,26,714,759,1473
TRANS NZOIA,ENDEBESS,27,780,837,1617
TRANS NZOIA,ENDEBESS,28,565,584,1149
TRANS NZOIA,ENDEBESS,29,686,695,1381
TRANS NZOIA,ENDEBESS,25-29,3644,3740,7384
TRANS NZOIA,ENDEBESS,30,717,802,1519
TRANS NZOIA,ENDEBESS,31,626,703,1329
TRANS NZOIA,ENDEBESS,32,785,840,1625
TRANS NZOIA,ENDEBESS,33,654,662,1316
TRANS NZOIA,ENDEBESS,34,535,560,1095
TRANS NZOIA,ENDEBESS,30-34,3317,3567,6884
TRANS NZOIA,ENDEBESS,35,728,665,1393
TRANS NZOIA,ENDEBESS,36,442,462,904
TRANS NZOIA,ENDEBESS,37,527,450,977
TRANS NZOIA,ENDEBESS,38,400,318,718
TRANS NZOIA,ENDEBESS,39,468,388,856
TRANS NZOIA,ENDEBESS,35-39,2565,2283,4848
TRANS NZOIA,ENDEBESS,40,481,425,906
TRANS NZOIA,ENDEBESS,41,472,511,983
TRANS NZOIA,ENDEBESS,42,508,503,1011
TRANS NZOIA,ENDEBESS,43,436,500,936
TRANS NZOIA,ENDEBESS,44,325,351,676
TRANS NZOIA,ENDEBESS,40-44,2222,2290,4512
TRANS NZOIA,ENDEBESS,45,481,461,942
TRANS NZOIA,ENDEBESS,46,406,335,741
TRANS NZOIA,ENDEBESS,47,365,352,717
TRANS NZOIA,ENDEBESS,48,248,250,498
TRANS NZOIA,ENDEBESS,49,293,264,557
TRANS NZOIA,ENDEBESS,45-49,1793,1662,3455
TRANS NZOIA,ENDEBESS,50,294,301,595
TRANS NZOIA,ENDEBESS,51,292,296,588
TRANS NZOIA,ENDEBESS,52,262,234,496
TRANS NZOIA,ENDEBESS,53,246,252,498
TRANS NZOIA,ENDEBESS,54,213,234,447
TRANS NZOIA,ENDEBESS,50-54,1307,1317,2624
TRANS NZOIA,ENDEBESS,55,220,223,443
TRANS NZOIA,ENDEBESS,56,201,209,410
TRANS NZOIA,ENDEBESS,57,216,273,489
TRANS NZOIA,ENDEBESS,58,184,199,383
TRANS NZOIA,ENDEBESS,59,257,244,501
TRANS NZOIA,ENDEBESS,55-59,1078,1148,2226
TRANS NZOIA,ENDEBESS,60,222,206,428
TRANS NZOIA,ENDEBESS,61,206,187,393
TRANS NZOIA,ENDEBESS,62,154,147,301
TRANS NZOIA,ENDEBESS,63,191,190,381
TRANS NZOIA,ENDEBESS,64,107,111,218
TRANS NZOIA,ENDEBESS,60-64,880,841,1721
TRANS NZOIA,ENDEBESS,65,154,176,330
TRANS NZOIA,ENDEBESS,66,107,93,200
TRANS NZOIA,ENDEBESS,67,140,159,299
TRANS NZOIA,ENDEBESS,68,71,55,126
TRANS NZOIA,ENDEBESS,69,113,111,224
TRANS NZOIA,ENDEBESS,65-69,585,594,1179
TRANS NZOIA,ENDEBESS,70,95,111,206
TRANS NZOIA,ENDEBESS,71,96,99,195
TRANS NZOIA,ENDEBESS,72,75,59,134
TRANS NZOIA,ENDEBESS,73,67,71,138
TRANS NZOIA,ENDEBESS,74,61,67,128
TRANS NZOIA,ENDEBESS,70-74,394,407,801
TRANS NZOIA,ENDEBESS,75,63,73,136
TRANS NZOIA,ENDEBESS,76,45,55,100
TRANS NZOIA,ENDEBESS,77,54,68,122
TRANS NZOIA,ENDEBESS,78,29,25,54
TRANS NZOIA,ENDEBESS,79,24,68,92
TRANS NZOIA,ENDEBESS,75-79,215,289,504
TRANS NZOIA,ENDEBESS,80,49,54,103
TRANS NZOIA,ENDEBESS,81,23,37,60
TRANS NZOIA,ENDEBESS,82,26,21,47
TRANS NZOIA,ENDEBESS,83,44,22,66
TRANS NZOIA,ENDEBESS,84,9,24,33
TRANS NZOIA,ENDEBESS,80-84,151,158,309
TRANS NZOIA,ENDEBESS,85,23,35,58
TRANS NZOIA,ENDEBESS,86,14,20,34
TRANS NZOIA,ENDEBESS,87,20,17,37
TRANS NZOIA,ENDEBESS,88,10,11,21
TRANS NZOIA,ENDEBESS,89,19,35,54
TRANS NZOIA,ENDEBESS,85-89,86,118,204
TRANS NZOIA,ENDEBESS,90,5,16,21
TRANS NZOIA,ENDEBESS,91,10,13,23
TRANS NZOIA,ENDEBESS,92,2,3,5
TRANS NZOIA,ENDEBESS,93,8,11,19
TRANS NZOIA,ENDEBESS,94,4,8,12
TRANS NZOIA,ENDEBESS,90-94,29,51,80
TRANS NZOIA,ENDEBESS,95,13,16,29
TRANS NZOIA,ENDEBESS,96,-,3,3
TRANS NZOIA,ENDEBESS,97,7,2,9
TRANS NZOIA,ENDEBESS,98,4,3,7
TRANS NZOIA,ENDEBESS,99,2,9,11
TRANS NZOIA,ENDEBESS,95-99,26,33,59
TRANS NZOIA,ENDEBESS,100+,3,17,20
TRANS NZOIA,ENDEBESS,Not Stated,-,-,-
TRANS NZOIA,KIMININI,Total,118087,124730,242817
TRANS NZOIA,KIMININI,0,2951,2963,5914
TRANS NZOIA,KIMININI,1,2844,2955,5799
TRANS NZOIA,KIMININI,2,3053,2888,5941
TRANS NZOIA,KIMININI,3,3120,3223,6343
TRANS NZOIA,KIMININI,4,3186,3119,6305
TRANS NZOIA,KIMININI,0 - 4,15154,15148,30302
TRANS NZOIA,KIMININI,5,3255,3230,6485
TRANS NZOIA,KIMININI,6,3340,3319,6659
TRANS NZOIA,KIMININI,7,3297,3357,6654
TRANS NZOIA,KIMININI,8,3110,3351,6461
TRANS NZOIA,KIMININI,9,3514,3459,6973
TRANS NZOIA,KIMININI,05-Sep,16516,16716,33232
TRANS NZOIA,KIMININI,10,3686,3659,7345
TRANS NZOIA,KIMININI,11,3170,3502,6672
TRANS NZOIA,KIMININI,12,3574,3677,7251
TRANS NZOIA,KIMININI,13,3672,3649,7321
TRANS NZOIA,KIMININI,14,3558,3536,7094
TRANS NZOIA,KIMININI,Oct-14,17660,18023,35683
TRANS NZOIA,KIMININI,15,3457,3429,6886
TRANS NZOIA,KIMININI,16,3233,3195,6428
TRANS NZOIA,KIMININI,17,3473,3268,6741
TRANS NZOIA,KIMININI,18,2720,2527,5247
TRANS NZOIA,KIMININI,19,2852,2757,5609
TRANS NZOIA,KIMININI,15-19,15735,15176,30911
TRANS NZOIA,KIMININI,20,2403,2482,4885
TRANS NZOIA,KIMININI,21,2042,2159,4201
TRANS NZOIA,KIMININI,22,1923,2187,4110
TRANS NZOIA,KIMININI,23,1918,2289,4207
TRANS NZOIA,KIMININI,24,1750,2052,3802
TRANS NZOIA,KIMININI,20-24,10036,11169,21205
TRANS NZOIA,KIMININI,25,1888,2190,4078
TRANS NZOIA,KIMININI,26,1418,1792,3210
TRANS NZOIA,KIMININI,27,1594,1889,3483
TRANS NZOIA,KIMININI,28,1237,1581,2818
TRANS NZOIA,KIMININI,29,1480,1754,3234
TRANS NZOIA,KIMININI,25-29,7617,9206,16823
TRANS NZOIA,KIMININI,30,1754,2103,3857
TRANS NZOIA,KIMININI,31,1295,1577,2872
TRANS NZOIA,KIMININI,32,1674,1981,3655
TRANS NZOIA,KIMININI,33,1405,1753,3158
TRANS NZOIA,KIMININI,34,1303,1505,2808
TRANS NZOIA,KIMININI,30-34,7431,8919,16350
TRANS NZOIA,KIMININI,35,1617,1590,3207
TRANS NZOIA,KIMININI,36,1144,1280,2424
TRANS NZOIA,KIMININI,37,1222,1182,2404
TRANS NZOIA,KIMININI,38,975,958,1933
TRANS NZOIA,KIMININI,39,1017,1051,2068
TRANS NZOIA,KIMININI,35-39,5975,6061,12036
TRANS NZOIA,KIMININI,40,1229,1229,2458
TRANS NZOIA,KIMININI,41,1175,1289,2464
TRANS NZOIA,KIMININI,42,1201,1289,2490
TRANS NZOIA,KIMININI,43,1083,1189,2272
TRANS NZOIA,KIMININI,44,789,834,1623
TRANS NZOIA,KIMININI,40-44,5477,5830,11307
TRANS NZOIA,KIMININI,45,1144,1212,2356
TRANS NZOIA,KIMININI,46,811,856,1667
TRANS NZOIA,KIMININI,47,829,890,1719
TRANS NZOIA,KIMININI,48,623,631,1254
TRANS NZOIA,KIMININI,49,705,776,1481
TRANS NZOIA,KIMININI,45-49,4112,4365,8477
TRANS NZOIA,KIMININI,50,791,841,1632
TRANS NZOIA,KIMININI,51,702,791,1493
TRANS NZOIA,KIMININI,52,621,716,1337
TRANS NZOIA,KIMININI,53,516,619,1135
TRANS NZOIA,KIMININI,54,549,671,1220
TRANS NZOIA,KIMININI,50-54,3179,3638,6817
TRANS NZOIA,KIMININI,55,616,588,1204
TRANS NZOIA,KIMININI,56,540,648,1188
TRANS NZOIA,KIMININI,57,568,820,1388
TRANS NZOIA,KIMININI,58,497,522,1019
TRANS NZOIA,KIMININI,59,635,685,1320
TRANS NZOIA,KIMININI,55-59,2856,3263,6119
TRANS NZOIA,KIMININI,60,594,651,1245
TRANS NZOIA,KIMININI,61,508,532,1040
TRANS NZOIA,KIMININI,62,442,481,923
TRANS NZOIA,KIMININI,63,470,508,978
TRANS NZOIA,KIMININI,64,303,356,659
TRANS NZOIA,KIMININI,60-64,2317,2528,4845
TRANS NZOIA,KIMININI,65,442,475,917
TRANS NZOIA,KIMININI,66,267,294,561
TRANS NZOIA,KIMININI,67,375,442,817
TRANS NZOIA,KIMININI,68,213,209,422
TRANS NZOIA,KIMININI,69,333,312,645
TRANS NZOIA,KIMININI,65-69,1630,1732,3362
TRANS NZOIA,KIMININI,70,287,321,608
TRANS NZOIA,KIMININI,71,264,286,550
TRANS NZOIA,KIMININI,72,206,165,371
TRANS NZOIA,KIMININI,73,193,230,423
TRANS NZOIA,KIMININI,74,152,188,340
TRANS NZOIA,KIMININI,70-74,1102,1190,2292
TRANS NZOIA,KIMININI,75,160,170,330
TRANS NZOIA,KIMININI,76,106,152,258
TRANS NZOIA,KIMININI,77,148,189,337
TRANS NZOIA,KIMININI,78,81,88,169
TRANS NZOIA,KIMININI,79,89,136,225
TRANS NZOIA,KIMININI,75-79,584,735,1319
TRANS NZOIA,KIMININI,80,104,147,251
TRANS NZOIA,KIMININI,81,63,88,151
TRANS NZOIA,KIMININI,82,65,94,159
TRANS NZOIA,KIMININI,83,77,98,175
TRANS NZOIA,KIMININI,84,53,73,126
TRANS NZOIA,KIMININI,80-84,362,500,862
TRANS NZOIA,KIMININI,85,62,90,152
TRANS NZOIA,KIMININI,86,33,51,84
TRANS NZOIA,KIMININI,87,69,97,166
TRANS NZOIA,KIMININI,88,29,23,52
TRANS NZOIA,KIMININI,89,42,77,119
TRANS NZOIA,KIMININI,85-89,235,338,573
TRANS NZOIA,KIMININI,90,9,26,35
TRANS NZOIA,KIMININI,91,27,26,53
TRANS NZOIA,KIMININI,92,13,9,22
TRANS NZOIA,KIMININI,93,15,20,35
TRANS NZOIA,KIMININI,94,9,10,19
TRANS NZOIA,KIMININI,90-94,73,91,164
TRANS NZOIA,KIMININI,95,11,25,36
TRANS NZOIA,KIMININI,96,6,16,22
TRANS NZOIA,KIMININI,97,7,10,17
TRANS NZOIA,KIMININI,98,-,9,9
TRANS NZOIA,KIMININI,99,4,9,13
TRANS NZOIA,KIMININI,95-99,28,69,97
TRANS NZOIA,KIMININI,100+,8,32,40
TRANS NZOIA,KIMININI,Not Stated,-,1,1
TURKANA,ALL,Total,478087,448868,926955
TURKANA,ALL,0,9945,9883,19828
TURKANA,ALL,1,11069,10750,21819
TURKANA,ALL,2,14501,14403,28904
TURKANA,ALL,3,15092,14998,30090
TURKANA,ALL,4,15544,15244,30788
TURKANA,ALL,0 - 4,66151,65278,131429
TURKANA,ALL,5,16240,15570,31810
TURKANA,ALL,6,15752,15207,30959
TURKANA,ALL,7,13655,13076,26731
TURKANA,ALL,8,16151,15481,31632
TURKANA,ALL,9,12241,11752,23993
TURKANA,ALL,05-Sep,74039,71086,145125
TURKANA,ALL,10,20635,19553,40188
TURKANA,ALL,11,10173,10730,20903
TURKANA,ALL,12,17278,14355,31633
TURKANA,ALL,13,13244,11213,24457
TURKANA,ALL,14,13783,11294,25077
TURKANA,ALL,Oct-14,75113,67145,142258
TURKANA,ALL,15,17535,13559,31094
TURKANA,ALL,16,13211,10511,23722
TURKANA,ALL,17,12581,9283,21864
TURKANA,ALL,18,13631,10768,24399
TURKANA,ALL,19,9965,8279,18244
TURKANA,ALL,15-19,66923,52400,119323
TURKANA,ALL,20,16833,13535,30368
TURKANA,ALL,21,8319,7225,15544
TURKANA,ALL,22,9120,8108,17228
TURKANA,ALL,23,8462,7559,16021
TURKANA,ALL,24,8249,7180,15429
TURKANA,ALL,20-24,50983,43607,94590
TURKANA,ALL,25,11861,10385,22246
TURKANA,ALL,26,6989,7259,14248
TURKANA,ALL,27,6929,6782,13711
TURKANA,ALL,28,6697,6095,12792
TURKANA,ALL,29,6380,6440,12820
TURKANA,ALL,25-29,38856,36961,75817
TURKANA,ALL,30,11421,11283,22704
TURKANA,ALL,31,3850,4249,8099
TURKANA,ALL,32,5189,5303,10492
TURKANA,ALL,33,3710,4288,7998
TURKANA,ALL,34,3774,4228,8002
TURKANA,ALL,30-34,27944,29351,57295
TURKANA,ALL,35,6749,6853,13602
TURKANA,ALL,36,3240,3663,6903
TURKANA,ALL,37,2932,3090,6022
TURKANA,ALL,38,2748,2864,5612
TURKANA,ALL,39,3686,4162,7848
TURKANA,ALL,35-39,19355,20632,39987
TURKANA,ALL,40,7027,5651,12678
TURKANA,ALL,41,2706,3274,5980
TURKANA,ALL,42,3175,3097,6272
TURKANA,ALL,43,2059,2313,4372
TURKANA,ALL,44,1782,1984,3766
TURKANA,ALL,40-44,16749,16319,33068
TURKANA,ALL,45,4205,3852,8057
TURKANA,ALL,46,2197,2600,4797
TURKANA,ALL,47,1846,1710,3556
TURKANA,ALL,48,1532,1393,2925
TURKANA,ALL,49,2075,2222,4297
TURKANA,ALL,45-49,11855,11777,23632
TURKANA,ALL,50,4240,3618,7858
TURKANA,ALL,51,1233,1319,2552
TURKANA,ALL,52,1341,1237,2578
TURKANA,ALL,53,931,960,1891
TURKANA,ALL,54,1170,1338,2508
TURKANA,ALL,50-54,8915,8472,17387
TURKANA,ALL,55,1488,1452,2940
TURKANA,ALL,56,1287,1285,2572
TURKANA,ALL,57,850,933,1783
TURKANA,ALL,58,759,828,1587
TURKANA,ALL,59,1290,1837,3127
TURKANA,ALL,55-59,5674,6335,12009
TURKANA,ALL,60,2465,2499,4964
TURKANA,ALL,61,892,1207,2099
TURKANA,ALL,62,760,857,1617
TURKANA,ALL,63,763,1106,1869
TURKANA,ALL,64,573,686,1259
TURKANA,ALL,60-64,5453,6355,11808
TURKANA,ALL,65,1059,1364,2423
TURKANA,ALL,66,428,493,921
TURKANA,ALL,67,621,737,1358
TURKANA,ALL,68,466,496,962
TURKANA,ALL,69,981,1453,2434
TURKANA,ALL,65-69,3555,4543,8098
TURKANA,ALL,70,1505,1708,3213
TURKANA,ALL,71,488,838,1326
TURKANA,ALL,72,422,533,955
TURKANA,ALL,73,301,474,775
TURKANA,ALL,74,555,699,1254
TURKANA,ALL,70-74,3271,4252,7523
TURKANA,ALL,75,421,491,912
TURKANA,ALL,76,221,279,500
TURKANA,ALL,77,220,311,531
TURKANA,ALL,78,192,237,429
TURKANA,ALL,79,520,695,1215
TURKANA,ALL,75-79,1574,2013,3587
TURKANA,ALL,80,519,625,1144
TURKANA,ALL,81,142,238,380
TURKANA,ALL,82,76,110,186
TURKANA,ALL,83,77,158,235
TURKANA,ALL,84,108,178,286
TURKANA,ALL,80-84,922,1309,2231
TURKANA,ALL,85,132,152,284
TURKANA,ALL,86,46,63,109
TURKANA,ALL,87,78,78,156
TURKANA,ALL,88,31,45,76
TURKANA,ALL,89,194,276,470
TURKANA,ALL,85-89,481,614,1095
TURKANA,ALL,90,74,120,194
TURKANA,ALL,91,36,49,85
TURKANA,ALL,92,19,19,38
TURKANA,ALL,93,8,30,38
TURKANA,ALL,94,24,25,49
TURKANA,ALL,90-94,161,243,404
TURKANA,ALL,95,25,47,72
TURKANA,ALL,96,12,16,28
TURKANA,ALL,97,9,15,24
TURKANA,ALL,98,11,10,21
TURKANA,ALL,99,24,29,53
TURKANA,ALL,95-99,81,117,198
TURKANA,ALL,100+,31,57,88
TURKANA,ALL,Not Stated,1,2,3
TURKANA,KIBISH,Total,18651,18117,36768
TURKANA,KIBISH,0,321,323,644
TURKANA,KIBISH,1,463,437,900
TURKANA,KIBISH,2,602,664,1266
TURKANA,KIBISH,3,674,694,1368
TURKANA,KIBISH,4,683,671,1354
TURKANA,KIBISH,0 - 4,2743,2789,5532
TURKANA,KIBISH,5,724,721,1445
TURKANA,KIBISH,6,695,665,1360
TURKANA,KIBISH,7,574,560,1134
TURKANA,KIBISH,8,731,697,1428
TURKANA,KIBISH,9,509,439,948
TURKANA,KIBISH,05-Sep,3233,3082,6315
TURKANA,KIBISH,10,979,903,1882
TURKANA,KIBISH,11,359,397,756
TURKANA,KIBISH,12,718,588,1306
TURKANA,KIBISH,13,512,398,910
TURKANA,KIBISH,14,520,412,932
TURKANA,KIBISH,Oct-14,3088,2698,5786
TURKANA,KIBISH,15,781,614,1395
TURKANA,KIBISH,16,497,378,875
TURKANA,KIBISH,17,494,327,821
TURKANA,KIBISH,18,585,441,1026
TURKANA,KIBISH,19,357,326,683
TURKANA,KIBISH,15-19,2714,2086,4800
TURKANA,KIBISH,20,739,547,1286
TURKANA,KIBISH,21,324,256,580
TURKANA,KIBISH,22,343,296,639
TURKANA,KIBISH,23,338,339,677
TURKANA,KIBISH,24,363,303,666
TURKANA,KIBISH,20-24,2107,1741,3848
TURKANA,KIBISH,25,391,394,785
TURKANA,KIBISH,26,225,279,504
TURKANA,KIBISH,27,231,279,510
TURKANA,KIBISH,28,241,237,478
TURKANA,KIBISH,29,265,325,590
TURKANA,KIBISH,25-29,1353,1514,2867
TURKANA,KIBISH,30,411,552,963
TURKANA,KIBISH,31,127,168,295
TURKANA,KIBISH,32,115,152,267
TURKANA,KIBISH,33,86,117,203
TURKANA,KIBISH,34,122,190,312
TURKANA,KIBISH,30-34,861,1179,2040
TURKANA,KIBISH,35,196,181,377
TURKANA,KIBISH,36,85,119,204
TURKANA,KIBISH,37,73,120,193
TURKANA,KIBISH,38,106,103,209
TURKANA,KIBISH,39,179,243,422
TURKANA,KIBISH,35-39,639,766,1405
TURKANA,KIBISH,40,268,237,505
TURKANA,KIBISH,41,77,121,198
TURKANA,KIBISH,42,79,71,150
TURKANA,KIBISH,43,62,72,134
TURKANA,KIBISH,44,46,68,114
TURKANA,KIBISH,40-44,532,569,1101
TURKANA,KIBISH,45,111,111,222
TURKANA,KIBISH,46,49,54,103
TURKANA,KIBISH,47,53,87,140
TURKANA,KIBISH,48,81,64,145
TURKANA,KIBISH,49,90,137,227
TURKANA,KIBISH,45-49,384,453,837
TURKANA,KIBISH,50,176,116,292
TURKANA,KIBISH,51,33,69,102
TURKANA,KIBISH,52,42,41,83
TURKANA,KIBISH,53,21,32,53
TURKANA,KIBISH,54,50,56,106
TURKANA,KIBISH,50-54,322,314,636
TURKANA,KIBISH,55,48,50,98
TURKANA,KIBISH,56,50,68,118
TURKANA,KIBISH,57,35,26,61
TURKANA,KIBISH,58,37,35,72
TURKANA,KIBISH,59,51,97,148
TURKANA,KIBISH,55-59,221,276,497
TURKANA,KIBISH,60,77,80,157
TURKANA,KIBISH,61,35,48,83
TURKANA,KIBISH,62,30,42,72
TURKANA,KIBISH,63,25,35,60
TURKANA,KIBISH,64,25,27,52
TURKANA,KIBISH,60-64,192,232,424
TURKANA,KIBISH,65,27,31,58
TURKANA,KIBISH,66,9,16,25
TURKANA,KIBISH,67,14,25,39
TURKANA,KIBISH,68,14,13,27
TURKANA,KIBISH,69,30,57,87
TURKANA,KIBISH,65-69,94,142,236
TURKANA,KIBISH,70,34,39,73
TURKANA,KIBISH,71,10,42,52
TURKANA,KIBISH,72,9,14,23
TURKANA,KIBISH,73,7,15,22
TURKANA,KIBISH,74,18,32,50
TURKANA,KIBISH,70-74,78,142,220
TURKANA,KIBISH,75,5,6,11
TURKANA,KIBISH,76,5,4,9
TURKANA,KIBISH,77,11,19,30
TURKANA,KIBISH,78,2,2,4
TURKANA,KIBISH,79,19,33,52
TURKANA,KIBISH,75-79,42,64,106
TURKANA,KIBISH,80,9,14,23
TURKANA,KIBISH,81,1,12,13
TURKANA,KIBISH,82,1,2,3
TURKANA,KIBISH,83,4,11,15
TURKANA,KIBISH,84,5,9,14
TURKANA,KIBISH,80-84,20,48,68
TURKANA,KIBISH,85,2,1,3
TURKANA,KIBISH,86,2,1,3
TURKANA,KIBISH,87,3,2,5
TURKANA,KIBISH,88,1,3,4
TURKANA,KIBISH,89,11,8,19
TURKANA,KIBISH,85-89,19,15,34
TURKANA,KIBISH,90,3,2,5
TURKANA,KIBISH,91,-,4,4
TURKANA,KIBISH,92,1,-,1
TURKANA,KIBISH,93,-,-,-
TURKANA,KIBISH,94,1,1,2
TURKANA,KIBISH,90-94,5,7,12
TURKANA,KIBISH,95,1,-,1
TURKANA,KIBISH,96,-,-,-
TURKANA,KIBISH,97,-,-,-
TURKANA,KIBISH,98,1,-,1
TURKANA,KIBISH,99,1,-,1
TURKANA,KIBISH,95-99,3,-,3
TURKANA,KIBISH,100+,1,-,1
TURKANA,KIBISH,Not Stated,-,-,-
TURKANA,LOIMA,Total,54341,53453,107794
TURKANA,LOIMA,0,1087,1160,2247
TURKANA,LOIMA,1,1325,1265,2590
TURKANA,LOIMA,2,1847,1782,3629
TURKANA,LOIMA,3,1842,1861,3703
TURKANA,LOIMA,4,1922,1876,3798
TURKANA,LOIMA,0 - 4,8023,7944,15967
TURKANA,LOIMA,5,2076,1974,4050
TURKANA,LOIMA,6,2076,1926,4002
TURKANA,LOIMA,7,1685,1608,3293
TURKANA,LOIMA,8,2085,1965,4050
TURKANA,LOIMA,9,1445,1288,2733
TURKANA,LOIMA,05-Sep,9367,8761,18128
TURKANA,LOIMA,10,2715,2360,5075
TURKANA,LOIMA,11,1122,1141,2263
TURKANA,LOIMA,12,2020,1689,3709
TURKANA,LOIMA,13,1444,1243,2687
TURKANA,LOIMA,14,1443,1210,2653
TURKANA,LOIMA,Oct-14,8744,7643,16387
TURKANA,LOIMA,15,2093,1535,3628
TURKANA,LOIMA,16,1374,1115,2489
TURKANA,LOIMA,17,1186,883,2069
TURKANA,LOIMA,18,1489,1193,2682
TURKANA,LOIMA,19,864,704,1568
TURKANA,LOIMA,15-19,7006,5430,12436
TURKANA,LOIMA,20,1862,1551,3413
TURKANA,LOIMA,21,648,589,1237
TURKANA,LOIMA,22,811,869,1680
TURKANA,LOIMA,23,817,783,1600
TURKANA,LOIMA,24,781,736,1517
TURKANA,LOIMA,20-24,4919,4528,9447
TURKANA,LOIMA,25,1330,1320,2650
TURKANA,LOIMA,26,841,1014,1855
TURKANA,LOIMA,27,657,707,1364
TURKANA,LOIMA,28,694,703,1397
TURKANA,LOIMA,29,723,823,1546
TURKANA,LOIMA,25-29,4245,4567,8812
TURKANA,LOIMA,30,1341,1479,2820
TURKANA,LOIMA,31,391,528,919
TURKANA,LOIMA,32,495,598,1093
TURKANA,LOIMA,33,400,552,952
TURKANA,LOIMA,34,406,483,889
TURKANA,LOIMA,30-34,3033,3640,6673
TURKANA,LOIMA,35,769,863,1632
TURKANA,LOIMA,36,352,432,784
TURKANA,LOIMA,37,291,307,598
TURKANA,LOIMA,38,237,311,548
TURKANA,LOIMA,39,410,462,872
TURKANA,LOIMA,35-39,2059,2375,4434
TURKANA,LOIMA,40,850,763,1613
TURKANA,LOIMA,41,248,402,650
TURKANA,LOIMA,42,360,465,825
TURKANA,LOIMA,43,231,347,578
TURKANA,LOIMA,44,206,262,468
TURKANA,LOIMA,40-44,1895,2239,4134
TURKANA,LOIMA,45,456,492,948
TURKANA,LOIMA,46,265,364,629
TURKANA,LOIMA,47,191,178,369
TURKANA,LOIMA,48,140,129,269
TURKANA,LOIMA,49,221,265,486
TURKANA,LOIMA,45-49,1273,1428,2701
TURKANA,LOIMA,50,499,452,951
TURKANA,LOIMA,51,150,147,297
TURKANA,LOIMA,52,130,144,274
TURKANA,LOIMA,53,94,147,241
TURKANA,LOIMA,54,117,198,315
TURKANA,LOIMA,50-54,990,1088,2078
TURKANA,LOIMA,55,147,181,328
TURKANA,LOIMA,56,135,158,293
TURKANA,LOIMA,57,91,137,228
TURKANA,LOIMA,58,64,96,160
TURKANA,LOIMA,59,163,256,419
TURKANA,LOIMA,55-59,600,828,1428
TURKANA,LOIMA,60,323,372,695
TURKANA,LOIMA,61,110,208,318
TURKANA,LOIMA,62,79,117,196
TURKANA,LOIMA,63,113,157,270
TURKANA,LOIMA,64,73,112,185
TURKANA,LOIMA,60-64,698,966,1664
TURKANA,LOIMA,65,147,187,334
TURKANA,LOIMA,66,73,83,156
TURKANA,LOIMA,67,88,103,191
TURKANA,LOIMA,68,52,55,107
TURKANA,LOIMA,69,140,224,364
TURKANA,LOIMA,65-69,500,652,1152
TURKANA,LOIMA,70,205,244,449
TURKANA,LOIMA,71,78,147,225
TURKANA,LOIMA,72,59,81,140
TURKANA,LOIMA,73,43,80,123
TURKANA,LOIMA,74,121,148,269
TURKANA,LOIMA,70-74,506,700,1206
TURKANA,LOIMA,75,63,67,130
TURKANA,LOIMA,76,25,48,73
TURKANA,LOIMA,77,42,48,90
TURKANA,LOIMA,78,25,40,65
TURKANA,LOIMA,79,72,101,173
TURKANA,LOIMA,75-79,227,304,531
TURKANA,LOIMA,80,86,86,172
TURKANA,LOIMA,81,26,53,79
TURKANA,LOIMA,82,13,20,33
TURKANA,LOIMA,83,11,14,25
TURKANA,LOIMA,84,8,26,34
TURKANA,LOIMA,80-84,144,199,343
TURKANA,LOIMA,85,22,18,40
TURKANA,LOIMA,86,4,11,15
TURKANA,LOIMA,87,18,24,42
TURKANA,LOIMA,88,2,7,9
TURKANA,LOIMA,89,26,42,68
TURKANA,LOIMA,85-89,72,102,174
TURKANA,LOIMA,90,10,18,28
TURKANA,LOIMA,91,11,6,17
TURKANA,LOIMA,92,3,2,5
TURKANA,LOIMA,93,1,2,3
TURKANA,LOIMA,94,2,4,6
TURKANA,LOIMA,90-94,27,32,59
TURKANA,LOIMA,95,1,6,7
TURKANA,LOIMA,96,1,4,5
TURKANA,LOIMA,97,2,5,7
TURKANA,LOIMA,98,2,1,3
TURKANA,LOIMA,99,3,2,5
TURKANA,LOIMA,95-99,9,18,27
TURKANA,LOIMA,100+,4,9,13
TURKANA,LOIMA,Not Stated,-,-,-
TURKANA,TURKANA CENTRAL,Total,93145,92160,185305
TURKANA,TURKANA CENTRAL,0,2743,2658,5401
TURKANA,TURKANA CENTRAL,1,2804,2624,5428
TURKANA,TURKANA CENTRAL,2,3121,3094,6215
TURKANA,TURKANA CENTRAL,3,3252,3272,6524
TURKANA,TURKANA CENTRAL,4,3373,3152,6525
TURKANA,TURKANA CENTRAL,0 - 4,15293,14800,30093
TURKANA,TURKANA CENTRAL,5,3315,3149,6464
TURKANA,TURKANA CENTRAL,6,3110,3011,6121
TURKANA,TURKANA CENTRAL,7,2751,2628,5379
TURKANA,TURKANA CENTRAL,8,2822,2849,5671
TURKANA,TURKANA CENTRAL,9,2302,2246,4548
TURKANA,TURKANA CENTRAL,05-Sep,14300,13883,28183
TURKANA,TURKANA CENTRAL,10,3502,3500,7002
TURKANA,TURKANA CENTRAL,11,1991,2081,4072
TURKANA,TURKANA CENTRAL,12,2996,2662,5658
TURKANA,TURKANA CENTRAL,13,2433,2296,4729
TURKANA,TURKANA CENTRAL,14,2380,2193,4573
TURKANA,TURKANA CENTRAL,Oct-14,13302,12732,26034
TURKANA,TURKANA CENTRAL,15,2840,2579,5419
TURKANA,TURKANA CENTRAL,16,2199,2125,4324
TURKANA,TURKANA CENTRAL,17,2259,1950,4209
TURKANA,TURKANA CENTRAL,18,2191,2033,4224
TURKANA,TURKANA CENTRAL,19,1787,1722,3509
TURKANA,TURKANA CENTRAL,15-19,11276,10409,21685
TURKANA,TURKANA CENTRAL,20,2454,2645,5099
TURKANA,TURKANA CENTRAL,21,1709,1745,3454
TURKANA,TURKANA CENTRAL,22,1747,1759,3506
TURKANA,TURKANA CENTRAL,23,1695,1796,3491
TURKANA,TURKANA CENTRAL,24,1716,1607,3323
TURKANA,TURKANA CENTRAL,20-24,9321,9552,18873
TURKANA,TURKANA CENTRAL,25,2316,2239,4555
TURKANA,TURKANA CENTRAL,26,1580,1657,3237
TURKANA,TURKANA CENTRAL,27,1504,1541,3045
TURKANA,TURKANA CENTRAL,28,1295,1121,2416
TURKANA,TURKANA CENTRAL,29,1259,1202,2461
TURKANA,TURKANA CENTRAL,25-29,7954,7760,15714
TURKANA,TURKANA CENTRAL,30,2034,1767,3801
TURKANA,TURKANA CENTRAL,31,820,847,1667
TURKANA,TURKANA CENTRAL,32,1150,1179,2329
TURKANA,TURKANA CENTRAL,33,895,1046,1941
TURKANA,TURKANA CENTRAL,34,863,919,1782
TURKANA,TURKANA CENTRAL,30-34,5762,5758,11520
TURKANA,TURKANA CENTRAL,35,1394,1424,2818
TURKANA,TURKANA CENTRAL,36,742,727,1469
TURKANA,TURKANA CENTRAL,37,687,686,1373
TURKANA,TURKANA CENTRAL,38,540,435,975
TURKANA,TURKANA CENTRAL,39,651,526,1177
TURKANA,TURKANA CENTRAL,35-39,4014,3798,7812
TURKANA,TURKANA CENTRAL,40,1144,867,2011
TURKANA,TURKANA CENTRAL,41,796,945,1741
TURKANA,TURKANA CENTRAL,42,716,777,1493
TURKANA,TURKANA CENTRAL,43,494,525,1019
TURKANA,TURKANA CENTRAL,44,374,454,828
TURKANA,TURKANA CENTRAL,40-44,3524,3568,7092
TURKANA,TURKANA CENTRAL,45,779,685,1464
TURKANA,TURKANA CENTRAL,46,516,667,1183
TURKANA,TURKANA CENTRAL,47,375,324,699
TURKANA,TURKANA CENTRAL,48,293,240,533
TURKANA,TURKANA CENTRAL,49,415,402,817
TURKANA,TURKANA CENTRAL,45-49,2378,2318,4696
TURKANA,TURKANA CENTRAL,50,678,619,1297
TURKANA,TURKANA CENTRAL,51,242,243,485
TURKANA,TURKANA CENTRAL,52,295,273,568
TURKANA,TURKANA CENTRAL,53,211,200,411
TURKANA,TURKANA CENTRAL,54,258,303,561
TURKANA,TURKANA CENTRAL,50-54,1684,1638,3322
TURKANA,TURKANA CENTRAL,55,281,274,555
TURKANA,TURKANA CENTRAL,56,257,288,545
TURKANA,TURKANA CENTRAL,57,186,216,402
TURKANA,TURKANA CENTRAL,58,131,165,296
TURKANA,TURKANA CENTRAL,59,253,397,650
TURKANA,TURKANA CENTRAL,55-59,1108,1340,2448
TURKANA,TURKANA CENTRAL,60,419,475,894
TURKANA,TURKANA CENTRAL,61,214,310,524
TURKANA,TURKANA CENTRAL,62,177,196,373
TURKANA,TURKANA CENTRAL,63,172,276,448
TURKANA,TURKANA CENTRAL,64,124,167,291
TURKANA,TURKANA CENTRAL,60-64,1106,1424,2530
TURKANA,TURKANA CENTRAL,65,214,341,555
TURKANA,TURKANA CENTRAL,66,99,116,215
TURKANA,TURKANA CENTRAL,67,126,161,287
TURKANA,TURKANA CENTRAL,68,95,98,193
TURKANA,TURKANA CENTRAL,69,209,353,562
TURKANA,TURKANA CENTRAL,65-69,743,1069,1812
TURKANA,TURKANA CENTRAL,70,310,400,710
TURKANA,TURKANA CENTRAL,71,109,202,311
TURKANA,TURKANA CENTRAL,72,77,127,204
TURKANA,TURKANA CENTRAL,73,76,117,193
TURKANA,TURKANA CENTRAL,74,107,172,279
TURKANA,TURKANA CENTRAL,70-74,679,1018,1697
TURKANA,TURKANA CENTRAL,75,80,118,198
TURKANA,TURKANA CENTRAL,76,52,64,116
TURKANA,TURKANA CENTRAL,77,45,90,135
TURKANA,TURKANA CENTRAL,78,38,53,91
TURKANA,TURKANA CENTRAL,79,117,170,287
TURKANA,TURKANA CENTRAL,75-79,332,495,827
TURKANA,TURKANA CENTRAL,80,97,168,265
TURKANA,TURKANA CENTRAL,81,36,54,90
TURKANA,TURKANA CENTRAL,82,13,19,32
TURKANA,TURKANA CENTRAL,83,26,41,67
TURKANA,TURKANA CENTRAL,84,30,55,85
TURKANA,TURKANA CENTRAL,80-84,202,337,539
TURKANA,TURKANA CENTRAL,85,29,45,74
TURKANA,TURKANA CENTRAL,86,10,7,17
TURKANA,TURKANA CENTRAL,87,19,13,32
TURKANA,TURKANA CENTRAL,88,6,12,18
TURKANA,TURKANA CENTRAL,89,42,67,109
TURKANA,TURKANA CENTRAL,85-89,106,144,250
TURKANA,TURKANA CENTRAL,90,16,30,46
TURKANA,TURKANA CENTRAL,91,7,13,20
TURKANA,TURKANA CENTRAL,92,5,7,12
TURKANA,TURKANA CENTRAL,93,1,9,10
TURKANA,TURKANA CENTRAL,94,4,6,10
TURKANA,TURKANA CENTRAL,90-94,33,65,98
TURKANA,TURKANA CENTRAL,95,5,11,16
TURKANA,TURKANA CENTRAL,96,3,2,5
TURKANA,TURKANA CENTRAL,97,3,5,8
TURKANA,TURKANA CENTRAL,98,2,5,7
TURKANA,TURKANA CENTRAL,99,5,8,13
TURKANA,TURKANA CENTRAL,95-99,18,31,49
TURKANA,TURKANA CENTRAL,100+,9,20,29
TURKANA,TURKANA CENTRAL,Not Stated,1,1,2
TURKANA,TURKANA EAST,Total,76871,61643,138514
TURKANA,TURKANA EAST,0,787,816,1603
TURKANA,TURKANA EAST,1,1152,1130,2282
TURKANA,TURKANA EAST,2,1838,1717,3555
TURKANA,TURKANA EAST,3,1790,1626,3416
TURKANA,TURKANA EAST,4,1924,1912,3836
TURKANA,TURKANA EAST,0 - 4,7491,7201,14692
TURKANA,TURKANA EAST,5,2138,1945,4083
TURKANA,TURKANA EAST,6,2114,2043,4157
TURKANA,TURKANA EAST,7,1902,1646,3548
TURKANA,TURKANA EAST,8,2485,2370,4855
TURKANA,TURKANA EAST,9,1849,1764,3613
TURKANA,TURKANA EAST,05-Sep,10488,9768,20256
TURKANA,TURKANA EAST,10,3732,3463,7195
TURKANA,TURKANA EAST,11,1557,1629,3186
TURKANA,TURKANA EAST,12,3134,2237,5371
TURKANA,TURKANA EAST,13,2299,1623,3922
TURKANA,TURKANA EAST,14,2692,1718,4410
TURKANA,TURKANA EAST,Oct-14,13414,10670,24084
TURKANA,TURKANA EAST,15,3272,2172,5444
TURKANA,TURKANA EAST,16,2707,1691,4398
TURKANA,TURKANA EAST,17,2391,1421,3812
TURKANA,TURKANA EAST,18,2636,1823,4459
TURKANA,TURKANA EAST,19,1782,1207,2989
TURKANA,TURKANA EAST,15-19,12788,8314,21102
TURKANA,TURKANA EAST,20,4120,2242,6362
TURKANA,TURKANA EAST,21,1581,1090,2671
TURKANA,TURKANA EAST,22,1447,1048,2495
TURKANA,TURKANA EAST,23,1474,1130,2604
TURKANA,TURKANA EAST,24,1458,1036,2494
TURKANA,TURKANA EAST,20-24,10080,6546,16626
TURKANA,TURKANA EAST,25,2189,1469,3658
TURKANA,TURKANA EAST,26,1089,921,2010
TURKANA,TURKANA EAST,27,1006,867,1873
TURKANA,TURKANA EAST,28,1170,969,2139
TURKANA,TURKANA EAST,29,929,854,1783
TURKANA,TURKANA EAST,25-29,6383,5080,11463
TURKANA,TURKANA EAST,30,2054,1745,3799
TURKANA,TURKANA EAST,31,514,429,943
TURKANA,TURKANA EAST,32,757,683,1440
TURKANA,TURKANA EAST,33,485,433,918
TURKANA,TURKANA EAST,34,484,530,1014
TURKANA,TURKANA EAST,30-34,4294,3820,8114
TURKANA,TURKANA EAST,35,1073,1026,2099
TURKANA,TURKANA EAST,36,465,558,1023
TURKANA,TURKANA EAST,37,360,359,719
TURKANA,TURKANA EAST,38,453,500,953
TURKANA,TURKANA EAST,39,474,527,1001
TURKANA,TURKANA EAST,35-39,2825,2970,5795
TURKANA,TURKANA EAST,40,1260,1019,2279
TURKANA,TURKANA EAST,41,311,344,655
TURKANA,TURKANA EAST,42,521,398,919
TURKANA,TURKANA EAST,43,299,284,583
TURKANA,TURKANA EAST,44,243,234,477
TURKANA,TURKANA EAST,40-44,2634,2279,4913
TURKANA,TURKANA EAST,45,728,613,1341
TURKANA,TURKANA EAST,46,312,288,600
TURKANA,TURKANA EAST,47,301,233,534
TURKANA,TURKANA EAST,48,242,205,447
TURKANA,TURKANA EAST,49,372,260,632
TURKANA,TURKANA EAST,45-49,1955,1599,3554
TURKANA,TURKANA EAST,50,844,601,1445
TURKANA,TURKANA EAST,51,181,116,297
TURKANA,TURKANA EAST,52,249,139,388
TURKANA,TURKANA EAST,53,145,88,233
TURKANA,TURKANA EAST,54,156,103,259
TURKANA,TURKANA EAST,50-54,1575,1047,2622
TURKANA,TURKANA EAST,55,256,191,447
TURKANA,TURKANA EAST,56,197,147,344
TURKANA,TURKANA EAST,57,127,89,216
TURKANA,TURKANA EAST,58,145,133,278
TURKANA,TURKANA EAST,59,174,186,360
TURKANA,TURKANA EAST,55-59,899,746,1645
TURKANA,TURKANA EAST,60,489,326,815
TURKANA,TURKANA EAST,61,95,74,169
TURKANA,TURKANA EAST,62,102,100,202
TURKANA,TURKANA EAST,63,106,115,221
TURKANA,TURKANA EAST,64,69,44,113
TURKANA,TURKANA EAST,60-64,861,659,1520
TURKANA,TURKANA EAST,65,131,120,251
TURKANA,TURKANA EAST,66,47,34,81
TURKANA,TURKANA EAST,67,71,64,135
TURKANA,TURKANA EAST,68,76,56,132
TURKANA,TURKANA EAST,69,119,131,250
TURKANA,TURKANA EAST,65-69,444,405,849
TURKANA,TURKANA EAST,70,208,133,341
TURKANA,TURKANA EAST,71,65,46,111
TURKANA,TURKANA EAST,72,63,39,102
TURKANA,TURKANA EAST,73,22,24,46
TURKANA,TURKANA EAST,74,40,37,77
TURKANA,TURKANA EAST,70-74,398,279,677
TURKANA,TURKANA EAST,75,48,36,84
TURKANA,TURKANA EAST,76,24,16,40
TURKANA,TURKANA EAST,77,16,14,30
TURKANA,TURKANA EAST,78,26,16,42
TURKANA,TURKANA EAST,79,67,41,108
TURKANA,TURKANA EAST,75-79,181,123,304
TURKANA,TURKANA EAST,80,51,42,93
TURKANA,TURKANA EAST,81,9,5,14
TURKANA,TURKANA EAST,82,4,6,10
TURKANA,TURKANA EAST,83,5,8,13
TURKANA,TURKANA EAST,84,11,8,19
TURKANA,TURKANA EAST,80-84,80,69,149
TURKANA,TURKANA EAST,85,23,14,37
TURKANA,TURKANA EAST,86,4,5,9
TURKANA,TURKANA EAST,87,6,7,13
TURKANA,TURKANA EAST,88,5,5,10
TURKANA,TURKANA EAST,89,18,16,34
TURKANA,TURKANA EAST,85-89,56,47,103
TURKANA,TURKANA EAST,90,8,7,15
TURKANA,TURKANA EAST,91,4,1,5
TURKANA,TURKANA EAST,92,2,-,2
TURKANA,TURKANA EAST,93,-,-,-
TURKANA,TURKANA EAST,94,2,-,2
TURKANA,TURKANA EAST,90-94,16,8,24
TURKANA,TURKANA EAST,95,5,8,13
TURKANA,TURKANA EAST,96,1,-,1
TURKANA,TURKANA EAST,97,-,-,-
TURKANA,TURKANA EAST,98,-,-,-
TURKANA,TURKANA EAST,99,1,2,3
TURKANA,TURKANA EAST,95-99,7,10,17
TURKANA,TURKANA EAST,100+,2,3,5
TURKANA,TURKANA EAST,Not Stated,-,-,-
TURKANA,TURKANA NORTH,Total,32810,32408,65218
TURKANA,TURKANA NORTH,0,951,851,1802
TURKANA,TURKANA NORTH,1,838,777,1615
TURKANA,TURKANA NORTH,2,1225,1107,2332
TURKANA,TURKANA NORTH,3,1217,1230,2447
TURKANA,TURKANA NORTH,4,1253,1204,2457
TURKANA,TURKANA NORTH,0 - 4,5484,5169,10653
TURKANA,TURKANA NORTH,5,1350,1205,2555
TURKANA,TURKANA NORTH,6,1184,1216,2400
TURKANA,TURKANA NORTH,7,1114,1050,2164
TURKANA,TURKANA NORTH,8,1237,1132,2369
TURKANA,TURKANA NORTH,9,912,847,1759
TURKANA,TURKANA NORTH,05-Sep,5797,5450,11247
TURKANA,TURKANA NORTH,10,1563,1447,3010
TURKANA,TURKANA NORTH,11,628,697,1325
TURKANA,TURKANA NORTH,12,1261,1056,2317
TURKANA,TURKANA NORTH,13,881,747,1628
TURKANA,TURKANA NORTH,14,841,680,1521
TURKANA,TURKANA NORTH,Oct-14,5174,4627,9801
TURKANA,TURKANA NORTH,15,1191,890,2081
TURKANA,TURKANA NORTH,16,699,596,1295
TURKANA,TURKANA NORTH,17,705,489,1194
TURKANA,TURKANA NORTH,18,662,545,1207
TURKANA,TURKANA NORTH,19,527,425,952
TURKANA,TURKANA NORTH,15-19,3784,2945,6729
TURKANA,TURKANA NORTH,20,925,837,1762
TURKANA,TURKANA NORTH,21,429,493,922
TURKANA,TURKANA NORTH,22,551,544,1095
TURKANA,TURKANA NORTH,23,451,464,915
TURKANA,TURKANA NORTH,24,423,462,885
TURKANA,TURKANA NORTH,20-24,2779,2800,5579
TURKANA,TURKANA NORTH,25,832,718,1550
TURKANA,TURKANA NORTH,26,448,541,989
TURKANA,TURKANA NORTH,27,416,458,874
TURKANA,TURKANA NORTH,28,355,324,679
TURKANA,TURKANA NORTH,29,457,564,1021
TURKANA,TURKANA NORTH,25-29,2508,2605,5113
TURKANA,TURKANA NORTH,30,673,721,1394
TURKANA,TURKANA NORTH,31,294,444,738
TURKANA,TURKANA NORTH,32,322,401,723
TURKANA,TURKANA NORTH,33,219,243,462
TURKANA,TURKANA NORTH,34,239,263,502
TURKANA,TURKANA NORTH,30-34,1747,2072,3819
TURKANA,TURKANA NORTH,35,453,467,920
TURKANA,TURKANA NORTH,36,215,271,486
TURKANA,TURKANA NORTH,37,180,189,369
TURKANA,TURKANA NORTH,38,155,155,310
TURKANA,TURKANA NORTH,39,302,393,695
TURKANA,TURKANA NORTH,35-39,1305,1475,2780
TURKANA,TURKANA NORTH,40,398,314,712
TURKANA,TURKANA NORTH,41,176,223,399
TURKANA,TURKANA NORTH,42,189,187,376
TURKANA,TURKANA NORTH,43,118,206,324
TURKANA,TURKANA NORTH,44,100,139,239
TURKANA,TURKANA NORTH,40-44,981,1069,2050
TURKANA,TURKANA NORTH,45,314,310,624
TURKANA,TURKANA NORTH,46,121,204,325
TURKANA,TURKANA NORTH,47,134,152,286
TURKANA,TURKANA NORTH,48,92,103,195
TURKANA,TURKANA NORTH,49,163,259,422
TURKANA,TURKANA NORTH,45-49,824,1028,1852
TURKANA,TURKANA NORTH,50,291,288,579
TURKANA,TURKANA NORTH,51,97,147,244
TURKANA,TURKANA NORTH,52,83,91,174
TURKANA,TURKANA NORTH,53,80,77,157
TURKANA,TURKANA NORTH,54,101,121,222
TURKANA,TURKANA NORTH,50-54,652,724,1376
TURKANA,TURKANA NORTH,55,91,87,178
TURKANA,TURKANA NORTH,56,78,97,175
TURKANA,TURKANA NORTH,57,51,76,127
TURKANA,TURKANA NORTH,58,59,54,113
TURKANA,TURKANA NORTH,59,110,190,300
TURKANA,TURKANA NORTH,55-59,389,504,893
TURKANA,TURKANA NORTH,60,169,199,368
TURKANA,TURKANA NORTH,61,70,139,209
TURKANA,TURKANA NORTH,62,68,93,161
TURKANA,TURKANA NORTH,63,60,119,179
TURKANA,TURKANA NORTH,64,52,68,120
TURKANA,TURKANA NORTH,60-64,419,618,1037
TURKANA,TURKANA NORTH,65,82,112,194
TURKANA,TURKANA NORTH,66,34,47,81
TURKANA,TURKANA NORTH,67,57,67,124
TURKANA,TURKANA NORTH,68,41,46,87
TURKANA,TURKANA NORTH,69,114,165,279
TURKANA,TURKANA NORTH,65-69,328,437,765
TURKANA,TURKANA NORTH,70,130,137,267
TURKANA,TURKANA NORTH,71,48,95,143
TURKANA,TURKANA NORTH,72,38,58,96
TURKANA,TURKANA NORTH,73,32,47,79
TURKANA,TURKANA NORTH,74,50,66,116
TURKANA,TURKANA NORTH,70-74,298,403,701
TURKANA,TURKANA NORTH,75,31,36,67
TURKANA,TURKANA NORTH,76,20,29,49
TURKANA,TURKANA NORTH,77,19,31,50
TURKANA,TURKANA NORTH,78,21,24,45
TURKANA,TURKANA NORTH,79,60,88,148
TURKANA,TURKANA NORTH,75-79,151,208,359
TURKANA,TURKANA NORTH,80,51,53,104
TURKANA,TURKANA NORTH,81,13,32,45
TURKANA,TURKANA NORTH,82,13,18,31
TURKANA,TURKANA NORTH,83,6,24,30
TURKANA,TURKANA NORTH,84,11,20,31
TURKANA,TURKANA NORTH,80-84,94,147,241
TURKANA,TURKANA NORTH,85,15,14,29
TURKANA,TURKANA NORTH,86,3,6,9
TURKANA,TURKANA NORTH,87,8,7,15
TURKANA,TURKANA NORTH,88,2,7,9
TURKANA,TURKANA NORTH,89,28,48,76
TURKANA,TURKANA NORTH,85-89,56,82,138
TURKANA,TURKANA NORTH,90,9,15,24
TURKANA,TURKANA NORTH,91,6,6,12
TURKANA,TURKANA NORTH,92,2,1,3
TURKANA,TURKANA NORTH,93,2,3,5
TURKANA,TURKANA NORTH,94,4,4,8
TURKANA,TURKANA NORTH,90-94,23,29,52
TURKANA,TURKANA NORTH,95,4,3,7
TURKANA,TURKANA NORTH,96,1,-,1
TURKANA,TURKANA NORTH,97,2,-,2
TURKANA,TURKANA NORTH,98,2,2,4
TURKANA,TURKANA NORTH,99,4,7,11
TURKANA,TURKANA NORTH,95-99,13,12,25
TURKANA,TURKANA NORTH,100+,4,4,8
TURKANA,TURKANA NORTH,Not Stated,-,-,-
TURKANA,TURKANA SOUTH,Total,78402,75329,153731
TURKANA,TURKANA SOUTH,0,1453,1505,2958
TURKANA,TURKANA SOUTH,1,1628,1633,3261
TURKANA,TURKANA SOUTH,2,2208,2400,4608
TURKANA,TURKANA SOUTH,3,2404,2562,4966
TURKANA,TURKANA SOUTH,4,2475,2519,4994
TURKANA,TURKANA SOUTH,0 - 4,10168,10619,20787
TURKANA,TURKANA SOUTH,5,2620,2647,5267
TURKANA,TURKANA SOUTH,6,2542,2549,5091
TURKANA,TURKANA SOUTH,7,2024,2199,4223
TURKANA,TURKANA SOUTH,8,2813,2794,5607
TURKANA,TURKANA SOUTH,9,1964,2001,3965
TURKANA,TURKANA SOUTH,05-Sep,11963,12190,24153
TURKANA,TURKANA SOUTH,10,3455,3607,7062
TURKANA,TURKANA SOUTH,11,1648,1967,3615
TURKANA,TURKANA SOUTH,12,2940,2646,5586
TURKANA,TURKANA SOUTH,13,2174,1969,4143
TURKANA,TURKANA SOUTH,14,2244,2064,4308
TURKANA,TURKANA SOUTH,Oct-14,12461,12253,24714
TURKANA,TURKANA SOUTH,15,3122,2527,5649
TURKANA,TURKANA SOUTH,16,2236,1860,4096
TURKANA,TURKANA SOUTH,17,2188,1669,3857
TURKANA,TURKANA SOUTH,18,2399,1998,4397
TURKANA,TURKANA SOUTH,19,1506,1307,2813
TURKANA,TURKANA SOUTH,15-19,11451,9361,20812
TURKANA,TURKANA SOUTH,20,2630,2372,5002
TURKANA,TURKANA SOUTH,21,1254,1135,2389
TURKANA,TURKANA SOUTH,22,1319,1216,2535
TURKANA,TURKANA SOUTH,23,1286,1114,2400
TURKANA,TURKANA SOUTH,24,1242,1046,2288
TURKANA,TURKANA SOUTH,20-24,7731,6883,14614
TURKANA,TURKANA SOUTH,25,1939,1718,3657
TURKANA,TURKANA SOUTH,26,983,1043,2026
TURKANA,TURKANA SOUTH,27,947,967,1914
TURKANA,TURKANA SOUTH,28,1141,1148,2289
TURKANA,TURKANA SOUTH,29,909,780,1689
TURKANA,TURKANA SOUTH,25-29,5919,5656,11575
TURKANA,TURKANA SOUTH,30,1996,2055,4051
TURKANA,TURKANA SOUTH,31,562,535,1097
TURKANA,TURKANA SOUTH,32,903,832,1735
TURKANA,TURKANA SOUTH,33,529,559,1088
TURKANA,TURKANA SOUTH,34,543,609,1152
TURKANA,TURKANA SOUTH,30-34,4533,4590,9123
TURKANA,TURKANA SOUTH,35,1219,1155,2374
TURKANA,TURKANA SOUTH,36,522,585,1107
TURKANA,TURKANA SOUTH,37,478,451,929
TURKANA,TURKANA SOUTH,38,492,504,996
TURKANA,TURKANA SOUTH,39,501,521,1022
TURKANA,TURKANA SOUTH,35-39,3212,3216,6428
TURKANA,TURKANA SOUTH,40,1360,1071,2431
TURKANA,TURKANA SOUTH,41,399,379,778
TURKANA,TURKANA SOUTH,42,571,523,1094
TURKANA,TURKANA SOUTH,43,321,307,628
TURKANA,TURKANA SOUTH,44,276,232,508
TURKANA,TURKANA SOUTH,40-44,2927,2512,5439
TURKANA,TURKANA SOUTH,45,869,712,1581
TURKANA,TURKANA SOUTH,46,409,455,864
TURKANA,TURKANA SOUTH,47,317,266,583
TURKANA,TURKANA SOUTH,48,320,287,607
TURKANA,TURKANA SOUTH,49,289,259,548
TURKANA,TURKANA SOUTH,45-49,2204,1979,4183
TURKANA,TURKANA SOUTH,50,811,641,1452
TURKANA,TURKANA SOUTH,51,201,183,384
TURKANA,TURKANA SOUTH,52,264,202,466
TURKANA,TURKANA SOUTH,53,156,132,288
TURKANA,TURKANA SOUTH,54,174,213,387
TURKANA,TURKANA SOUTH,50-54,1606,1371,2977
TURKANA,TURKANA SOUTH,55,284,264,548
TURKANA,TURKANA SOUTH,56,253,234,487
TURKANA,TURKANA SOUTH,57,159,154,313
TURKANA,TURKANA SOUTH,58,168,152,320
TURKANA,TURKANA SOUTH,59,199,272,471
TURKANA,TURKANA SOUTH,55-59,1063,1076,2139
TURKANA,TURKANA SOUTH,60,476,479,955
TURKANA,TURKANA SOUTH,61,152,197,349
TURKANA,TURKANA SOUTH,62,134,146,280
TURKANA,TURKANA SOUTH,63,146,175,321
TURKANA,TURKANA SOUTH,64,95,109,204
TURKANA,TURKANA SOUTH,60-64,1003,1106,2109
TURKANA,TURKANA SOUTH,65,237,260,497
TURKANA,TURKANA SOUTH,66,77,78,155
TURKANA,TURKANA SOUTH,67,150,138,288
TURKANA,TURKANA SOUTH,68,105,108,213
TURKANA,TURKANA SOUTH,69,163,213,376
TURKANA,TURKANA SOUTH,65-69,732,797,1529
TURKANA,TURKANA SOUTH,70,358,419,777
TURKANA,TURKANA SOUTH,71,91,132,223
TURKANA,TURKANA SOUTH,72,110,114,224
TURKANA,TURKANA SOUTH,73,64,93,157
TURKANA,TURKANA SOUTH,74,106,93,199
TURKANA,TURKANA SOUTH,70-74,729,851,1580
TURKANA,TURKANA SOUTH,75,92,130,222
TURKANA,TURKANA SOUTH,76,56,61,117
TURKANA,TURKANA SOUTH,77,45,39,84
TURKANA,TURKANA SOUTH,78,50,47,97
TURKANA,TURKANA SOUTH,79,95,120,215
TURKANA,TURKANA SOUTH,75-79,338,397,735
TURKANA,TURKANA SOUTH,80,135,154,289
TURKANA,TURKANA SOUTH,81,34,29,63
TURKANA,TURKANA SOUTH,82,14,21,35
TURKANA,TURKANA SOUTH,83,11,30,41
TURKANA,TURKANA SOUTH,84,22,31,53
TURKANA,TURKANA SOUTH,80-84,216,265,481
TURKANA,TURKANA SOUTH,85,26,35,61
TURKANA,TURKANA SOUTH,86,12,12,24
TURKANA,TURKANA SOUTH,87,8,16,24
TURKANA,TURKANA SOUTH,88,8,5,13
TURKANA,TURKANA SOUTH,89,35,46,81
TURKANA,TURKANA SOUTH,85-89,89,114,203
TURKANA,TURKANA SOUTH,90,16,29,45
TURKANA,TURKANA SOUTH,91,3,9,12
TURKANA,TURKANA SOUTH,92,2,4,6
TURKANA,TURKANA SOUTH,93,2,5,7
TURKANA,TURKANA SOUTH,94,7,6,13
TURKANA,TURKANA SOUTH,90-94,30,53,83
TURKANA,TURKANA SOUTH,95,8,12,20
TURKANA,TURKANA SOUTH,96,2,9,11
TURKANA,TURKANA SOUTH,97,2,2,4
TURKANA,TURKANA SOUTH,98,2,2,4
TURKANA,TURKANA SOUTH,99,5,4,9
TURKANA,TURKANA SOUTH,95-99,19,29,48
TURKANA,TURKANA SOUTH,100+,8,11,19
TURKANA,TURKANA SOUTH,Not Stated,-,-,-
TURKANA,TURKANA WEST,Total,123867,115758,239625
TURKANA,TURKANA WEST,0,2603,2570,5173
TURKANA,TURKANA WEST,1,2859,2884,5743
TURKANA,TURKANA WEST,2,3660,3639,7299
TURKANA,TURKANA WEST,3,3913,3753,7666
TURKANA,TURKANA WEST,4,3914,3910,7824
TURKANA,TURKANA WEST,0 - 4,16949,16756,33705
TURKANA,TURKANA WEST,5,4017,3929,7946
TURKANA,TURKANA WEST,6,4031,3797,7828
TURKANA,TURKANA WEST,7,3605,3385,6990
TURKANA,TURKANA WEST,8,3978,3674,7652
TURKANA,TURKANA WEST,9,3260,3167,6427
TURKANA,TURKANA WEST,05-Sep,18891,17952,36843
TURKANA,TURKANA WEST,10,4689,4273,8962
TURKANA,TURKANA WEST,11,2868,2818,5686
TURKANA,TURKANA WEST,12,4209,3477,7686
TURKANA,TURKANA WEST,13,3501,2937,6438
TURKANA,TURKANA WEST,14,3663,3017,6680
TURKANA,TURKANA WEST,Oct-14,18930,16522,35452
TURKANA,TURKANA WEST,15,4236,3242,7478
TURKANA,TURKANA WEST,16,3499,2746,6245
TURKANA,TURKANA WEST,17,3358,2544,5902
TURKANA,TURKANA WEST,18,3669,2735,6404
TURKANA,TURKANA WEST,19,3142,2588,5730
TURKANA,TURKANA WEST,15-19,17904,13855,31759
TURKANA,TURKANA WEST,20,4103,3341,7444
TURKANA,TURKANA WEST,21,2374,1917,4291
TURKANA,TURKANA WEST,22,2902,2376,5278
TURKANA,TURKANA WEST,23,2401,1933,4334
TURKANA,TURKANA WEST,24,2266,1990,4256
TURKANA,TURKANA WEST,20-24,14046,11557,25603
TURKANA,TURKANA WEST,25,2864,2527,5391
TURKANA,TURKANA WEST,26,1823,1804,3627
TURKANA,TURKANA WEST,27,2168,1963,4131
TURKANA,TURKANA WEST,28,1801,1593,3394
TURKANA,TURKANA WEST,29,1838,1892,3730
TURKANA,TURKANA WEST,25-29,10494,9779,20273
TURKANA,TURKANA WEST,30,2912,2964,5876
TURKANA,TURKANA WEST,31,1142,1298,2440
TURKANA,TURKANA WEST,32,1447,1458,2905
TURKANA,TURKANA WEST,33,1096,1338,2434
TURKANA,TURKANA WEST,34,1117,1234,2351
TURKANA,TURKANA WEST,30-34,7714,8292,16006
TURKANA,TURKANA WEST,35,1645,1737,3382
TURKANA,TURKANA WEST,36,859,971,1830
TURKANA,TURKANA WEST,37,863,978,1841
TURKANA,TURKANA WEST,38,765,856,1621
TURKANA,TURKANA WEST,39,1169,1490,2659
TURKANA,TURKANA WEST,35-39,5301,6032,11333
TURKANA,TURKANA WEST,40,1747,1380,3127
TURKANA,TURKANA WEST,41,699,860,1559
TURKANA,TURKANA WEST,42,739,676,1415
TURKANA,TURKANA WEST,43,534,572,1106
TURKANA,TURKANA WEST,44,537,595,1132
TURKANA,TURKANA WEST,40-44,4256,4083,8339
TURKANA,TURKANA WEST,45,948,929,1877
TURKANA,TURKANA WEST,46,525,568,1093
TURKANA,TURKANA WEST,47,475,470,945
TURKANA,TURKANA WEST,48,364,365,729
TURKANA,TURKANA WEST,49,525,640,1165
TURKANA,TURKANA WEST,45-49,2837,2972,5809
TURKANA,TURKANA WEST,50,941,901,1842
TURKANA,TURKANA WEST,51,329,414,743
TURKANA,TURKANA WEST,52,278,347,625
TURKANA,TURKANA WEST,53,224,284,508
TURKANA,TURKANA WEST,54,314,344,658
TURKANA,TURKANA WEST,50-54,2086,2290,4376
TURKANA,TURKANA WEST,55,381,405,786
TURKANA,TURKANA WEST,56,317,293,610
TURKANA,TURKANA WEST,57,201,235,436
TURKANA,TURKANA WEST,58,155,193,348
TURKANA,TURKANA WEST,59,340,439,779
TURKANA,TURKANA WEST,55-59,1394,1565,2959
TURKANA,TURKANA WEST,60,512,568,1080
TURKANA,TURKANA WEST,61,216,231,447
TURKANA,TURKANA WEST,62,170,163,333
TURKANA,TURKANA WEST,63,141,229,370
TURKANA,TURKANA WEST,64,135,159,294
TURKANA,TURKANA WEST,60-64,1174,1350,2524
TURKANA,TURKANA WEST,65,221,313,534
TURKANA,TURKANA WEST,66,89,119,208
TURKANA,TURKANA WEST,67,115,179,294
TURKANA,TURKANA WEST,68,83,120,203
TURKANA,TURKANA WEST,69,206,310,516
TURKANA,TURKANA WEST,65-69,714,1041,1755
TURKANA,TURKANA WEST,70,260,336,596
TURKANA,TURKANA WEST,71,87,174,261
TURKANA,TURKANA WEST,72,66,100,166
TURKANA,TURKANA WEST,73,57,98,155
TURKANA,TURKANA WEST,74,113,151,264
TURKANA,TURKANA WEST,70-74,583,859,1442
TURKANA,TURKANA WEST,75,102,98,200
TURKANA,TURKANA WEST,76,39,57,96
TURKANA,TURKANA WEST,77,42,70,112
TURKANA,TURKANA WEST,78,30,55,85
TURKANA,TURKANA WEST,79,90,142,232
TURKANA,TURKANA WEST,75-79,303,422,725
TURKANA,TURKANA WEST,80,90,108,198
TURKANA,TURKANA WEST,81,23,53,76
TURKANA,TURKANA WEST,82,18,24,42
TURKANA,TURKANA WEST,83,14,30,44
TURKANA,TURKANA WEST,84,21,29,50
TURKANA,TURKANA WEST,80-84,166,244,410
TURKANA,TURKANA WEST,85,15,25,40
TURKANA,TURKANA WEST,86,11,21,32
TURKANA,TURKANA WEST,87,16,9,25
TURKANA,TURKANA WEST,88,7,6,13
TURKANA,TURKANA WEST,89,34,49,83
TURKANA,TURKANA WEST,85-89,83,110,193
TURKANA,TURKANA WEST,90,12,19,31
TURKANA,TURKANA WEST,91,5,10,15
TURKANA,TURKANA WEST,92,4,5,9
TURKANA,TURKANA WEST,93,2,11,13
TURKANA,TURKANA WEST,94,4,4,8
TURKANA,TURKANA WEST,90-94,27,49,76
TURKANA,TURKANA WEST,95,1,7,8
TURKANA,TURKANA WEST,96,4,1,5
TURKANA,TURKANA WEST,97,-,3,3
TURKANA,TURKANA WEST,98,2,-,2
TURKANA,TURKANA WEST,99,5,6,11
TURKANA,TURKANA WEST,95-99,12,17,29
TURKANA,TURKANA WEST,100+,3,10,13
TURKANA,TURKANA WEST,Not Stated,-,1,1
UASIN GISHU,ALL,Total,580269,582889,1163158
UASIN GISHU,ALL,0,13650,13823,27473
UASIN GISHU,ALL,1,13849,13774,27623
UASIN GISHU,ALL,2,13952,13639,27591
UASIN GISHU,ALL,3,14238,14562,28800
UASIN GISHU,ALL,4,14657,14079,28736
UASIN GISHU,ALL,0 - 4,70346,69877,140223
UASIN GISHU,ALL,5,13999,13261,27260
UASIN GISHU,ALL,6,14187,14005,28192
UASIN GISHU,ALL,7,14259,13940,28199
UASIN GISHU,ALL,8,13486,13394,26880
UASIN GISHU,ALL,9,15011,15010,30021
UASIN GISHU,ALL,05-Sep,70942,69610,140552
UASIN GISHU,ALL,10,14899,14525,29424
UASIN GISHU,ALL,11,13880,14205,28085
UASIN GISHU,ALL,12,15311,15176,30487
UASIN GISHU,ALL,13,14909,15356,30265
UASIN GISHU,ALL,14,14327,14272,28599
UASIN GISHU,ALL,Oct-14,73326,73534,146860
UASIN GISHU,ALL,15,13886,13934,27820
UASIN GISHU,ALL,16,13317,13797,27114
UASIN GISHU,ALL,17,14077,13889,27966
UASIN GISHU,ALL,18,11017,11113,22130
UASIN GISHU,ALL,19,13368,13533,26901
UASIN GISHU,ALL,15-19,65665,66266,131931
UASIN GISHU,ALL,20,11979,13076,25055
UASIN GISHU,ALL,21,12355,13206,25561
UASIN GISHU,ALL,22,12039,12951,24990
UASIN GISHU,ALL,23,12860,13946,26806
UASIN GISHU,ALL,24,12256,12947,25203
UASIN GISHU,ALL,20-24,61489,66126,127615
UASIN GISHU,ALL,25,13003,13112,26115
UASIN GISHU,ALL,26,10751,11241,21992
UASIN GISHU,ALL,27,10741,11069,21810
UASIN GISHU,ALL,28,8363,8730,17093
UASIN GISHU,ALL,29,9282,9903,19185
UASIN GISHU,ALL,25-29,52140,54055,106195
UASIN GISHU,ALL,30,10768,11468,22236
UASIN GISHU,ALL,31,8078,8307,16385
UASIN GISHU,ALL,32,10261,10835,21096
UASIN GISHU,ALL,33,8387,9235,17622
UASIN GISHU,ALL,34,7816,8298,16114
UASIN GISHU,ALL,30-34,45310,48143,93453
UASIN GISHU,ALL,35,10039,9778,19817
UASIN GISHU,ALL,36,6872,6301,13173
UASIN GISHU,ALL,37,7072,6239,13311
UASIN GISHU,ALL,38,5188,4797,9985
UASIN GISHU,ALL,39,6214,5718,11932
UASIN GISHU,ALL,35-39,35385,32833,68218
UASIN GISHU,ALL,40,6989,6336,13325
UASIN GISHU,ALL,41,6794,5958,12752
UASIN GISHU,ALL,42,6256,5646,11902
UASIN GISHU,ALL,43,5243,5191,10434
UASIN GISHU,ALL,44,4262,3927,8189
UASIN GISHU,ALL,40-44,29544,27058,56602
UASIN GISHU,ALL,45,6936,6068,13004
UASIN GISHU,ALL,46,4710,4431,9141
UASIN GISHU,ALL,47,4880,4528,9408
UASIN GISHU,ALL,48,3169,2945,6114
UASIN GISHU,ALL,49,3990,3704,7694
UASIN GISHU,ALL,45-49,23685,21676,45361
UASIN GISHU,ALL,50,4214,3829,8043
UASIN GISHU,ALL,51,3353,3057,6410
UASIN GISHU,ALL,52,2937,2757,5694
UASIN GISHU,ALL,53,2354,2152,4506
UASIN GISHU,ALL,54,2708,2415,5123
UASIN GISHU,ALL,50-54,15566,14210,29776
UASIN GISHU,ALL,55,2641,2085,4726
UASIN GISHU,ALL,56,2373,2429,4802
UASIN GISHU,ALL,57,2520,3012,5532
UASIN GISHU,ALL,58,2312,2613,4925
UASIN GISHU,ALL,59,2498,2293,4791
UASIN GISHU,ALL,55-59,12344,12432,24776
UASIN GISHU,ALL,60,2448,2376,4824
UASIN GISHU,ALL,61,1878,1875,3753
UASIN GISHU,ALL,62,1531,1493,3024
UASIN GISHU,ALL,63,1497,1552,3049
UASIN GISHU,ALL,64,1165,1166,2331
UASIN GISHU,ALL,60-64,8519,8462,16981
UASIN GISHU,ALL,65,1677,1741,3418
UASIN GISHU,ALL,66,956,1055,2011
UASIN GISHU,ALL,67,1678,1782,3460
UASIN GISHU,ALL,68,723,714,1437
UASIN GISHU,ALL,69,1153,1164,2317
UASIN GISHU,ALL,65-69,6187,6456,12643
UASIN GISHU,ALL,70,1223,1439,2662
UASIN GISHU,ALL,71,991,1004,1995
UASIN GISHU,ALL,72,733,701,1434
UASIN GISHU,ALL,73,650,597,1247
UASIN GISHU,ALL,74,626,733,1359
UASIN GISHU,ALL,70-74,4223,4474,8697
UASIN GISHU,ALL,75,604,792,1396
UASIN GISHU,ALL,76,622,824,1446
UASIN GISHU,ALL,77,538,586,1124
UASIN GISHU,ALL,78,298,310,608
UASIN GISHU,ALL,79,443,700,1143
UASIN GISHU,ALL,75-79,2505,3212,5717
UASIN GISHU,ALL,80,474,697,1171
UASIN GISHU,ALL,81,268,390,658
UASIN GISHU,ALL,82,265,232,497
UASIN GISHU,ALL,83,281,313,594
UASIN GISHU,ALL,84,260,385,645
UASIN GISHU,ALL,80-84,1548,2017,3565
UASIN GISHU,ALL,85,206,335,541
UASIN GISHU,ALL,86,153,205,358
UASIN GISHU,ALL,87,181,219,400
UASIN GISHU,ALL,88,103,111,214
UASIN GISHU,ALL,89,181,388,569
UASIN GISHU,ALL,85-89,824,1258,2082
UASIN GISHU,ALL,90,107,215,322
UASIN GISHU,ALL,91,80,115,195
UASIN GISHU,ALL,92,67,75,142
UASIN GISHU,ALL,93,76,64,140
UASIN GISHU,ALL,94,45,106,151
UASIN GISHU,ALL,90-94,375,575,950
UASIN GISHU,ALL,95,124,164,288
UASIN GISHU,ALL,96,34,53,87
UASIN GISHU,ALL,97,46,59,105
UASIN GISHU,ALL,98,25,24,49
UASIN GISHU,ALL,99,35,94,129
UASIN GISHU,ALL,95-99,264,394,658
UASIN GISHU,ALL,100+,73,218,291
UASIN GISHU,ALL,Not Stated,9,3,12
UASIN GISHU,AINABKOI,Total,68348,69835,138183
UASIN GISHU,AINABKOI,0,1634,1719,3353
UASIN GISHU,AINABKOI,1,1603,1510,3113
UASIN GISHU,AINABKOI,2,1612,1525,3137
UASIN GISHU,AINABKOI,3,1696,1785,3481
UASIN GISHU,AINABKOI,4,1690,1600,3290
UASIN GISHU,AINABKOI,0 - 4,8235,8139,16374
UASIN GISHU,AINABKOI,5,1628,1599,3227
UASIN GISHU,AINABKOI,6,1623,1623,3246
UASIN GISHU,AINABKOI,7,1726,1692,3418
UASIN GISHU,AINABKOI,8,1554,1547,3101
UASIN GISHU,AINABKOI,9,1761,1777,3538
UASIN GISHU,AINABKOI,05-Sep,8292,8238,16530
UASIN GISHU,AINABKOI,10,1825,1707,3532
UASIN GISHU,AINABKOI,11,1690,1634,3324
UASIN GISHU,AINABKOI,12,1771,1754,3525
UASIN GISHU,AINABKOI,13,1751,1835,3586
UASIN GISHU,AINABKOI,14,1723,1807,3530
UASIN GISHU,AINABKOI,Oct-14,8760,8737,17497
UASIN GISHU,AINABKOI,15,1600,1775,3375
UASIN GISHU,AINABKOI,16,1595,1669,3264
UASIN GISHU,AINABKOI,17,1676,1652,3328
UASIN GISHU,AINABKOI,18,1343,1330,2673
UASIN GISHU,AINABKOI,19,1604,1683,3287
UASIN GISHU,AINABKOI,15-19,7818,8109,15927
UASIN GISHU,AINABKOI,20,1382,1493,2875
UASIN GISHU,AINABKOI,21,1409,1529,2938
UASIN GISHU,AINABKOI,22,1364,1456,2820
UASIN GISHU,AINABKOI,23,1420,1574,2994
UASIN GISHU,AINABKOI,24,1342,1483,2825
UASIN GISHU,AINABKOI,20-24,6917,7535,14452
UASIN GISHU,AINABKOI,25,1424,1514,2938
UASIN GISHU,AINABKOI,26,1267,1224,2491
UASIN GISHU,AINABKOI,27,1209,1277,2486
UASIN GISHU,AINABKOI,28,939,980,1919
UASIN GISHU,AINABKOI,29,1055,1164,2219
UASIN GISHU,AINABKOI,25-29,5894,6159,12053
UASIN GISHU,AINABKOI,30,1252,1361,2613
UASIN GISHU,AINABKOI,31,904,999,1903
UASIN GISHU,AINABKOI,32,1145,1302,2447
UASIN GISHU,AINABKOI,33,979,1103,2082
UASIN GISHU,AINABKOI,34,929,1002,1931
UASIN GISHU,AINABKOI,30-34,5209,5767,10976
UASIN GISHU,AINABKOI,35,1218,1250,2468
UASIN GISHU,AINABKOI,36,811,749,1560
UASIN GISHU,AINABKOI,37,831,779,1610
UASIN GISHU,AINABKOI,38,642,657,1299
UASIN GISHU,AINABKOI,39,709,693,1402
UASIN GISHU,AINABKOI,35-39,4211,4128,8339
UASIN GISHU,AINABKOI,40,816,831,1647
UASIN GISHU,AINABKOI,41,849,723,1572
UASIN GISHU,AINABKOI,42,728,694,1422
UASIN GISHU,AINABKOI,43,646,635,1281
UASIN GISHU,AINABKOI,44,507,504,1011
UASIN GISHU,AINABKOI,40-44,3546,3387,6933
UASIN GISHU,AINABKOI,45,860,750,1610
UASIN GISHU,AINABKOI,46,558,563,1121
UASIN GISHU,AINABKOI,47,586,589,1175
UASIN GISHU,AINABKOI,48,414,378,792
UASIN GISHU,AINABKOI,49,489,462,951
UASIN GISHU,AINABKOI,45-49,2907,2742,5649
UASIN GISHU,AINABKOI,50,556,507,1063
UASIN GISHU,AINABKOI,51,392,379,771
UASIN GISHU,AINABKOI,52,410,364,774
UASIN GISHU,AINABKOI,53,287,245,532
UASIN GISHU,AINABKOI,54,331,315,646
UASIN GISHU,AINABKOI,50-54,1976,1810,3786
UASIN GISHU,AINABKOI,55,345,249,594
UASIN GISHU,AINABKOI,56,269,271,540
UASIN GISHU,AINABKOI,57,296,397,693
UASIN GISHU,AINABKOI,58,275,365,640
UASIN GISHU,AINABKOI,59,291,267,558
UASIN GISHU,AINABKOI,55-59,1476,1549,3025
UASIN GISHU,AINABKOI,60,332,321,653
UASIN GISHU,AINABKOI,61,228,207,435
UASIN GISHU,AINABKOI,62,183,182,365
UASIN GISHU,AINABKOI,63,178,200,378
UASIN GISHU,AINABKOI,64,150,152,302
UASIN GISHU,AINABKOI,60-64,1071,1062,2133
UASIN GISHU,AINABKOI,65,195,231,426
UASIN GISHU,AINABKOI,66,124,119,243
UASIN GISHU,AINABKOI,67,223,244,467
UASIN GISHU,AINABKOI,68,86,99,185
UASIN GISHU,AINABKOI,69,124,140,264
UASIN GISHU,AINABKOI,65-69,752,833,1585
UASIN GISHU,AINABKOI,70,149,223,372
UASIN GISHU,AINABKOI,71,120,103,223
UASIN GISHU,AINABKOI,72,96,102,198
UASIN GISHU,AINABKOI,73,83,70,153
UASIN GISHU,AINABKOI,74,84,108,192
UASIN GISHU,AINABKOI,70-74,532,606,1138
UASIN GISHU,AINABKOI,75,100,100,200
UASIN GISHU,AINABKOI,76,79,105,184
UASIN GISHU,AINABKOI,77,62,83,145
UASIN GISHU,AINABKOI,78,41,45,86
UASIN GISHU,AINABKOI,79,54,101,155
UASIN GISHU,AINABKOI,75-79,336,434,770
UASIN GISHU,AINABKOI,80,72,112,184
UASIN GISHU,AINABKOI,81,29,47,76
UASIN GISHU,AINABKOI,82,36,32,68
UASIN GISHU,AINABKOI,83,44,39,83
UASIN GISHU,AINABKOI,84,43,54,97
UASIN GISHU,AINABKOI,80-84,224,284,508
UASIN GISHU,AINABKOI,85,19,43,62
UASIN GISHU,AINABKOI,86,27,19,46
UASIN GISHU,AINABKOI,87,22,33,55
UASIN GISHU,AINABKOI,88,11,24,35
UASIN GISHU,AINABKOI,89,27,41,68
UASIN GISHU,AINABKOI,85-89,106,160,266
UASIN GISHU,AINABKOI,90,25,27,52
UASIN GISHU,AINABKOI,91,8,13,21
UASIN GISHU,AINABKOI,92,6,10,16
UASIN GISHU,AINABKOI,93,8,8,16
UASIN GISHU,AINABKOI,94,6,17,23
UASIN GISHU,AINABKOI,90-94,53,75,128
UASIN GISHU,AINABKOI,95,10,22,32
UASIN GISHU,AINABKOI,96,7,7,14
UASIN GISHU,AINABKOI,97,4,8,12
UASIN GISHU,AINABKOI,98,3,3,6
UASIN GISHU,AINABKOI,99,3,10,13
UASIN GISHU,AINABKOI,95-99,27,50,77
UASIN GISHU,AINABKOI,100+,6,30,36
UASIN GISHU,AINABKOI,Not Stated,-,1,1
UASIN GISHU,KAPSERET,Total,99650,98845,198495
UASIN GISHU,KAPSERET,0,2354,2360,4714
UASIN GISHU,KAPSERET,1,2370,2323,4693
UASIN GISHU,KAPSERET,2,2366,2289,4655
UASIN GISHU,KAPSERET,3,2333,2321,4654
UASIN GISHU,KAPSERET,4,2316,2243,4559
UASIN GISHU,KAPSERET,0 - 4,11739,11536,23275
UASIN GISHU,KAPSERET,5,2171,2087,4258
UASIN GISHU,KAPSERET,6,2216,2190,4406
UASIN GISHU,KAPSERET,7,2160,2180,4340
UASIN GISHU,KAPSERET,8,2103,2202,4305
UASIN GISHU,KAPSERET,9,2335,2365,4700
UASIN GISHU,KAPSERET,05-Sep,10985,11024,22009
UASIN GISHU,KAPSERET,10,2182,2294,4476
UASIN GISHU,KAPSERET,11,2029,2085,4114
UASIN GISHU,KAPSERET,12,2336,2334,4670
UASIN GISHU,KAPSERET,13,2240,2290,4530
UASIN GISHU,KAPSERET,14,2130,2131,4261
UASIN GISHU,KAPSERET,Oct-14,10917,11134,22051
UASIN GISHU,KAPSERET,15,2038,2000,4038
UASIN GISHU,KAPSERET,16,1881,2090,3971
UASIN GISHU,KAPSERET,17,2042,2213,4255
UASIN GISHU,KAPSERET,18,1689,1870,3559
UASIN GISHU,KAPSERET,19,2086,2354,4440
UASIN GISHU,KAPSERET,15-19,9736,10527,20263
UASIN GISHU,KAPSERET,20,2141,2548,4689
UASIN GISHU,KAPSERET,21,2269,2684,4953
UASIN GISHU,KAPSERET,22,2297,2602,4899
UASIN GISHU,KAPSERET,23,2583,2877,5460
UASIN GISHU,KAPSERET,24,2459,2629,5088
UASIN GISHU,KAPSERET,20-24,11749,13340,25089
UASIN GISHU,KAPSERET,25,2568,2603,5171
UASIN GISHU,KAPSERET,26,2143,2208,4351
UASIN GISHU,KAPSERET,27,2133,2223,4356
UASIN GISHU,KAPSERET,28,1780,1770,3550
UASIN GISHU,KAPSERET,29,1924,1926,3850
UASIN GISHU,KAPSERET,25-29,10548,10730,21278
UASIN GISHU,KAPSERET,30,2254,2201,4455
UASIN GISHU,KAPSERET,31,1674,1556,3230
UASIN GISHU,KAPSERET,32,2021,2049,4070
UASIN GISHU,KAPSERET,33,1643,1652,3295
UASIN GISHU,KAPSERET,34,1536,1558,3094
UASIN GISHU,KAPSERET,30-34,9128,9016,18144
UASIN GISHU,KAPSERET,35,1929,1828,3757
UASIN GISHU,KAPSERET,36,1355,1221,2576
UASIN GISHU,KAPSERET,37,1312,1145,2457
UASIN GISHU,KAPSERET,38,1058,954,2012
UASIN GISHU,KAPSERET,39,1233,1122,2355
UASIN GISHU,KAPSERET,35-39,6887,6270,13157
UASIN GISHU,KAPSERET,40,1360,1188,2548
UASIN GISHU,KAPSERET,41,1232,1015,2247
UASIN GISHU,KAPSERET,42,1159,997,2156
UASIN GISHU,KAPSERET,43,1012,904,1916
UASIN GISHU,KAPSERET,44,798,666,1464
UASIN GISHU,KAPSERET,40-44,5561,4770,10331
UASIN GISHU,KAPSERET,45,1184,937,2121
UASIN GISHU,KAPSERET,46,839,682,1521
UASIN GISHU,KAPSERET,47,866,699,1565
UASIN GISHU,KAPSERET,48,591,469,1060
UASIN GISHU,KAPSERET,49,752,584,1336
UASIN GISHU,KAPSERET,45-49,4232,3371,7603
UASIN GISHU,KAPSERET,50,795,638,1433
UASIN GISHU,KAPSERET,51,599,465,1064
UASIN GISHU,KAPSERET,52,522,430,952
UASIN GISHU,KAPSERET,53,391,317,708
UASIN GISHU,KAPSERET,54,461,382,843
UASIN GISHU,KAPSERET,50-54,2768,2232,5000
UASIN GISHU,KAPSERET,55,461,294,755
UASIN GISHU,KAPSERET,56,417,380,797
UASIN GISHU,KAPSERET,57,470,417,887
UASIN GISHU,KAPSERET,58,333,319,652
UASIN GISHU,KAPSERET,59,395,341,736
UASIN GISHU,KAPSERET,55-59,2076,1751,3827
UASIN GISHU,KAPSERET,60,392,311,703
UASIN GISHU,KAPSERET,61,287,220,507
UASIN GISHU,KAPSERET,62,250,192,442
UASIN GISHU,KAPSERET,63,230,186,416
UASIN GISHU,KAPSERET,64,180,143,323
UASIN GISHU,KAPSERET,60-64,1339,1052,2391
UASIN GISHU,KAPSERET,65,239,188,427
UASIN GISHU,KAPSERET,66,129,133,262
UASIN GISHU,KAPSERET,67,223,200,423
UASIN GISHU,KAPSERET,68,109,93,202
UASIN GISHU,KAPSERET,69,163,130,293
UASIN GISHU,KAPSERET,65-69,863,744,1607
UASIN GISHU,KAPSERET,70,150,164,314
UASIN GISHU,KAPSERET,71,123,105,228
UASIN GISHU,KAPSERET,72,98,76,174
UASIN GISHU,KAPSERET,73,78,80,158
UASIN GISHU,KAPSERET,74,78,75,153
UASIN GISHU,KAPSERET,70-74,527,500,1027
UASIN GISHU,KAPSERET,75,76,83,159
UASIN GISHU,KAPSERET,76,57,92,149
UASIN GISHU,KAPSERET,77,55,69,124
UASIN GISHU,KAPSERET,78,38,36,74
UASIN GISHU,KAPSERET,79,54,82,136
UASIN GISHU,KAPSERET,75-79,280,362,642
UASIN GISHU,KAPSERET,80,44,70,114
UASIN GISHU,KAPSERET,81,32,42,74
UASIN GISHU,KAPSERET,82,29,24,53
UASIN GISHU,KAPSERET,83,31,37,68
UASIN GISHU,KAPSERET,84,27,39,66
UASIN GISHU,KAPSERET,80-84,163,212,375
UASIN GISHU,KAPSERET,85,21,42,63
UASIN GISHU,KAPSERET,86,10,21,31
UASIN GISHU,KAPSERET,87,17,20,37
UASIN GISHU,KAPSERET,88,10,11,21
UASIN GISHU,KAPSERET,89,19,42,61
UASIN GISHU,KAPSERET,85-89,77,136,213
UASIN GISHU,KAPSERET,90,7,20,27
UASIN GISHU,KAPSERET,91,11,20,31
UASIN GISHU,KAPSERET,92,5,9,14
UASIN GISHU,KAPSERET,93,7,8,15
UASIN GISHU,KAPSERET,94,4,11,15
UASIN GISHU,KAPSERET,90-94,34,68,102
UASIN GISHU,KAPSERET,95,16,17,33
UASIN GISHU,KAPSERET,96,5,6,11
UASIN GISHU,KAPSERET,97,4,5,9
UASIN GISHU,KAPSERET,98,2,2,4
UASIN GISHU,KAPSERET,99,2,13,15
UASIN GISHU,KAPSERET,95-99,29,43,72
UASIN GISHU,KAPSERET,100+,10,25,35
UASIN GISHU,KAPSERET,Not Stated,2,2,4
UASIN GISHU,KESSES,Total,74301,74493,148794
UASIN GISHU,KESSES,0,1711,1778,3489
UASIN GISHU,KESSES,1,1720,1682,3402
UASIN GISHU,KESSES,2,1798,1740,3538
UASIN GISHU,KESSES,3,1781,1792,3573
UASIN GISHU,KESSES,4,1946,1892,3838
UASIN GISHU,KESSES,0 - 4,8956,8884,17840
UASIN GISHU,KESSES,5,1917,1754,3671
UASIN GISHU,KESSES,6,1983,1853,3836
UASIN GISHU,KESSES,7,2000,1764,3764
UASIN GISHU,KESSES,8,1834,1878,3712
UASIN GISHU,KESSES,9,2079,2060,4139
UASIN GISHU,KESSES,05-Sep,9813,9309,19122
UASIN GISHU,KESSES,10,2086,2037,4123
UASIN GISHU,KESSES,11,1984,1931,3915
UASIN GISHU,KESSES,12,2192,2149,4341
UASIN GISHU,KESSES,13,2118,2084,4202
UASIN GISHU,KESSES,14,2037,2013,4050
UASIN GISHU,KESSES,Oct-14,10417,10214,20631
UASIN GISHU,KESSES,15,2029,1918,3947
UASIN GISHU,KESSES,16,1943,1997,3940
UASIN GISHU,KESSES,17,2033,1880,3913
UASIN GISHU,KESSES,18,1497,1430,2927
UASIN GISHU,KESSES,19,1687,1595,3282
UASIN GISHU,KESSES,15-19,9189,8820,18009
UASIN GISHU,KESSES,20,1496,1417,2913
UASIN GISHU,KESSES,21,1486,1499,2985
UASIN GISHU,KESSES,22,1435,1381,2816
UASIN GISHU,KESSES,23,1480,1463,2943
UASIN GISHU,KESSES,24,1389,1469,2858
UASIN GISHU,KESSES,20-24,7286,7229,14515
UASIN GISHU,KESSES,25,1485,1413,2898
UASIN GISHU,KESSES,26,1087,1237,2324
UASIN GISHU,KESSES,27,1250,1197,2447
UASIN GISHU,KESSES,28,894,960,1854
UASIN GISHU,KESSES,29,936,1130,2066
UASIN GISHU,KESSES,25-29,5652,5937,11589
UASIN GISHU,KESSES,30,1102,1262,2364
UASIN GISHU,KESSES,31,856,899,1755
UASIN GISHU,KESSES,32,1092,1305,2397
UASIN GISHU,KESSES,33,962,1119,2081
UASIN GISHU,KESSES,34,847,969,1816
UASIN GISHU,KESSES,30-34,4859,5554,10413
UASIN GISHU,KESSES,35,1132,1228,2360
UASIN GISHU,KESSES,36,771,704,1475
UASIN GISHU,KESSES,37,832,747,1579
UASIN GISHU,KESSES,38,574,541,1115
UASIN GISHU,KESSES,39,719,725,1444
UASIN GISHU,KESSES,35-39,4028,3945,7973
UASIN GISHU,KESSES,40,863,764,1627
UASIN GISHU,KESSES,41,854,763,1617
UASIN GISHU,KESSES,42,712,672,1384
UASIN GISHU,KESSES,43,630,670,1300
UASIN GISHU,KESSES,44,530,530,1060
UASIN GISHU,KESSES,40-44,3589,3399,6988
UASIN GISHU,KESSES,45,850,834,1684
UASIN GISHU,KESSES,46,612,602,1214
UASIN GISHU,KESSES,47,612,623,1235
UASIN GISHU,KESSES,48,356,399,755
UASIN GISHU,KESSES,49,476,521,997
UASIN GISHU,KESSES,45-49,2906,2979,5885
UASIN GISHU,KESSES,50,549,522,1071
UASIN GISHU,KESSES,51,465,446,911
UASIN GISHU,KESSES,52,365,386,751
UASIN GISHU,KESSES,53,319,350,669
UASIN GISHU,KESSES,54,408,332,740
UASIN GISHU,KESSES,50-54,2106,2036,4142
UASIN GISHU,KESSES,55,353,313,666
UASIN GISHU,KESSES,56,344,349,693
UASIN GISHU,KESSES,57,336,427,763
UASIN GISHU,KESSES,58,354,420,774
UASIN GISHU,KESSES,59,309,346,655
UASIN GISHU,KESSES,55-59,1696,1855,3551
UASIN GISHU,KESSES,60,357,359,716
UASIN GISHU,KESSES,61,281,316,597
UASIN GISHU,KESSES,62,220,233,453
UASIN GISHU,KESSES,63,193,215,408
UASIN GISHU,KESSES,64,168,186,354
UASIN GISHU,KESSES,60-64,1219,1309,2528
UASIN GISHU,KESSES,65,237,270,507
UASIN GISHU,KESSES,66,156,145,301
UASIN GISHU,KESSES,67,279,258,537
UASIN GISHU,KESSES,68,112,103,215
UASIN GISHU,KESSES,69,193,182,375
UASIN GISHU,KESSES,65-69,977,958,1935
UASIN GISHU,KESSES,70,204,245,449
UASIN GISHU,KESSES,71,151,176,327
UASIN GISHU,KESSES,72,120,97,217
UASIN GISHU,KESSES,73,96,93,189
UASIN GISHU,KESSES,74,98,135,233
UASIN GISHU,KESSES,70-74,669,746,1415
UASIN GISHU,KESSES,75,85,137,222
UASIN GISHU,KESSES,76,96,138,234
UASIN GISHU,KESSES,77,101,83,184
UASIN GISHU,KESSES,78,53,49,102
UASIN GISHU,KESSES,79,79,123,202
UASIN GISHU,KESSES,75-79,414,530,944
UASIN GISHU,KESSES,80,73,127,200
UASIN GISHU,KESSES,81,56,83,139
UASIN GISHU,KESSES,82,52,31,83
UASIN GISHU,KESSES,83,34,51,85
UASIN GISHU,KESSES,84,36,66,102
UASIN GISHU,KESSES,80-84,251,358,609
UASIN GISHU,KESSES,85,36,52,88
UASIN GISHU,KESSES,86,25,32,57
UASIN GISHU,KESSES,87,33,42,75
UASIN GISHU,KESSES,88,15,20,35
UASIN GISHU,KESSES,89,34,77,111
UASIN GISHU,KESSES,85-89,143,223,366
UASIN GISHU,KESSES,90,17,40,57
UASIN GISHU,KESSES,91,20,24,44
UASIN GISHU,KESSES,92,15,21,36
UASIN GISHU,KESSES,93,10,9,19
UASIN GISHU,KESSES,94,11,19,30
UASIN GISHU,KESSES,90-94,73,113,186
UASIN GISHU,KESSES,95,23,25,48
UASIN GISHU,KESSES,96,1,9,10
UASIN GISHU,KESSES,97,9,7,16
UASIN GISHU,KESSES,98,5,5,10
UASIN GISHU,KESSES,99,5,18,23
UASIN GISHU,KESSES,95-99,43,64,107
UASIN GISHU,KESSES,100+,14,31,45
UASIN GISHU,KESSES,Not Stated,1,-,1
UASIN GISHU,MOIBEN,Total,90309,91027,181336
UASIN GISHU,MOIBEN,0,2198,2209,4407
UASIN GISHU,MOIBEN,1,2150,2256,4406
UASIN GISHU,MOIBEN,2,2108,2034,4142
UASIN GISHU,MOIBEN,3,2201,2225,4426
UASIN GISHU,MOIBEN,4,2278,2211,4489
UASIN GISHU,MOIBEN,0 - 4,10935,10935,21870
UASIN GISHU,MOIBEN,5,2028,1940,3968
UASIN GISHU,MOIBEN,6,2081,2074,4155
UASIN GISHU,MOIBEN,7,2048,2084,4132
UASIN GISHU,MOIBEN,8,1959,1879,3838
UASIN GISHU,MOIBEN,9,2233,2234,4467
UASIN GISHU,MOIBEN,05-Sep,10349,10211,20560
UASIN GISHU,MOIBEN,10,2162,2035,4197
UASIN GISHU,MOIBEN,11,2077,2121,4198
UASIN GISHU,MOIBEN,12,2178,2240,4418
UASIN GISHU,MOIBEN,13,2199,2280,4479
UASIN GISHU,MOIBEN,14,2080,2096,4176
UASIN GISHU,MOIBEN,Oct-14,10696,10772,21468
UASIN GISHU,MOIBEN,15,2095,2152,4247
UASIN GISHU,MOIBEN,16,2023,2043,4066
UASIN GISHU,MOIBEN,17,2164,2206,4370
UASIN GISHU,MOIBEN,18,1630,1760,3390
UASIN GISHU,MOIBEN,19,2129,2217,4346
UASIN GISHU,MOIBEN,15-19,10041,10378,20419
UASIN GISHU,MOIBEN,20,1881,2192,4073
UASIN GISHU,MOIBEN,21,1997,2205,4202
UASIN GISHU,MOIBEN,22,1944,2132,4076
UASIN GISHU,MOIBEN,23,2094,2430,4524
UASIN GISHU,MOIBEN,24,2089,2317,4406
UASIN GISHU,MOIBEN,20-24,10005,11276,21281
UASIN GISHU,MOIBEN,25,2192,2286,4478
UASIN GISHU,MOIBEN,26,1870,2000,3870
UASIN GISHU,MOIBEN,27,1808,1831,3639
UASIN GISHU,MOIBEN,28,1420,1516,2936
UASIN GISHU,MOIBEN,29,1656,1646,3302
UASIN GISHU,MOIBEN,25-29,8946,9279,18225
UASIN GISHU,MOIBEN,30,1981,1866,3847
UASIN GISHU,MOIBEN,31,1401,1319,2720
UASIN GISHU,MOIBEN,32,1744,1701,3445
UASIN GISHU,MOIBEN,33,1410,1487,2897
UASIN GISHU,MOIBEN,34,1231,1285,2516
UASIN GISHU,MOIBEN,30-34,7767,7658,15425
UASIN GISHU,MOIBEN,35,1693,1521,3214
UASIN GISHU,MOIBEN,36,1051,923,1974
UASIN GISHU,MOIBEN,37,1116,941,2057
UASIN GISHU,MOIBEN,38,770,649,1419
UASIN GISHU,MOIBEN,39,1004,848,1852
UASIN GISHU,MOIBEN,35-39,5634,4882,10516
UASIN GISHU,MOIBEN,40,1085,952,2037
UASIN GISHU,MOIBEN,41,1016,908,1924
UASIN GISHU,MOIBEN,42,968,860,1828
UASIN GISHU,MOIBEN,43,788,740,1528
UASIN GISHU,MOIBEN,44,595,551,1146
UASIN GISHU,MOIBEN,40-44,4452,4011,8463
UASIN GISHU,MOIBEN,45,1129,999,2128
UASIN GISHU,MOIBEN,46,709,664,1373
UASIN GISHU,MOIBEN,47,793,670,1463
UASIN GISHU,MOIBEN,48,479,460,939
UASIN GISHU,MOIBEN,49,593,550,1143
UASIN GISHU,MOIBEN,45-49,3703,3343,7046
UASIN GISHU,MOIBEN,50,629,571,1200
UASIN GISHU,MOIBEN,51,494,453,947
UASIN GISHU,MOIBEN,52,399,427,826
UASIN GISHU,MOIBEN,53,313,305,618
UASIN GISHU,MOIBEN,54,449,370,819
UASIN GISHU,MOIBEN,50-54,2284,2126,4410
UASIN GISHU,MOIBEN,55,375,320,695
UASIN GISHU,MOIBEN,56,341,357,698
UASIN GISHU,MOIBEN,57,371,435,806
UASIN GISHU,MOIBEN,58,376,424,800
UASIN GISHU,MOIBEN,59,400,332,732
UASIN GISHU,MOIBEN,55-59,1863,1868,3731
UASIN GISHU,MOIBEN,60,366,378,744
UASIN GISHU,MOIBEN,61,283,296,579
UASIN GISHU,MOIBEN,62,213,225,438
UASIN GISHU,MOIBEN,63,193,236,429
UASIN GISHU,MOIBEN,64,163,182,345
UASIN GISHU,MOIBEN,60-64,1218,1317,2535
UASIN GISHU,MOIBEN,65,251,258,509
UASIN GISHU,MOIBEN,66,137,150,287
UASIN GISHU,MOIBEN,67,243,276,519
UASIN GISHU,MOIBEN,68,114,102,216
UASIN GISHU,MOIBEN,69,161,205,366
UASIN GISHU,MOIBEN,65-69,906,991,1897
UASIN GISHU,MOIBEN,70,183,239,422
UASIN GISHU,MOIBEN,71,136,175,311
UASIN GISHU,MOIBEN,72,109,109,218
UASIN GISHU,MOIBEN,73,91,81,172
UASIN GISHU,MOIBEN,74,104,111,215
UASIN GISHU,MOIBEN,70-74,623,715,1338
UASIN GISHU,MOIBEN,75,82,135,217
UASIN GISHU,MOIBEN,76,99,102,201
UASIN GISHU,MOIBEN,77,84,84,168
UASIN GISHU,MOIBEN,78,38,53,91
UASIN GISHU,MOIBEN,79,72,137,209
UASIN GISHU,MOIBEN,75-79,375,511,886
UASIN GISHU,MOIBEN,80,87,129,216
UASIN GISHU,MOIBEN,81,37,74,111
UASIN GISHU,MOIBEN,82,49,35,84
UASIN GISHU,MOIBEN,83,44,52,96
UASIN GISHU,MOIBEN,84,41,69,110
UASIN GISHU,MOIBEN,80-84,258,359,617
UASIN GISHU,MOIBEN,85,40,66,106
UASIN GISHU,MOIBEN,86,15,33,48
UASIN GISHU,MOIBEN,87,37,27,64
UASIN GISHU,MOIBEN,88,12,13,25
UASIN GISHU,MOIBEN,89,29,71,100
UASIN GISHU,MOIBEN,85-89,133,210,343
UASIN GISHU,MOIBEN,90,21,41,62
UASIN GISHU,MOIBEN,91,14,18,32
UASIN GISHU,MOIBEN,92,11,7,18
UASIN GISHU,MOIBEN,93,13,13,26
UASIN GISHU,MOIBEN,94,7,14,21
UASIN GISHU,MOIBEN,90-94,66,93,159
UASIN GISHU,MOIBEN,95,18,29,47
UASIN GISHU,MOIBEN,96,1,8,9
UASIN GISHU,MOIBEN,97,10,5,15
UASIN GISHU,MOIBEN,98,5,2,7
UASIN GISHU,MOIBEN,99,9,14,23
UASIN GISHU,MOIBEN,95-99,43,58,101
UASIN GISHU,MOIBEN,100+,12,34,46
UASIN GISHU,MOIBEN,Not Stated,-,-,-
UASIN GISHU,SOY,Total,114082,115007,229089
UASIN GISHU,SOY,0,2759,2733,5492
UASIN GISHU,SOY,1,2701,2688,5389
UASIN GISHU,SOY,2,2847,2838,5685
UASIN GISHU,SOY,3,2985,3030,6015
UASIN GISHU,SOY,4,3074,2889,5963
UASIN GISHU,SOY,0 - 4,14366,14178,28544
UASIN GISHU,SOY,5,2904,2773,5677
UASIN GISHU,SOY,6,3013,3015,6028
UASIN GISHU,SOY,7,3000,2986,5986
UASIN GISHU,SOY,8,2884,2864,5748
UASIN GISHU,SOY,9,3293,3217,6510
UASIN GISHU,SOY,05-Sep,15094,14855,29949
UASIN GISHU,SOY,10,3278,3054,6332
UASIN GISHU,SOY,11,3123,3152,6275
UASIN GISHU,SOY,12,3403,3275,6678
UASIN GISHU,SOY,13,3299,3310,6609
UASIN GISHU,SOY,14,3227,3064,6291
UASIN GISHU,SOY,Oct-14,16330,15855,32185
UASIN GISHU,SOY,15,3141,3012,6153
UASIN GISHU,SOY,16,2967,2974,5941
UASIN GISHU,SOY,17,3122,2831,5953
UASIN GISHU,SOY,18,2422,2196,4618
UASIN GISHU,SOY,19,2898,2656,5554
UASIN GISHU,SOY,15-19,14550,13669,28219
UASIN GISHU,SOY,20,2376,2442,4818
UASIN GISHU,SOY,21,2303,2368,4671
UASIN GISHU,SOY,22,2078,2258,4336
UASIN GISHU,SOY,23,2102,2334,4436
UASIN GISHU,SOY,24,1943,2127,4070
UASIN GISHU,SOY,20-24,10802,11529,22331
UASIN GISHU,SOY,25,2137,2170,4307
UASIN GISHU,SOY,26,1663,1772,3435
UASIN GISHU,SOY,27,1779,1875,3654
UASIN GISHU,SOY,28,1331,1298,2629
UASIN GISHU,SOY,29,1556,1627,3183
UASIN GISHU,SOY,25-29,8466,8742,17208
UASIN GISHU,SOY,30,1645,1934,3579
UASIN GISHU,SOY,31,1401,1538,2939
UASIN GISHU,SOY,32,1730,1852,3582
UASIN GISHU,SOY,33,1448,1758,3206
UASIN GISHU,SOY,34,1391,1582,2973
UASIN GISHU,SOY,30-34,7615,8664,16279
UASIN GISHU,SOY,35,1702,1740,3442
UASIN GISHU,SOY,36,1189,1131,2320
UASIN GISHU,SOY,37,1231,1098,2329
UASIN GISHU,SOY,38,892,772,1664
UASIN GISHU,SOY,39,1123,1033,2156
UASIN GISHU,SOY,35-39,6137,5774,11911
UASIN GISHU,SOY,40,1150,1115,2265
UASIN GISHU,SOY,41,1253,1160,2413
UASIN GISHU,SOY,42,1169,1114,2283
UASIN GISHU,SOY,43,970,1054,2024
UASIN GISHU,SOY,44,789,771,1560
UASIN GISHU,SOY,40-44,5331,5214,10545
UASIN GISHU,SOY,45,1306,1216,2522
UASIN GISHU,SOY,46,904,956,1860
UASIN GISHU,SOY,47,878,930,1808
UASIN GISHU,SOY,48,580,592,1172
UASIN GISHU,SOY,49,735,825,1560
UASIN GISHU,SOY,45-49,4403,4519,8922
UASIN GISHU,SOY,50,742,735,1477
UASIN GISHU,SOY,51,631,666,1297
UASIN GISHU,SOY,52,570,562,1132
UASIN GISHU,SOY,53,453,479,932
UASIN GISHU,SOY,54,471,503,974
UASIN GISHU,SOY,50-54,2867,2945,5812
UASIN GISHU,SOY,55,509,426,935
UASIN GISHU,SOY,56,439,464,903
UASIN GISHU,SOY,57,493,696,1189
UASIN GISHU,SOY,58,502,560,1062
UASIN GISHU,SOY,59,537,501,1038
UASIN GISHU,SOY,55-59,2480,2647,5127
UASIN GISHU,SOY,60,496,527,1023
UASIN GISHU,SOY,61,405,420,825
UASIN GISHU,SOY,62,330,359,689
UASIN GISHU,SOY,63,357,395,752
UASIN GISHU,SOY,64,256,277,533
UASIN GISHU,SOY,60-64,1844,1978,3822
UASIN GISHU,SOY,65,356,428,784
UASIN GISHU,SOY,66,207,254,461
UASIN GISHU,SOY,67,401,440,841
UASIN GISHU,SOY,68,143,162,305
UASIN GISHU,SOY,69,280,270,550
UASIN GISHU,SOY,65-69,1387,1554,2941
UASIN GISHU,SOY,70,277,318,595
UASIN GISHU,SOY,71,255,245,500
UASIN GISHU,SOY,72,163,178,341
UASIN GISHU,SOY,73,174,151,325
UASIN GISHU,SOY,74,135,165,300
UASIN GISHU,SOY,70-74,1004,1057,2061
UASIN GISHU,SOY,75,159,193,352
UASIN GISHU,SOY,76,156,221,377
UASIN GISHU,SOY,77,128,152,280
UASIN GISHU,SOY,78,75,74,149
UASIN GISHU,SOY,79,112,144,256
UASIN GISHU,SOY,75-79,630,784,1414
UASIN GISHU,SOY,80,114,158,272
UASIN GISHU,SOY,81,56,80,136
UASIN GISHU,SOY,82,49,56,105
UASIN GISHU,SOY,83,79,76,155
UASIN GISHU,SOY,84,69,84,153
UASIN GISHU,SOY,80-84,367,454,821
UASIN GISHU,SOY,85,62,78,140
UASIN GISHU,SOY,86,39,60,99
UASIN GISHU,SOY,87,34,62,96
UASIN GISHU,SOY,88,40,25,65
UASIN GISHU,SOY,89,44,92,136
UASIN GISHU,SOY,85-89,219,317,536
UASIN GISHU,SOY,90,24,45,69
UASIN GISHU,SOY,91,20,27,47
UASIN GISHU,SOY,92,18,17,35
UASIN GISHU,SOY,93,25,13,38
UASIN GISHU,SOY,94,9,31,40
UASIN GISHU,SOY,90-94,96,133,229
UASIN GISHU,SOY,95,36,35,71
UASIN GISHU,SOY,96,14,15,29
UASIN GISHU,SOY,97,10,20,30
UASIN GISHU,SOY,98,4,6,10
UASIN GISHU,SOY,99,11,18,29
UASIN GISHU,SOY,95-99,75,94,169
UASIN GISHU,SOY,100+,15,45,60
UASIN GISHU,SOY,Not Stated,4,-,4
UASIN GISHU,TURBO,Total,133579,133682,267261
UASIN GISHU,TURBO,0,2994,3024,6018
UASIN GISHU,TURBO,1,3305,3315,6620
UASIN GISHU,TURBO,2,3221,3213,6434
UASIN GISHU,TURBO,3,3242,3409,6651
UASIN GISHU,TURBO,4,3353,3244,6597
UASIN GISHU,TURBO,0 - 4,16115,16205,32320
UASIN GISHU,TURBO,5,3351,3108,6459
UASIN GISHU,TURBO,6,3271,3250,6521
UASIN GISHU,TURBO,7,3325,3234,6559
UASIN GISHU,TURBO,8,3152,3024,6176
UASIN GISHU,TURBO,9,3310,3357,6667
UASIN GISHU,TURBO,05-Sep,16409,15973,32382
UASIN GISHU,TURBO,10,3366,3398,6764
UASIN GISHU,TURBO,11,2977,3282,6259
UASIN GISHU,TURBO,12,3431,3424,6855
UASIN GISHU,TURBO,13,3302,3557,6859
UASIN GISHU,TURBO,14,3130,3161,6291
UASIN GISHU,TURBO,Oct-14,16206,16822,33028
UASIN GISHU,TURBO,15,2983,3077,6060
UASIN GISHU,TURBO,16,2908,3024,5932
UASIN GISHU,TURBO,17,3040,3107,6147
UASIN GISHU,TURBO,18,2436,2527,4963
UASIN GISHU,TURBO,19,2964,3028,5992
UASIN GISHU,TURBO,15-19,14331,14763,29094
UASIN GISHU,TURBO,20,2703,2984,5687
UASIN GISHU,TURBO,21,2891,2921,5812
UASIN GISHU,TURBO,22,2921,3122,6043
UASIN GISHU,TURBO,23,3181,3268,6449
UASIN GISHU,TURBO,24,3034,2922,5956
UASIN GISHU,TURBO,20-24,14730,15217,29947
UASIN GISHU,TURBO,25,3197,3126,6323
UASIN GISHU,TURBO,26,2721,2800,5521
UASIN GISHU,TURBO,27,2562,2666,5228
UASIN GISHU,TURBO,28,1999,2206,4205
UASIN GISHU,TURBO,29,2155,2410,4565
UASIN GISHU,TURBO,25-29,12634,13208,25842
UASIN GISHU,TURBO,30,2534,2844,5378
UASIN GISHU,TURBO,31,1842,1996,3838
UASIN GISHU,TURBO,32,2529,2626,5155
UASIN GISHU,TURBO,33,1945,2116,4061
UASIN GISHU,TURBO,34,1882,1902,3784
UASIN GISHU,TURBO,30-34,10732,11484,22216
UASIN GISHU,TURBO,35,2365,2211,4576
UASIN GISHU,TURBO,36,1695,1573,3268
UASIN GISHU,TURBO,37,1750,1529,3279
UASIN GISHU,TURBO,38,1252,1224,2476
UASIN GISHU,TURBO,39,1426,1297,2723
UASIN GISHU,TURBO,35-39,8488,7834,16322
UASIN GISHU,TURBO,40,1715,1486,3201
UASIN GISHU,TURBO,41,1590,1389,2979
UASIN GISHU,TURBO,42,1520,1309,2829
UASIN GISHU,TURBO,43,1197,1188,2385
UASIN GISHU,TURBO,44,1043,905,1948
UASIN GISHU,TURBO,40-44,7065,6277,13342
UASIN GISHU,TURBO,45,1607,1332,2939
UASIN GISHU,TURBO,46,1088,964,2052
UASIN GISHU,TURBO,47,1145,1017,2162
UASIN GISHU,TURBO,48,749,647,1396
UASIN GISHU,TURBO,49,945,762,1707
UASIN GISHU,TURBO,45-49,5534,4722,10256
UASIN GISHU,TURBO,50,943,856,1799
UASIN GISHU,TURBO,51,772,648,1420
UASIN GISHU,TURBO,52,671,588,1259
UASIN GISHU,TURBO,53,591,456,1047
UASIN GISHU,TURBO,54,588,513,1101
UASIN GISHU,TURBO,50-54,3565,3061,6626
UASIN GISHU,TURBO,55,598,483,1081
UASIN GISHU,TURBO,56,563,608,1171
UASIN GISHU,TURBO,57,554,640,1194
UASIN GISHU,TURBO,58,472,525,997
UASIN GISHU,TURBO,59,566,506,1072
UASIN GISHU,TURBO,55-59,2753,2762,5515
UASIN GISHU,TURBO,60,505,480,985
UASIN GISHU,TURBO,61,394,416,810
UASIN GISHU,TURBO,62,335,302,637
UASIN GISHU,TURBO,63,346,320,666
UASIN GISHU,TURBO,64,248,226,474
UASIN GISHU,TURBO,60-64,1828,1744,3572
UASIN GISHU,TURBO,65,399,366,765
UASIN GISHU,TURBO,66,203,254,457
UASIN GISHU,TURBO,67,309,364,673
UASIN GISHU,TURBO,68,159,155,314
UASIN GISHU,TURBO,69,232,237,469
UASIN GISHU,TURBO,65-69,1302,1376,2678
UASIN GISHU,TURBO,70,260,250,510
UASIN GISHU,TURBO,71,206,200,406
UASIN GISHU,TURBO,72,147,139,286
UASIN GISHU,TURBO,73,128,122,250
UASIN GISHU,TURBO,74,127,139,266
UASIN GISHU,TURBO,70-74,868,850,1718
UASIN GISHU,TURBO,75,102,144,246
UASIN GISHU,TURBO,76,135,166,301
UASIN GISHU,TURBO,77,108,115,223
UASIN GISHU,TURBO,78,53,53,106
UASIN GISHU,TURBO,79,72,113,185
UASIN GISHU,TURBO,75-79,470,591,1061
UASIN GISHU,TURBO,80,84,101,185
UASIN GISHU,TURBO,81,58,64,122
UASIN GISHU,TURBO,82,50,54,104
UASIN GISHU,TURBO,83,49,58,107
UASIN GISHU,TURBO,84,44,73,117
UASIN GISHU,TURBO,80-84,285,350,635
UASIN GISHU,TURBO,85,28,54,82
UASIN GISHU,TURBO,86,37,40,77
UASIN GISHU,TURBO,87,38,35,73
UASIN GISHU,TURBO,88,15,18,33
UASIN GISHU,TURBO,89,28,65,93
UASIN GISHU,TURBO,85-89,146,212,358
UASIN GISHU,TURBO,90,13,42,55
UASIN GISHU,TURBO,91,7,13,20
UASIN GISHU,TURBO,92,12,11,23
UASIN GISHU,TURBO,93,13,13,26
UASIN GISHU,TURBO,94,8,14,22
UASIN GISHU,TURBO,90-94,53,93,146
UASIN GISHU,TURBO,95,21,36,57
UASIN GISHU,TURBO,96,6,8,14
UASIN GISHU,TURBO,97,9,14,23
UASIN GISHU,TURBO,98,6,6,12
UASIN GISHU,TURBO,99,5,21,26
UASIN GISHU,TURBO,95-99,47,85,132
UASIN GISHU,TURBO,100+,16,53,69
UASIN GISHU,TURBO,Not Stated,2,-,2
VIHIGA,ALL,Total,283678,306323,590001
VIHIGA,ALL,0,5909,6233,12142
VIHIGA,ALL,1,6106,6266,12372
VIHIGA,ALL,2,6310,6372,12682
VIHIGA,ALL,3,6810,6772,13582
VIHIGA,ALL,4,6920,6940,13860
VIHIGA,ALL,0 - 4,32055,32583,64638
VIHIGA,ALL,5,7275,6943,14218
VIHIGA,ALL,6,7468,7629,15097
VIHIGA,ALL,7,7893,8111,16004
VIHIGA,ALL,8,7687,7908,15595
VIHIGA,ALL,9,8544,8666,17210
VIHIGA,ALL,05-Sep,38867,39257,78124
VIHIGA,ALL,10,8719,8484,17203
VIHIGA,ALL,11,8327,8719,17046
VIHIGA,ALL,12,9233,9136,18369
VIHIGA,ALL,13,8960,9240,18200
VIHIGA,ALL,14,8442,8399,16841
VIHIGA,ALL,Oct-14,43681,43978,87659
VIHIGA,ALL,15,8219,8180,16399
VIHIGA,ALL,16,8025,8077,16102
VIHIGA,ALL,17,8141,7776,15917
VIHIGA,ALL,18,6585,6323,12908
VIHIGA,ALL,19,6489,6105,12594
VIHIGA,ALL,15-19,37459,36461,73920
VIHIGA,ALL,20,5416,5508,10924
VIHIGA,ALL,21,4347,4389,8736
VIHIGA,ALL,22,4042,4230,8272
VIHIGA,ALL,23,3759,4270,8029
VIHIGA,ALL,24,3321,3797,7118
VIHIGA,ALL,20-24,20885,22194,43079
VIHIGA,ALL,25,3270,3951,7221
VIHIGA,ALL,26,2872,3616,6488
VIHIGA,ALL,27,3049,3705,6754
VIHIGA,ALL,28,2680,3205,5885
VIHIGA,ALL,29,2786,3382,6168
VIHIGA,ALL,25-29,14657,17859,32516
VIHIGA,ALL,30,3544,4476,8020
VIHIGA,ALL,31,2583,3313,5896
VIHIGA,ALL,32,3316,4165,7481
VIHIGA,ALL,33,2771,3388,6159
VIHIGA,ALL,34,2718,3143,5861
VIHIGA,ALL,30-34,14932,18485,33417
VIHIGA,ALL,35,3304,3669,6973
VIHIGA,ALL,36,2550,2893,5443
VIHIGA,ALL,37,2791,2907,5698
VIHIGA,ALL,38,2194,2365,4559
VIHIGA,ALL,39,2467,2637,5104
VIHIGA,ALL,35-39,13306,14471,27777
VIHIGA,ALL,40,2848,3112,5960
VIHIGA,ALL,41,2558,2824,5382
VIHIGA,ALL,42,2653,3050,5703
VIHIGA,ALL,43,2359,2694,5053
VIHIGA,ALL,44,1958,2036,3994
VIHIGA,ALL,40-44,12376,13716,26092
VIHIGA,ALL,45,2577,2732,5309
VIHIGA,ALL,46,2149,2262,4411
VIHIGA,ALL,47,2328,2546,4874
VIHIGA,ALL,48,1711,1779,3490
VIHIGA,ALL,49,1843,2089,3932
VIHIGA,ALL,45-49,10608,11408,22016
VIHIGA,ALL,50,2208,2716,4924
VIHIGA,ALL,51,1838,2274,4112
VIHIGA,ALL,52,1712,1977,3689
VIHIGA,ALL,53,1439,1786,3225
VIHIGA,ALL,54,1644,1970,3614
VIHIGA,ALL,50-54,8841,10723,19564
VIHIGA,ALL,55,1791,2048,3839
VIHIGA,ALL,56,1687,2113,3800
VIHIGA,ALL,57,1711,2547,4258
VIHIGA,ALL,58,1353,1740,3093
VIHIGA,ALL,59,1760,2152,3912
VIHIGA,ALL,55-59,8302,10600,18902
VIHIGA,ALL,60,1845,2452,4297
VIHIGA,ALL,61,1750,1919,3669
VIHIGA,ALL,62,1599,1804,3403
VIHIGA,ALL,63,1588,1958,3546
VIHIGA,ALL,64,1413,1665,3078
VIHIGA,ALL,60-64,8195,9798,17993
VIHIGA,ALL,65,1779,2127,3906
VIHIGA,ALL,66,1250,1481,2731
VIHIGA,ALL,67,1702,2021,3723
VIHIGA,ALL,68,876,1021,1897
VIHIGA,ALL,69,1352,1487,2839
VIHIGA,ALL,65-69,6959,8137,15096
VIHIGA,ALL,70,1588,1914,3502
VIHIGA,ALL,71,1179,1133,2312
VIHIGA,ALL,72,1075,1151,2226
VIHIGA,ALL,73,898,1012,1910
VIHIGA,ALL,74,842,970,1812
VIHIGA,ALL,70-74,5582,6180,11762
VIHIGA,ALL,75,605,914,1519
VIHIGA,ALL,76,746,1253,1999
VIHIGA,ALL,77,678,871,1549
VIHIGA,ALL,78,442,488,930
VIHIGA,ALL,79,556,771,1327
VIHIGA,ALL,75-79,3027,4297,7324
VIHIGA,ALL,80,523,915,1438
VIHIGA,ALL,81,426,619,1045
VIHIGA,ALL,82,412,546,958
VIHIGA,ALL,83,396,614,1010
VIHIGA,ALL,84,345,483,828
VIHIGA,ALL,80-84,2102,3177,5279
VIHIGA,ALL,85,271,483,754
VIHIGA,ALL,86,250,416,666
VIHIGA,ALL,87,285,450,735
VIHIGA,ALL,88,164,194,358
VIHIGA,ALL,89,188,366,554
VIHIGA,ALL,85-89,1158,1909,3067
VIHIGA,ALL,90,137,165,302
VIHIGA,ALL,91,124,185,309
VIHIGA,ALL,92,86,125,211
VIHIGA,ALL,93,69,87,156
VIHIGA,ALL,94,48,80,128
VIHIGA,ALL,90-94,464,642,1106
VIHIGA,ALL,95,57,127,184
VIHIGA,ALL,96,32,65,97
VIHIGA,ALL,97,43,75,118
VIHIGA,ALL,98,19,25,44
VIHIGA,ALL,99,18,55,73
VIHIGA,ALL,95-99,169,347,516
VIHIGA,ALL,100+,47,98,145
VIHIGA,ALL,Not Stated,6,3,9
VIHIGA,EMUHAYA,Total,46507,50633,97140
VIHIGA,EMUHAYA,0,1020,1013,2033
VIHIGA,EMUHAYA,1,1010,1049,2059
VIHIGA,EMUHAYA,2,1039,1098,2137
VIHIGA,EMUHAYA,3,1180,1160,2340
VIHIGA,EMUHAYA,4,1172,1176,2348
VIHIGA,EMUHAYA,0 - 4,5421,5496,10917
VIHIGA,EMUHAYA,5,1309,1162,2471
VIHIGA,EMUHAYA,6,1327,1323,2650
VIHIGA,EMUHAYA,7,1336,1452,2788
VIHIGA,EMUHAYA,8,1335,1377,2712
VIHIGA,EMUHAYA,9,1396,1421,2817
VIHIGA,EMUHAYA,05-Sep,6703,6735,13438
VIHIGA,EMUHAYA,10,1507,1489,2996
VIHIGA,EMUHAYA,11,1483,1419,2902
VIHIGA,EMUHAYA,12,1597,1590,3187
VIHIGA,EMUHAYA,13,1486,1620,3106
VIHIGA,EMUHAYA,14,1369,1420,2789
VIHIGA,EMUHAYA,Oct-14,7442,7538,14980
VIHIGA,EMUHAYA,15,1430,1332,2762
VIHIGA,EMUHAYA,16,1293,1296,2589
VIHIGA,EMUHAYA,17,1311,1246,2557
VIHIGA,EMUHAYA,18,1031,1051,2082
VIHIGA,EMUHAYA,19,1083,988,2071
VIHIGA,EMUHAYA,15-19,6148,5913,12061
VIHIGA,EMUHAYA,20,814,908,1722
VIHIGA,EMUHAYA,21,679,735,1414
VIHIGA,EMUHAYA,22,632,667,1299
VIHIGA,EMUHAYA,23,515,676,1191
VIHIGA,EMUHAYA,24,483,611,1094
VIHIGA,EMUHAYA,20-24,3123,3597,6720
VIHIGA,EMUHAYA,25,481,655,1136
VIHIGA,EMUHAYA,26,449,581,1030
VIHIGA,EMUHAYA,27,486,603,1089
VIHIGA,EMUHAYA,28,440,519,959
VIHIGA,EMUHAYA,29,403,520,923
VIHIGA,EMUHAYA,25-29,2259,2878,5137
VIHIGA,EMUHAYA,30,553,706,1259
VIHIGA,EMUHAYA,31,388,525,913
VIHIGA,EMUHAYA,32,550,660,1210
VIHIGA,EMUHAYA,33,427,537,964
VIHIGA,EMUHAYA,34,440,473,913
VIHIGA,EMUHAYA,30-34,2358,2901,5259
VIHIGA,EMUHAYA,35,491,564,1055
VIHIGA,EMUHAYA,36,380,400,780
VIHIGA,EMUHAYA,37,392,464,856
VIHIGA,EMUHAYA,38,321,349,670
VIHIGA,EMUHAYA,39,389,393,782
VIHIGA,EMUHAYA,35-39,1973,2170,4143
VIHIGA,EMUHAYA,40,443,501,944
VIHIGA,EMUHAYA,41,386,467,853
VIHIGA,EMUHAYA,42,377,469,846
VIHIGA,EMUHAYA,43,311,416,727
VIHIGA,EMUHAYA,44,306,298,604
VIHIGA,EMUHAYA,40-44,1823,2151,3974
VIHIGA,EMUHAYA,45,384,457,841
VIHIGA,EMUHAYA,46,345,361,706
VIHIGA,EMUHAYA,47,401,416,817
VIHIGA,EMUHAYA,48,254,277,531
VIHIGA,EMUHAYA,49,274,376,650
VIHIGA,EMUHAYA,45-49,1658,1887,3545
VIHIGA,EMUHAYA,50,380,493,873
VIHIGA,EMUHAYA,51,305,376,681
VIHIGA,EMUHAYA,52,289,302,591
VIHIGA,EMUHAYA,53,248,325,573
VIHIGA,EMUHAYA,54,272,312,584
VIHIGA,EMUHAYA,50-54,1494,1808,3302
VIHIGA,EMUHAYA,55,300,330,630
VIHIGA,EMUHAYA,56,305,361,666
VIHIGA,EMUHAYA,57,318,489,807
VIHIGA,EMUHAYA,58,205,278,483
VIHIGA,EMUHAYA,59,290,332,622
VIHIGA,EMUHAYA,55-59,1418,1790,3208
VIHIGA,EMUHAYA,60,314,442,756
VIHIGA,EMUHAYA,61,262,311,573
VIHIGA,EMUHAYA,62,294,295,589
VIHIGA,EMUHAYA,63,268,296,564
VIHIGA,EMUHAYA,64,272,272,544
VIHIGA,EMUHAYA,60-64,1410,1616,3026
VIHIGA,EMUHAYA,65,310,358,668
VIHIGA,EMUHAYA,66,220,252,472
VIHIGA,EMUHAYA,67,299,377,676
VIHIGA,EMUHAYA,68,144,179,323
VIHIGA,EMUHAYA,69,223,227,450
VIHIGA,EMUHAYA,65-69,1196,1393,2589
VIHIGA,EMUHAYA,70,313,365,678
VIHIGA,EMUHAYA,71,210,181,391
VIHIGA,EMUHAYA,72,171,168,339
VIHIGA,EMUHAYA,73,125,146,271
VIHIGA,EMUHAYA,74,116,153,269
VIHIGA,EMUHAYA,70-74,935,1013,1948
VIHIGA,EMUHAYA,75,107,179,286
VIHIGA,EMUHAYA,76,139,230,369
VIHIGA,EMUHAYA,77,97,159,256
VIHIGA,EMUHAYA,78,77,79,156
VIHIGA,EMUHAYA,79,82,131,213
VIHIGA,EMUHAYA,75-79,502,778,1280
VIHIGA,EMUHAYA,80,84,180,264
VIHIGA,EMUHAYA,81,66,99,165
VIHIGA,EMUHAYA,82,68,107,175
VIHIGA,EMUHAYA,83,58,79,137
VIHIGA,EMUHAYA,84,74,75,149
VIHIGA,EMUHAYA,80-84,350,540,890
VIHIGA,EMUHAYA,85,47,76,123
VIHIGA,EMUHAYA,86,37,77,114
VIHIGA,EMUHAYA,87,47,58,105
VIHIGA,EMUHAYA,88,28,25,53
VIHIGA,EMUHAYA,89,30,47,77
VIHIGA,EMUHAYA,85-89,189,283,472
VIHIGA,EMUHAYA,90,28,28,56
VIHIGA,EMUHAYA,91,20,21,41
VIHIGA,EMUHAYA,92,9,17,26
VIHIGA,EMUHAYA,93,7,8,15
VIHIGA,EMUHAYA,94,7,8,15
VIHIGA,EMUHAYA,90-94,71,82,153
VIHIGA,EMUHAYA,95,11,17,28
VIHIGA,EMUHAYA,96,6,8,14
VIHIGA,EMUHAYA,97,5,9,14
VIHIGA,EMUHAYA,98,3,2,5
VIHIGA,EMUHAYA,99,4,13,17
VIHIGA,EMUHAYA,95-99,29,49,78
VIHIGA,EMUHAYA,100+,4,15,19
VIHIGA,EMUHAYA,Not Stated,1,-,1
VIHIGA,VIHIGA,Total,45788,49501,95289
VIHIGA,VIHIGA,0,918,1028,1946
VIHIGA,VIHIGA,1,1027,967,1994
VIHIGA,VIHIGA,2,975,968,1943
VIHIGA,VIHIGA,3,1069,1042,2111
VIHIGA,VIHIGA,4,1087,1096,2183
VIHIGA,VIHIGA,0 - 4,5076,5101,10177
VIHIGA,VIHIGA,5,1165,1082,2247
VIHIGA,VIHIGA,6,1207,1210,2417
VIHIGA,VIHIGA,7,1209,1229,2438
VIHIGA,VIHIGA,8,1246,1209,2455
VIHIGA,VIHIGA,9,1357,1403,2760
VIHIGA,VIHIGA,05-Sep,6184,6133,12317
VIHIGA,VIHIGA,10,1343,1353,2696
VIHIGA,VIHIGA,11,1291,1353,2644
VIHIGA,VIHIGA,12,1434,1385,2819
VIHIGA,VIHIGA,13,1411,1465,2876
VIHIGA,VIHIGA,14,1323,1297,2620
VIHIGA,VIHIGA,Oct-14,6802,6853,13655
VIHIGA,VIHIGA,15,1327,1315,2642
VIHIGA,VIHIGA,16,1199,1283,2482
VIHIGA,VIHIGA,17,1323,1290,2613
VIHIGA,VIHIGA,18,1024,1007,2031
VIHIGA,VIHIGA,19,1008,975,1983
VIHIGA,VIHIGA,15-19,5881,5870,11751
VIHIGA,VIHIGA,20,938,842,1780
VIHIGA,VIHIGA,21,736,723,1459
VIHIGA,VIHIGA,22,683,682,1365
VIHIGA,VIHIGA,23,662,709,1371
VIHIGA,VIHIGA,24,532,622,1154
VIHIGA,VIHIGA,20-24,3551,3578,7129
VIHIGA,VIHIGA,25,528,641,1169
VIHIGA,VIHIGA,26,518,602,1120
VIHIGA,VIHIGA,27,483,623,1106
VIHIGA,VIHIGA,28,408,532,940
VIHIGA,VIHIGA,29,491,595,1086
VIHIGA,VIHIGA,25-29,2428,2993,5421
VIHIGA,VIHIGA,30,569,706,1275
VIHIGA,VIHIGA,31,432,571,1003
VIHIGA,VIHIGA,32,547,702,1249
VIHIGA,VIHIGA,33,412,587,999
VIHIGA,VIHIGA,34,435,522,957
VIHIGA,VIHIGA,30-34,2395,3088,5483
VIHIGA,VIHIGA,35,572,613,1185
VIHIGA,VIHIGA,36,414,507,921
VIHIGA,VIHIGA,37,488,478,966
VIHIGA,VIHIGA,38,380,431,811
VIHIGA,VIHIGA,39,421,503,924
VIHIGA,VIHIGA,35-39,2275,2532,4807
VIHIGA,VIHIGA,40,465,548,1013
VIHIGA,VIHIGA,41,410,477,887
VIHIGA,VIHIGA,42,406,488,894
VIHIGA,VIHIGA,43,402,430,832
VIHIGA,VIHIGA,44,311,352,663
VIHIGA,VIHIGA,40-44,1994,2295,4289
VIHIGA,VIHIGA,45,471,456,927
VIHIGA,VIHIGA,46,361,360,721
VIHIGA,VIHIGA,47,373,429,802
VIHIGA,VIHIGA,48,310,307,617
VIHIGA,VIHIGA,49,325,316,641
VIHIGA,VIHIGA,45-49,1840,1868,3708
VIHIGA,VIHIGA,50,392,468,860
VIHIGA,VIHIGA,51,287,397,684
VIHIGA,VIHIGA,52,266,330,596
VIHIGA,VIHIGA,53,226,292,518
VIHIGA,VIHIGA,54,274,341,615
VIHIGA,VIHIGA,50-54,1445,1828,3273
VIHIGA,VIHIGA,55,277,338,615
VIHIGA,VIHIGA,56,272,360,632
VIHIGA,VIHIGA,57,272,376,648
VIHIGA,VIHIGA,58,221,294,515
VIHIGA,VIHIGA,59,295,356,651
VIHIGA,VIHIGA,55-59,1337,1724,3061
VIHIGA,VIHIGA,60,306,388,694
VIHIGA,VIHIGA,61,279,268,547
VIHIGA,VIHIGA,62,267,298,565
VIHIGA,VIHIGA,63,260,342,602
VIHIGA,VIHIGA,64,232,255,487
VIHIGA,VIHIGA,60-64,1344,1551,2895
VIHIGA,VIHIGA,65,303,339,642
VIHIGA,VIHIGA,66,202,226,428
VIHIGA,VIHIGA,67,264,327,591
VIHIGA,VIHIGA,68,152,159,311
VIHIGA,VIHIGA,69,231,264,495
VIHIGA,VIHIGA,65-69,1152,1315,2467
VIHIGA,VIHIGA,70,261,314,575
VIHIGA,VIHIGA,71,193,192,385
VIHIGA,VIHIGA,72,187,181,368
VIHIGA,VIHIGA,73,155,189,344
VIHIGA,VIHIGA,74,139,133,272
VIHIGA,VIHIGA,70-74,935,1009,1944
VIHIGA,VIHIGA,75,97,138,235
VIHIGA,VIHIGA,76,105,207,312
VIHIGA,VIHIGA,77,115,139,254
VIHIGA,VIHIGA,78,74,77,151
VIHIGA,VIHIGA,79,82,124,206
VIHIGA,VIHIGA,75-79,473,685,1158
VIHIGA,VIHIGA,80,85,148,233
VIHIGA,VIHIGA,81,67,118,185
VIHIGA,VIHIGA,82,64,78,142
VIHIGA,VIHIGA,83,69,115,184
VIHIGA,VIHIGA,84,62,85,147
VIHIGA,VIHIGA,80-84,347,544,891
VIHIGA,VIHIGA,85,56,90,146
VIHIGA,VIHIGA,86,55,67,122
VIHIGA,VIHIGA,87,46,72,118
VIHIGA,VIHIGA,88,18,42,60
VIHIGA,VIHIGA,89,31,59,90
VIHIGA,VIHIGA,85-89,206,330,536
VIHIGA,VIHIGA,90,26,29,55
VIHIGA,VIHIGA,91,28,33,61
VIHIGA,VIHIGA,92,14,28,42
VIHIGA,VIHIGA,93,18,20,38
VIHIGA,VIHIGA,94,5,20,25
VIHIGA,VIHIGA,90-94,91,130,221
VIHIGA,VIHIGA,95,8,19,27
VIHIGA,VIHIGA,96,5,10,15
VIHIGA,VIHIGA,97,4,19,23
VIHIGA,VIHIGA,98,1,5,6
VIHIGA,VIHIGA,99,3,6,9
VIHIGA,VIHIGA,95-99,21,59,80
VIHIGA,VIHIGA,100+,9,15,24
VIHIGA,VIHIGA,Not Stated,2,-,2
VIHIGA,SABATIA,Total,62944,68683,131627
VIHIGA,SABATIA,0,1307,1355,2662
VIHIGA,SABATIA,1,1294,1365,2659
VIHIGA,SABATIA,2,1410,1420,2830
VIHIGA,SABATIA,3,1454,1445,2899
VIHIGA,SABATIA,4,1482,1560,3042
VIHIGA,SABATIA,0 - 4,6947,7145,14092
VIHIGA,SABATIA,5,1623,1559,3182
VIHIGA,SABATIA,6,1570,1662,3232
VIHIGA,SABATIA,7,1739,1793,3532
VIHIGA,SABATIA,8,1642,1711,3353
VIHIGA,SABATIA,9,1851,1926,3777
VIHIGA,SABATIA,05-Sep,8425,8651,17076
VIHIGA,SABATIA,10,1862,1805,3667
VIHIGA,SABATIA,11,1845,2009,3854
VIHIGA,SABATIA,12,1951,2000,3951
VIHIGA,SABATIA,13,2002,2045,4047
VIHIGA,SABATIA,14,1773,1874,3647
VIHIGA,SABATIA,Oct-14,9433,9733,19166
VIHIGA,SABATIA,15,1801,1845,3646
VIHIGA,SABATIA,16,1764,1790,3554
VIHIGA,SABATIA,17,1900,1744,3644
VIHIGA,SABATIA,18,1543,1463,3006
VIHIGA,SABATIA,19,1506,1356,2862
VIHIGA,SABATIA,15-19,8514,8198,16712
VIHIGA,SABATIA,20,1239,1215,2454
VIHIGA,SABATIA,21,960,981,1941
VIHIGA,SABATIA,22,959,927,1886
VIHIGA,SABATIA,23,823,966,1789
VIHIGA,SABATIA,24,771,851,1622
VIHIGA,SABATIA,20-24,4752,4940,9692
VIHIGA,SABATIA,25,755,847,1602
VIHIGA,SABATIA,26,619,790,1409
VIHIGA,SABATIA,27,681,799,1480
VIHIGA,SABATIA,28,614,695,1309
VIHIGA,SABATIA,29,602,768,1370
VIHIGA,SABATIA,25-29,3271,3899,7170
VIHIGA,SABATIA,30,785,1023,1808
VIHIGA,SABATIA,31,551,715,1266
VIHIGA,SABATIA,32,704,920,1624
VIHIGA,SABATIA,33,662,719,1381
VIHIGA,SABATIA,34,628,715,1343
VIHIGA,SABATIA,30-34,3330,4092,7422
VIHIGA,SABATIA,35,723,849,1572
VIHIGA,SABATIA,36,567,693,1260
VIHIGA,SABATIA,37,627,686,1313
VIHIGA,SABATIA,38,514,576,1090
VIHIGA,SABATIA,39,579,622,1201
VIHIGA,SABATIA,35-39,3010,3426,6436
VIHIGA,SABATIA,40,669,712,1381
VIHIGA,SABATIA,41,573,629,1202
VIHIGA,SABATIA,42,604,696,1300
VIHIGA,SABATIA,43,541,592,1133
VIHIGA,SABATIA,44,438,474,912
VIHIGA,SABATIA,40-44,2825,3103,5928
VIHIGA,SABATIA,45,595,650,1245
VIHIGA,SABATIA,46,485,531,1016
VIHIGA,SABATIA,47,543,585,1128
VIHIGA,SABATIA,48,378,386,764
VIHIGA,SABATIA,49,434,485,919
VIHIGA,SABATIA,45-49,2435,2637,5072
VIHIGA,SABATIA,50,463,599,1062
VIHIGA,SABATIA,51,412,491,903
VIHIGA,SABATIA,52,396,437,833
VIHIGA,SABATIA,53,327,386,713
VIHIGA,SABATIA,54,400,468,868
VIHIGA,SABATIA,50-54,1998,2381,4379
VIHIGA,SABATIA,55,358,465,823
VIHIGA,SABATIA,56,374,495,869
VIHIGA,SABATIA,57,362,578,940
VIHIGA,SABATIA,58,283,388,671
VIHIGA,SABATIA,59,390,501,891
VIHIGA,SABATIA,55-59,1767,2427,4194
VIHIGA,SABATIA,60,374,556,930
VIHIGA,SABATIA,61,356,436,792
VIHIGA,SABATIA,62,352,431,783
VIHIGA,SABATIA,63,328,438,766
VIHIGA,SABATIA,64,297,429,726
VIHIGA,SABATIA,60-64,1707,2290,3997
VIHIGA,SABATIA,65,389,493,882
VIHIGA,SABATIA,66,271,341,612
VIHIGA,SABATIA,67,377,460,837
VIHIGA,SABATIA,68,234,248,482
VIHIGA,SABATIA,69,316,330,646
VIHIGA,SABATIA,65-69,1587,1872,3459
VIHIGA,SABATIA,70,352,408,760
VIHIGA,SABATIA,71,273,256,529
VIHIGA,SABATIA,72,237,313,550
VIHIGA,SABATIA,73,227,275,502
VIHIGA,SABATIA,74,199,246,445
VIHIGA,SABATIA,70-74,1288,1498,2786
VIHIGA,SABATIA,75,125,189,314
VIHIGA,SABATIA,76,174,281,455
VIHIGA,SABATIA,77,176,191,367
VIHIGA,SABATIA,78,101,111,212
VIHIGA,SABATIA,79,138,172,310
VIHIGA,SABATIA,75-79,714,944,1658
VIHIGA,SABATIA,80,130,190,320
VIHIGA,SABATIA,81,104,141,245
VIHIGA,SABATIA,82,107,128,235
VIHIGA,SABATIA,83,93,146,239
VIHIGA,SABATIA,84,64,105,169
VIHIGA,SABATIA,80-84,498,710,1208
VIHIGA,SABATIA,85,57,102,159
VIHIGA,SABATIA,86,61,102,163
VIHIGA,SABATIA,87,76,107,183
VIHIGA,SABATIA,88,42,40,82
VIHIGA,SABATIA,89,37,85,122
VIHIGA,SABATIA,85-89,273,436,709
VIHIGA,SABATIA,90,35,41,76
VIHIGA,SABATIA,91,28,60,88
VIHIGA,SABATIA,92,18,32,50
VIHIGA,SABATIA,93,17,28,45
VIHIGA,SABATIA,94,12,17,29
VIHIGA,SABATIA,90-94,110,178,288
VIHIGA,SABATIA,95,11,35,46
VIHIGA,SABATIA,96,8,17,25
VIHIGA,SABATIA,97,12,19,31
VIHIGA,SABATIA,98,3,6,9
VIHIGA,SABATIA,99,5,14,19
VIHIGA,SABATIA,95-99,39,91,130
VIHIGA,SABATIA,100+,19,31,50
VIHIGA,SABATIA,Not Stated,2,1,3
VIHIGA,LUANDA,Total,51525,55165,106690
VIHIGA,LUANDA,0,1097,1195,2292
VIHIGA,LUANDA,1,1085,1168,2253
VIHIGA,LUANDA,2,1162,1199,2361
VIHIGA,LUANDA,3,1323,1252,2575
VIHIGA,LUANDA,4,1267,1196,2463
VIHIGA,LUANDA,0 - 4,5934,6010,11944
VIHIGA,LUANDA,5,1264,1282,2546
VIHIGA,LUANDA,6,1349,1365,2714
VIHIGA,LUANDA,7,1446,1474,2920
VIHIGA,LUANDA,8,1369,1399,2768
VIHIGA,LUANDA,9,1550,1517,3067
VIHIGA,LUANDA,05-Sep,6978,7037,14015
VIHIGA,LUANDA,10,1593,1579,3172
VIHIGA,LUANDA,11,1469,1587,3056
VIHIGA,LUANDA,12,1760,1716,3476
VIHIGA,LUANDA,13,1590,1634,3224
VIHIGA,LUANDA,14,1562,1455,3017
VIHIGA,LUANDA,Oct-14,7974,7971,15945
VIHIGA,LUANDA,15,1412,1416,2828
VIHIGA,LUANDA,16,1461,1408,2869
VIHIGA,LUANDA,17,1370,1310,2680
VIHIGA,LUANDA,18,1077,1011,2088
VIHIGA,LUANDA,19,1069,1121,2190
VIHIGA,LUANDA,15-19,6389,6266,12655
VIHIGA,LUANDA,20,899,994,1893
VIHIGA,LUANDA,21,731,775,1506
VIHIGA,LUANDA,22,698,847,1545
VIHIGA,LUANDA,23,702,798,1500
VIHIGA,LUANDA,24,621,763,1384
VIHIGA,LUANDA,20-24,3651,4177,7828
VIHIGA,LUANDA,25,636,796,1432
VIHIGA,LUANDA,26,525,729,1254
VIHIGA,LUANDA,27,611,718,1329
VIHIGA,LUANDA,28,513,611,1124
VIHIGA,LUANDA,29,534,640,1174
VIHIGA,LUANDA,25-29,2819,3494,6313
VIHIGA,LUANDA,30,717,903,1620
VIHIGA,LUANDA,31,501,609,1110
VIHIGA,LUANDA,32,614,766,1380
VIHIGA,LUANDA,33,507,625,1132
VIHIGA,LUANDA,34,489,565,1054
VIHIGA,LUANDA,30-34,2828,3468,6296
VIHIGA,LUANDA,35,659,704,1363
VIHIGA,LUANDA,36,487,528,1015
VIHIGA,LUANDA,37,530,515,1045
VIHIGA,LUANDA,38,401,393,794
VIHIGA,LUANDA,39,451,440,891
VIHIGA,LUANDA,35-39,2528,2580,5108
VIHIGA,LUANDA,40,551,554,1105
VIHIGA,LUANDA,41,500,492,992
VIHIGA,LUANDA,42,490,475,965
VIHIGA,LUANDA,43,455,462,917
VIHIGA,LUANDA,44,383,361,744
VIHIGA,LUANDA,40-44,2379,2344,4723
VIHIGA,LUANDA,45,462,452,914
VIHIGA,LUANDA,46,340,404,744
VIHIGA,LUANDA,47,406,421,827
VIHIGA,LUANDA,48,329,286,615
VIHIGA,LUANDA,49,308,336,644
VIHIGA,LUANDA,45-49,1845,1899,3744
VIHIGA,LUANDA,50,426,516,942
VIHIGA,LUANDA,51,342,420,762
VIHIGA,LUANDA,52,311,335,646
VIHIGA,LUANDA,53,243,319,562
VIHIGA,LUANDA,54,273,333,606
VIHIGA,LUANDA,50-54,1595,1923,3518
VIHIGA,LUANDA,55,363,390,753
VIHIGA,LUANDA,56,316,388,704
VIHIGA,LUANDA,57,313,474,787
VIHIGA,LUANDA,58,263,307,570
VIHIGA,LUANDA,59,335,385,720
VIHIGA,LUANDA,55-59,1590,1944,3534
VIHIGA,LUANDA,60,368,496,864
VIHIGA,LUANDA,61,374,382,756
VIHIGA,LUANDA,62,288,287,575
VIHIGA,LUANDA,63,299,362,661
VIHIGA,LUANDA,64,264,285,549
VIHIGA,LUANDA,60-64,1593,1812,3405
VIHIGA,LUANDA,65,349,399,748
VIHIGA,LUANDA,66,253,263,516
VIHIGA,LUANDA,67,345,339,684
VIHIGA,LUANDA,68,139,161,300
VIHIGA,LUANDA,69,229,272,501
VIHIGA,LUANDA,65-69,1315,1434,2749
VIHIGA,LUANDA,70,283,395,678
VIHIGA,LUANDA,71,207,204,411
VIHIGA,LUANDA,72,186,173,359
VIHIGA,LUANDA,73,151,161,312
VIHIGA,LUANDA,74,149,166,315
VIHIGA,LUANDA,70-74,976,1099,2075
VIHIGA,LUANDA,75,116,139,255
VIHIGA,LUANDA,76,117,195,312
VIHIGA,LUANDA,77,113,146,259
VIHIGA,LUANDA,78,58,81,139
VIHIGA,LUANDA,79,84,123,207
VIHIGA,LUANDA,75-79,488,684,1172
VIHIGA,LUANDA,80,106,188,294
VIHIGA,LUANDA,81,53,92,145
VIHIGA,LUANDA,82,75,89,164
VIHIGA,LUANDA,83,81,98,179
VIHIGA,LUANDA,84,58,93,151
VIHIGA,LUANDA,80-84,373,560,933
VIHIGA,LUANDA,85,49,80,129
VIHIGA,LUANDA,86,39,60,99
VIHIGA,LUANDA,87,36,78,114
VIHIGA,LUANDA,88,26,34,60
VIHIGA,LUANDA,89,29,58,87
VIHIGA,LUANDA,85-89,179,310,489
VIHIGA,LUANDA,90,17,25,42
VIHIGA,LUANDA,91,17,22,39
VIHIGA,LUANDA,92,14,14,28
VIHIGA,LUANDA,93,8,15,23
VIHIGA,LUANDA,94,9,14,23
VIHIGA,LUANDA,90-94,65,90,155
VIHIGA,LUANDA,95,10,25,35
VIHIGA,LUANDA,96,5,7,12
VIHIGA,LUANDA,97,3,11,14
VIHIGA,LUANDA,98,3,4,7
VIHIGA,LUANDA,99,1,6,7
VIHIGA,LUANDA,95-99,22,53,75
VIHIGA,LUANDA,100+,3,8,11
VIHIGA,LUANDA,Not Stated,1,2,3
VIHIGA,HAMISI,Total,76901,82337,159238
VIHIGA,HAMISI,0,1566,1642,3208
VIHIGA,HAMISI,1,1690,1717,3407
VIHIGA,HAMISI,2,1724,1687,3411
VIHIGA,HAMISI,3,1784,1873,3657
VIHIGA,HAMISI,4,1912,1912,3824
VIHIGA,HAMISI,0 - 4,8676,8831,17507
VIHIGA,HAMISI,5,1914,1858,3772
VIHIGA,HAMISI,6,2015,2069,4084
VIHIGA,HAMISI,7,2163,2163,4326
VIHIGA,HAMISI,8,2095,2212,4307
VIHIGA,HAMISI,9,2390,2399,4789
VIHIGA,HAMISI,05-Sep,10577,10701,21278
VIHIGA,HAMISI,10,2414,2258,4672
VIHIGA,HAMISI,11,2239,2351,4590
VIHIGA,HAMISI,12,2491,2445,4936
VIHIGA,HAMISI,13,2471,2476,4947
VIHIGA,HAMISI,14,2415,2353,4768
VIHIGA,HAMISI,Oct-14,12030,11883,23913
VIHIGA,HAMISI,15,2249,2272,4521
VIHIGA,HAMISI,16,2308,2300,4608
VIHIGA,HAMISI,17,2237,2186,4423
VIHIGA,HAMISI,18,1910,1791,3701
VIHIGA,HAMISI,19,1823,1665,3488
VIHIGA,HAMISI,15-19,10527,10214,20741
VIHIGA,HAMISI,20,1526,1549,3075
VIHIGA,HAMISI,21,1241,1175,2416
VIHIGA,HAMISI,22,1070,1106,2176
VIHIGA,HAMISI,23,1057,1121,2178
VIHIGA,HAMISI,24,914,950,1864
VIHIGA,HAMISI,20-24,5808,5901,11709
VIHIGA,HAMISI,25,870,1012,1882
VIHIGA,HAMISI,26,760,914,1674
VIHIGA,HAMISI,27,786,962,1748
VIHIGA,HAMISI,28,705,848,1553
VIHIGA,HAMISI,29,756,859,1615
VIHIGA,HAMISI,25-29,3877,4595,8472
VIHIGA,HAMISI,30,920,1137,2057
VIHIGA,HAMISI,31,711,893,1604
VIHIGA,HAMISI,32,901,1116,2017
VIHIGA,HAMISI,33,763,920,1683
VIHIGA,HAMISI,34,726,868,1594
VIHIGA,HAMISI,30-34,4021,4934,8955
VIHIGA,HAMISI,35,859,938,1797
VIHIGA,HAMISI,36,702,765,1467
VIHIGA,HAMISI,37,752,764,1516
VIHIGA,HAMISI,38,576,616,1192
VIHIGA,HAMISI,39,627,679,1306
VIHIGA,HAMISI,35-39,3516,3762,7278
VIHIGA,HAMISI,40,720,797,1517
VIHIGA,HAMISI,41,689,759,1448
VIHIGA,HAMISI,42,776,922,1698
VIHIGA,HAMISI,43,650,794,1444
VIHIGA,HAMISI,44,520,551,1071
VIHIGA,HAMISI,40-44,3355,3823,7178
VIHIGA,HAMISI,45,665,717,1382
VIHIGA,HAMISI,46,618,606,1224
VIHIGA,HAMISI,47,605,695,1300
VIHIGA,HAMISI,48,439,523,962
VIHIGA,HAMISI,49,501,576,1077
VIHIGA,HAMISI,45-49,2828,3117,5945
VIHIGA,HAMISI,50,546,640,1186
VIHIGA,HAMISI,51,492,590,1082
VIHIGA,HAMISI,52,450,573,1023
VIHIGA,HAMISI,53,395,464,859
VIHIGA,HAMISI,54,424,516,940
VIHIGA,HAMISI,50-54,2307,2783,5090
VIHIGA,HAMISI,55,493,525,1018
VIHIGA,HAMISI,56,420,509,929
VIHIGA,HAMISI,57,445,630,1075
VIHIGA,HAMISI,58,381,473,854
VIHIGA,HAMISI,59,450,578,1028
VIHIGA,HAMISI,55-59,2189,2715,4904
VIHIGA,HAMISI,60,483,570,1053
VIHIGA,HAMISI,61,479,522,1001
VIHIGA,HAMISI,62,398,493,891
VIHIGA,HAMISI,63,433,520,953
VIHIGA,HAMISI,64,348,424,772
VIHIGA,HAMISI,60-64,2141,2529,4670
VIHIGA,HAMISI,65,428,538,966
VIHIGA,HAMISI,66,304,399,703
VIHIGA,HAMISI,67,417,518,935
VIHIGA,HAMISI,68,207,274,481
VIHIGA,HAMISI,69,353,394,747
VIHIGA,HAMISI,65-69,1709,2123,3832
VIHIGA,HAMISI,70,379,432,811
VIHIGA,HAMISI,71,296,300,596
VIHIGA,HAMISI,72,294,316,610
VIHIGA,HAMISI,73,240,241,481
VIHIGA,HAMISI,74,239,272,511
VIHIGA,HAMISI,70-74,1448,1561,3009
VIHIGA,HAMISI,75,160,269,429
VIHIGA,HAMISI,76,211,340,551
VIHIGA,HAMISI,77,177,236,413
VIHIGA,HAMISI,78,132,140,272
VIHIGA,HAMISI,79,170,221,391
VIHIGA,HAMISI,75-79,850,1206,2056
VIHIGA,HAMISI,80,118,209,327
VIHIGA,HAMISI,81,136,169,305
VIHIGA,HAMISI,82,98,144,242
VIHIGA,HAMISI,83,95,176,271
VIHIGA,HAMISI,84,87,125,212
VIHIGA,HAMISI,80-84,534,823,1357
VIHIGA,HAMISI,85,62,135,197
VIHIGA,HAMISI,86,58,110,168
VIHIGA,HAMISI,87,80,135,215
VIHIGA,HAMISI,88,50,53,103
VIHIGA,HAMISI,89,61,117,178
VIHIGA,HAMISI,85-89,311,550,861
VIHIGA,HAMISI,90,31,42,73
VIHIGA,HAMISI,91,31,49,80
VIHIGA,HAMISI,92,31,34,65
VIHIGA,HAMISI,93,19,16,35
VIHIGA,HAMISI,94,15,21,36
VIHIGA,HAMISI,90-94,127,162,289
VIHIGA,HAMISI,95,17,31,48
VIHIGA,HAMISI,96,8,23,31
VIHIGA,HAMISI,97,19,17,36
VIHIGA,HAMISI,98,9,8,17
VIHIGA,HAMISI,99,5,16,21
VIHIGA,HAMISI,95-99,58,95,153
VIHIGA,HAMISI,100+,12,29,41
VIHIGA,HAMISI,Not Stated,-,-,-
VIHIGA,KAKAMEGA FOREST,Total,13,4,17
VIHIGA,KAKAMEGA FOREST,0,1,-,1
VIHIGA,KAKAMEGA FOREST,1,-,-,-
VIHIGA,KAKAMEGA FOREST,2,-,-,-
VIHIGA,KAKAMEGA FOREST,3,-,-,-
VIHIGA,KAKAMEGA FOREST,4,-,-,-
VIHIGA,KAKAMEGA FOREST,0 - 4,1,-,1
VIHIGA,KAKAMEGA FOREST,5,-,-,-
VIHIGA,KAKAMEGA FOREST,6,-,-,-
VIHIGA,KAKAMEGA FOREST,7,-,-,-
VIHIGA,KAKAMEGA FOREST,8,-,-,-
VIHIGA,KAKAMEGA FOREST,9,-,-,-
VIHIGA,KAKAMEGA FOREST,05-Sep,-,-,-
VIHIGA,KAKAMEGA FOREST,10,-,-,-
VIHIGA,KAKAMEGA FOREST,11,-,-,-
VIHIGA,KAKAMEGA FOREST,12,-,-,-
VIHIGA,KAKAMEGA FOREST,13,-,-,-
VIHIGA,KAKAMEGA FOREST,14,-,-,-
VIHIGA,KAKAMEGA FOREST,Oct-14,-,-,-
VIHIGA,KAKAMEGA FOREST,15,-,-,-
VIHIGA,KAKAMEGA FOREST,16,-,-,-
VIHIGA,KAKAMEGA FOREST,17,-,-,-
VIHIGA,KAKAMEGA FOREST,18,-,-,-
VIHIGA,KAKAMEGA FOREST,19,-,-,-
VIHIGA,KAKAMEGA FOREST,15-19,-,-,-
VIHIGA,KAKAMEGA FOREST,20,-,-,-
VIHIGA,KAKAMEGA FOREST,21,-,-,-
VIHIGA,KAKAMEGA FOREST,22,-,1,1
VIHIGA,KAKAMEGA FOREST,23,-,-,-
VIHIGA,KAKAMEGA FOREST,24,-,-,-
VIHIGA,KAKAMEGA FOREST,20-24,-,-,-
VIHIGA,KAKAMEGA FOREST,25,-,-,-
VIHIGA,KAKAMEGA FOREST,26,1,-,1
VIHIGA,KAKAMEGA FOREST,27,2,-,2
VIHIGA,KAKAMEGA FOREST,28,-,-,-
VIHIGA,KAKAMEGA FOREST,29,-,-,-
VIHIGA,KAKAMEGA FOREST,25-29,3,-,3
VIHIGA,KAKAMEGA FOREST,30,-,1,1
VIHIGA,KAKAMEGA FOREST,31,-,-,-
VIHIGA,KAKAMEGA FOREST,32,-,1,1
VIHIGA,KAKAMEGA FOREST,33,-,-,-
VIHIGA,KAKAMEGA FOREST,34,-,-,-
VIHIGA,KAKAMEGA FOREST,30-34,-,2,2
VIHIGA,KAKAMEGA FOREST,35,-,1,1
VIHIGA,KAKAMEGA FOREST,36,-,-,-
VIHIGA,KAKAMEGA FOREST,37,2,-,2
VIHIGA,KAKAMEGA FOREST,38,2,-,2
VIHIGA,KAKAMEGA FOREST,39,-,-,-
VIHIGA,KAKAMEGA FOREST,35-39,4,1,5
VIHIGA,KAKAMEGA FOREST,40,-,-,-
VIHIGA,KAKAMEGA FOREST,41,-,-,-
VIHIGA,KAKAMEGA FOREST,42,-,-,-
VIHIGA,KAKAMEGA FOREST,43,-,-,-
VIHIGA,KAKAMEGA FOREST,44,-,-,-
VIHIGA,KAKAMEGA FOREST,40-44,-,-,-
VIHIGA,KAKAMEGA FOREST,45,-,-,-
VIHIGA,KAKAMEGA FOREST,46,-,-,-
VIHIGA,KAKAMEGA FOREST,47,-,-,-
VIHIGA,KAKAMEGA FOREST,48,1,-,1
VIHIGA,KAKAMEGA FOREST,49,1,-,1
VIHIGA,KAKAMEGA FOREST,45-49,2,-,2
VIHIGA,KAKAMEGA FOREST,50,1,-,1
VIHIGA,KAKAMEGA FOREST,51,-,-,-
VIHIGA,KAKAMEGA FOREST,52,-,-,-
VIHIGA,KAKAMEGA FOREST,53,-,-,-
VIHIGA,KAKAMEGA FOREST,54,1,-,1
VIHIGA,KAKAMEGA FOREST,50-54,2,-,2
VIHIGA,KAKAMEGA FOREST,55,-,-,-
VIHIGA,KAKAMEGA FOREST,56,-,-,-
VIHIGA,KAKAMEGA FOREST,57,1,-,1
VIHIGA,KAKAMEGA FOREST,58,-,-,-
VIHIGA,KAKAMEGA FOREST,59,-,-,-
VIHIGA,KAKAMEGA FOREST,55-59,1,-,1
VIHIGA,KAKAMEGA FOREST,60,-,-,-
VIHIGA,KAKAMEGA FOREST,61,-,-,-
VIHIGA,KAKAMEGA FOREST,62,-,-,-
VIHIGA,KAKAMEGA FOREST,63,-,-,-
VIHIGA,KAKAMEGA FOREST,64,-,-,-
VIHIGA,KAKAMEGA FOREST,60-64,-,-,-
VIHIGA,KAKAMEGA FOREST,65,-,-,-
VIHIGA,KAKAMEGA FOREST,66,-,-,-
VIHIGA,KAKAMEGA FOREST,67,-,-,-
VIHIGA,KAKAMEGA FOREST,68,-,-,-
VIHIGA,KAKAMEGA FOREST,69,-,-,-
VIHIGA,KAKAMEGA FOREST,65-69,-,-,-
VIHIGA,KAKAMEGA FOREST,70,-,-,-
VIHIGA,KAKAMEGA FOREST,71,-,-,-
VIHIGA,KAKAMEGA FOREST,72,-,-,-
VIHIGA,KAKAMEGA FOREST,73,-,-,-
VIHIGA,KAKAMEGA FOREST,74,-,-,-
VIHIGA,KAKAMEGA FOREST,70-74,-,-,-
VIHIGA,KAKAMEGA FOREST,75,-,-,-
VIHIGA,KAKAMEGA FOREST,76,-,-,-
VIHIGA,KAKAMEGA FOREST,77,-,-,-
VIHIGA,KAKAMEGA FOREST,78,-,-,-
VIHIGA,KAKAMEGA FOREST,79,-,-,-
VIHIGA,KAKAMEGA FOREST,75-79,-,-,-
VIHIGA,KAKAMEGA FOREST,80,-,-,-
VIHIGA,KAKAMEGA FOREST,81,-,-,-
VIHIGA,KAKAMEGA FOREST,82,-,-,-
VIHIGA,KAKAMEGA FOREST,83,-,-,-
VIHIGA,KAKAMEGA FOREST,84,-,-,-
VIHIGA,KAKAMEGA FOREST,80-84,-,-,-
VIHIGA,KAKAMEGA FOREST,85,-,-,-
VIHIGA,KAKAMEGA FOREST,86,-,-,-
VIHIGA,KAKAMEGA FOREST,87,-,-,-
VIHIGA,KAKAMEGA FOREST,88,-,-,-
VIHIGA,KAKAMEGA FOREST,89,-,-,-
VIHIGA,KAKAMEGA FOREST,85-89,-,-,-
VIHIGA,KAKAMEGA FOREST,90,-,-,-
VIHIGA,KAKAMEGA FOREST,91,-,-,-
VIHIGA,KAKAMEGA FOREST,92,-,-,-
VIHIGA,KAKAMEGA FOREST,93,-,-,-
VIHIGA,KAKAMEGA FOREST,94,-,-,-
VIHIGA,KAKAMEGA FOREST,90-94,-,-,-
VIHIGA,KAKAMEGA FOREST,95,-,-,-
VIHIGA,KAKAMEGA FOREST,96,-,-,-
VIHIGA,KAKAMEGA FOREST,97,-,-,-
VIHIGA,KAKAMEGA FOREST,98,-,-,-
VIHIGA,KAKAMEGA FOREST,99,-,-,-
VIHIGA,KAKAMEGA FOREST,95-99,-,-,-
VIHIGA,KAKAMEGA FOREST,100+,-,-,-
VIHIGA,KAKAMEGA FOREST,Not Stated,-,-,-
WAJIR,ALL,Total,415374,365840,781214
WAJIR,ALL,0,5431,5675,11106
WAJIR,ALL,1,9519,9334,18853
WAJIR,ALL,2,16905,16931,33836
WAJIR,ALL,3,12337,12288,24625
WAJIR,ALL,4,17344,17063,34407
WAJIR,ALL,0 - 4,61536,61291,122827
WAJIR,ALL,5,12543,12404,24947
WAJIR,ALL,6,17878,17105,34983
WAJIR,ALL,7,10954,10378,21332
WAJIR,ALL,8,18705,17201,35906
WAJIR,ALL,9,10305,9961,20266
WAJIR,ALL,05-Sep,70385,67049,137434
WAJIR,ALL,10,21285,18692,39977
WAJIR,ALL,11,8957,9219,18176
WAJIR,ALL,12,17570,12770,30340
WAJIR,ALL,13,11088,8255,19343
WAJIR,ALL,14,14306,10236,24542
WAJIR,ALL,Oct-14,73206,59172,132378
WAJIR,ALL,15,14966,10348,25314
WAJIR,ALL,16,12853,9128,21981
WAJIR,ALL,17,11744,8185,19929
WAJIR,ALL,18,11799,9083,20882
WAJIR,ALL,19,5603,5138,10741
WAJIR,ALL,15-19,56965,41882,98847
WAJIR,ALL,20,12808,11571,24379
WAJIR,ALL,21,5092,4772,9864
WAJIR,ALL,22,6235,6176,12411
WAJIR,ALL,23,4761,4829,9590
WAJIR,ALL,24,4734,4622,9356
WAJIR,ALL,20-24,33630,31970,65600
WAJIR,ALL,25,8972,9267,18239
WAJIR,ALL,26,4693,4729,9422
WAJIR,ALL,27,4206,4573,8779
WAJIR,ALL,28,5662,6280,11942
WAJIR,ALL,29,3651,4080,7731
WAJIR,ALL,25-29,27184,28929,56113
WAJIR,ALL,30,11178,10834,22012
WAJIR,ALL,31,3374,3800,7174
WAJIR,ALL,32,4109,3997,8106
WAJIR,ALL,33,2630,2732,5362
WAJIR,ALL,34,2500,2525,5025
WAJIR,ALL,30-34,23791,23888,47679
WAJIR,ALL,35,6077,5908,11985
WAJIR,ALL,36,2760,2852,5612
WAJIR,ALL,37,2238,2352,4590
WAJIR,ALL,38,3064,3288,6352
WAJIR,ALL,39,2097,2177,4274
WAJIR,ALL,35-39,16236,16577,32813
WAJIR,ALL,40,8644,6321,14965
WAJIR,ALL,41,2568,2398,4966
WAJIR,ALL,42,2905,2260,5165
WAJIR,ALL,43,1686,1229,2915
WAJIR,ALL,44,1029,855,1884
WAJIR,ALL,40-44,16832,13063,29895
WAJIR,ALL,45,4084,2834,6918
WAJIR,ALL,46,1309,891,2200
WAJIR,ALL,47,1233,798,2031
WAJIR,ALL,48,1597,1110,2707
WAJIR,ALL,49,1195,772,1967
WAJIR,ALL,45-49,9418,6405,15823
WAJIR,ALL,50,4867,2723,7590
WAJIR,ALL,51,978,590,1568
WAJIR,ALL,52,1533,853,2386
WAJIR,ALL,53,734,393,1127
WAJIR,ALL,54,954,573,1527
WAJIR,ALL,50-54,9066,5132,14198
WAJIR,ALL,55,1273,710,1983
WAJIR,ALL,56,949,613,1562
WAJIR,ALL,57,695,593,1288
WAJIR,ALL,58,913,613,1526
WAJIR,ALL,59,996,580,1576
WAJIR,ALL,55-59,4826,3109,7935
WAJIR,ALL,60,2784,1440,4224
WAJIR,ALL,61,798,530,1328
WAJIR,ALL,62,634,298,932
WAJIR,ALL,63,553,293,846
WAJIR,ALL,64,447,253,700
WAJIR,ALL,60-64,5216,2814,8030
WAJIR,ALL,65,805,475,1280
WAJIR,ALL,66,329,292,621
WAJIR,ALL,67,362,191,553
WAJIR,ALL,68,394,203,597
WAJIR,ALL,69,479,225,704
WAJIR,ALL,65-69,2369,1386,3755
WAJIR,ALL,70,1247,839,2086
WAJIR,ALL,71,367,363,730
WAJIR,ALL,72,297,132,429
WAJIR,ALL,73,179,79,258
WAJIR,ALL,74,197,110,307
WAJIR,ALL,70-74,2287,1523,3810
WAJIR,ALL,75,350,192,542
WAJIR,ALL,76,162,101,263
WAJIR,ALL,77,145,65,210
WAJIR,ALL,78,176,86,262
WAJIR,ALL,79,190,85,275
WAJIR,ALL,75-79,1023,529,1552
WAJIR,ALL,80,473,399,872
WAJIR,ALL,81,144,185,329
WAJIR,ALL,82,94,46,140
WAJIR,ALL,83,70,43,113
WAJIR,ALL,84,65,46,111
WAJIR,ALL,80-84,846,719,1565
WAJIR,ALL,85,82,55,137
WAJIR,ALL,86,52,37,89
WAJIR,ALL,87,54,29,83
WAJIR,ALL,88,41,21,62
WAJIR,ALL,89,62,47,109
WAJIR,ALL,85-89,291,189,480
WAJIR,ALL,90,102,95,197
WAJIR,ALL,91,32,37,69
WAJIR,ALL,92,26,9,35
WAJIR,ALL,93,21,8,29
WAJIR,ALL,94,10,7,17
WAJIR,ALL,90-94,191,156,347
WAJIR,ALL,95,23,11,34
WAJIR,ALL,96,11,9,20
WAJIR,ALL,97,6,2,8
WAJIR,ALL,98,11,2,13
WAJIR,ALL,99,4,13,17
WAJIR,ALL,95-99,55,37,92
WAJIR,ALL,100+,20,19,39
WAJIR,ALL,Not Stated,1,1,2
WAJIR,BUNA,Total,26796,23088,49884
WAJIR,BUNA,0,331,414,745
WAJIR,BUNA,1,588,641,1229
WAJIR,BUNA,2,993,1068,2061
WAJIR,BUNA,3,652,768,1420
WAJIR,BUNA,4,1049,1113,2162
WAJIR,BUNA,0 - 4,3613,4004,7617
WAJIR,BUNA,5,697,710,1407
WAJIR,BUNA,6,1073,1098,2171
WAJIR,BUNA,7,697,636,1333
WAJIR,BUNA,8,1152,1044,2196
WAJIR,BUNA,9,687,664,1351
WAJIR,BUNA,05-Sep,4306,4152,8458
WAJIR,BUNA,10,1348,1172,2520
WAJIR,BUNA,11,634,653,1287
WAJIR,BUNA,12,1213,841,2054
WAJIR,BUNA,13,710,492,1202
WAJIR,BUNA,14,975,693,1668
WAJIR,BUNA,Oct-14,4880,3851,8731
WAJIR,BUNA,15,964,642,1606
WAJIR,BUNA,16,884,629,1513
WAJIR,BUNA,17,716,450,1166
WAJIR,BUNA,18,856,629,1485
WAJIR,BUNA,19,455,375,830
WAJIR,BUNA,15-19,3875,2725,6600
WAJIR,BUNA,20,943,789,1732
WAJIR,BUNA,21,484,383,867
WAJIR,BUNA,22,457,376,833
WAJIR,BUNA,23,351,394,745
WAJIR,BUNA,24,417,355,772
WAJIR,BUNA,20-24,2652,2297,4949
WAJIR,BUNA,25,563,517,1080
WAJIR,BUNA,26,389,312,701
WAJIR,BUNA,27,280,283,563
WAJIR,BUNA,28,385,387,772
WAJIR,BUNA,29,285,241,526
WAJIR,BUNA,25-29,1902,1740,3642
WAJIR,BUNA,30,634,584,1218
WAJIR,BUNA,31,193,176,369
WAJIR,BUNA,32,270,251,521
WAJIR,BUNA,33,161,158,319
WAJIR,BUNA,34,188,193,381
WAJIR,BUNA,30-34,1446,1362,2808
WAJIR,BUNA,35,323,298,621
WAJIR,BUNA,36,205,179,384
WAJIR,BUNA,37,115,117,232
WAJIR,BUNA,38,187,198,385
WAJIR,BUNA,39,177,156,333
WAJIR,BUNA,35-39,1007,948,1955
WAJIR,BUNA,40,441,354,795
WAJIR,BUNA,41,128,106,234
WAJIR,BUNA,42,216,173,389
WAJIR,BUNA,43,112,84,196
WAJIR,BUNA,44,73,68,141
WAJIR,BUNA,40-44,970,785,1755
WAJIR,BUNA,45,235,162,397
WAJIR,BUNA,46,99,62,161
WAJIR,BUNA,47,84,59,143
WAJIR,BUNA,48,88,70,158
WAJIR,BUNA,49,104,46,150
WAJIR,BUNA,45-49,610,399,1009
WAJIR,BUNA,50,266,127,393
WAJIR,BUNA,51,49,23,72
WAJIR,BUNA,52,114,42,156
WAJIR,BUNA,53,54,26,80
WAJIR,BUNA,54,63,48,111
WAJIR,BUNA,50-54,546,266,812
WAJIR,BUNA,55,70,48,118
WAJIR,BUNA,56,68,34,102
WAJIR,BUNA,57,53,23,76
WAJIR,BUNA,58,51,46,97
WAJIR,BUNA,59,64,49,113
WAJIR,BUNA,55-59,306,200,506
WAJIR,BUNA,60,158,77,235
WAJIR,BUNA,61,32,27,59
WAJIR,BUNA,62,38,14,52
WAJIR,BUNA,63,37,20,57
WAJIR,BUNA,64,26,14,40
WAJIR,BUNA,60-64,291,152,443
WAJIR,BUNA,65,40,18,58
WAJIR,BUNA,66,23,18,41
WAJIR,BUNA,67,21,15,36
WAJIR,BUNA,68,26,10,36
WAJIR,BUNA,69,33,16,49
WAJIR,BUNA,65-69,143,77,220
WAJIR,BUNA,70,73,26,99
WAJIR,BUNA,71,17,24,41
WAJIR,BUNA,72,15,5,20
WAJIR,BUNA,73,13,6,19
WAJIR,BUNA,74,11,5,16
WAJIR,BUNA,70-74,129,66,195
WAJIR,BUNA,75,26,4,30
WAJIR,BUNA,76,6,5,11
WAJIR,BUNA,77,8,6,14
WAJIR,BUNA,78,5,4,9
WAJIR,BUNA,79,16,4,20
WAJIR,BUNA,75-79,61,23,84
WAJIR,BUNA,80,18,7,25
WAJIR,BUNA,81,6,9,15
WAJIR,BUNA,82,10,2,12
WAJIR,BUNA,83,2,2,4
WAJIR,BUNA,84,4,1,5
WAJIR,BUNA,80-84,40,21,61
WAJIR,BUNA,85,5,2,7
WAJIR,BUNA,86,1,2,3
WAJIR,BUNA,87,4,3,7
WAJIR,BUNA,88,-,-,-
WAJIR,BUNA,89,-,7,7
WAJIR,BUNA,85-89,10,14,24
WAJIR,BUNA,90,2,2,4
WAJIR,BUNA,91,3,3,6
WAJIR,BUNA,92,3,-,3
WAJIR,BUNA,93,-,-,-
WAJIR,BUNA,94,-,-,-
WAJIR,BUNA,90-94,8,5,13
WAJIR,BUNA,95,1,-,1
WAJIR,BUNA,96,-,-,-
WAJIR,BUNA,97,-,-,-
WAJIR,BUNA,98,-,-,-
WAJIR,BUNA,99,-,-,-
WAJIR,BUNA,95-99,1,-,1
WAJIR,BUNA,100+,-,1,1
WAJIR,BUNA,Not Stated,-,-,-
WAJIR,ELDAS,Total,45028,44069,89097
WAJIR,ELDAS,0,387,468,855
WAJIR,ELDAS,1,903,1062,1965
WAJIR,ELDAS,2,1729,2170,3899
WAJIR,ELDAS,3,1218,1556,2774
WAJIR,ELDAS,4,1895,2302,4197
WAJIR,ELDAS,0 - 4,6132,7558,13690
WAJIR,ELDAS,5,1265,1529,2794
WAJIR,ELDAS,6,2039,2268,4307
WAJIR,ELDAS,7,1188,1379,2567
WAJIR,ELDAS,8,2111,2306,4417
WAJIR,ELDAS,9,1217,1343,2560
WAJIR,ELDAS,05-Sep,7820,8825,16645
WAJIR,ELDAS,10,2384,2423,4807
WAJIR,ELDAS,11,1030,1269,2299
WAJIR,ELDAS,12,1995,1693,3688
WAJIR,ELDAS,13,1193,939,2132
WAJIR,ELDAS,14,1635,1363,2998
WAJIR,ELDAS,Oct-14,8237,7687,15924
WAJIR,ELDAS,15,1441,1142,2583
WAJIR,ELDAS,16,1429,1030,2459
WAJIR,ELDAS,17,1132,797,1929
WAJIR,ELDAS,18,1247,935,2182
WAJIR,ELDAS,19,572,457,1029
WAJIR,ELDAS,15-19,5821,4361,10182
WAJIR,ELDAS,20,1346,1205,2551
WAJIR,ELDAS,21,535,500,1035
WAJIR,ELDAS,22,580,637,1217
WAJIR,ELDAS,23,453,467,920
WAJIR,ELDAS,24,473,550,1023
WAJIR,ELDAS,20-24,3387,3359,6746
WAJIR,ELDAS,25,911,976,1887
WAJIR,ELDAS,26,525,523,1048
WAJIR,ELDAS,27,492,515,1007
WAJIR,ELDAS,28,562,643,1205
WAJIR,ELDAS,29,417,504,921
WAJIR,ELDAS,25-29,2907,3161,6068
WAJIR,ELDAS,30,1151,1257,2408
WAJIR,ELDAS,31,458,535,993
WAJIR,ELDAS,32,454,479,933
WAJIR,ELDAS,33,317,401,718
WAJIR,ELDAS,34,295,383,678
WAJIR,ELDAS,30-34,2675,3055,5730
WAJIR,ELDAS,35,624,632,1256
WAJIR,ELDAS,36,299,360,659
WAJIR,ELDAS,37,305,362,667
WAJIR,ELDAS,38,344,480,824
WAJIR,ELDAS,39,278,326,604
WAJIR,ELDAS,35-39,1850,2160,4010
WAJIR,ELDAS,40,1102,872,1974
WAJIR,ELDAS,41,382,322,704
WAJIR,ELDAS,42,340,261,601
WAJIR,ELDAS,43,190,148,338
WAJIR,ELDAS,44,157,133,290
WAJIR,ELDAS,40-44,2171,1736,3907
WAJIR,ELDAS,45,454,285,739
WAJIR,ELDAS,46,179,105,284
WAJIR,ELDAS,47,149,112,261
WAJIR,ELDAS,48,188,109,297
WAJIR,ELDAS,49,144,71,215
WAJIR,ELDAS,45-49,1114,682,1796
WAJIR,ELDAS,50,517,285,802
WAJIR,ELDAS,51,138,73,211
WAJIR,ELDAS,52,184,96,280
WAJIR,ELDAS,53,76,43,119
WAJIR,ELDAS,54,106,50,156
WAJIR,ELDAS,50-54,1021,547,1568
WAJIR,ELDAS,55,130,67,197
WAJIR,ELDAS,56,102,52,154
WAJIR,ELDAS,57,71,64,135
WAJIR,ELDAS,58,103,49,152
WAJIR,ELDAS,59,103,51,154
WAJIR,ELDAS,55-59,509,283,792
WAJIR,ELDAS,60,298,132,430
WAJIR,ELDAS,61,122,59,181
WAJIR,ELDAS,62,83,24,107
WAJIR,ELDAS,63,40,31,71
WAJIR,ELDAS,64,52,26,78
WAJIR,ELDAS,60-64,595,272,867
WAJIR,ELDAS,65,65,37,102
WAJIR,ELDAS,66,39,27,66
WAJIR,ELDAS,67,37,18,55
WAJIR,ELDAS,68,31,18,49
WAJIR,ELDAS,69,52,16,68
WAJIR,ELDAS,65-69,224,116,340
WAJIR,ELDAS,70,140,56,196
WAJIR,ELDAS,71,59,28,87
WAJIR,ELDAS,72,36,14,50
WAJIR,ELDAS,73,18,6,24
WAJIR,ELDAS,74,21,13,34
WAJIR,ELDAS,70-74,274,117,391
WAJIR,ELDAS,75,30,16,46
WAJIR,ELDAS,76,17,9,26
WAJIR,ELDAS,77,12,5,17
WAJIR,ELDAS,78,16,12,28
WAJIR,ELDAS,79,33,5,38
WAJIR,ELDAS,75-79,108,47,155
WAJIR,ELDAS,80,59,38,97
WAJIR,ELDAS,81,28,15,43
WAJIR,ELDAS,82,13,2,15
WAJIR,ELDAS,83,8,5,13
WAJIR,ELDAS,84,12,6,18
WAJIR,ELDAS,80-84,120,66,186
WAJIR,ELDAS,85,6,3,9
WAJIR,ELDAS,86,7,3,10
WAJIR,ELDAS,87,5,4,9
WAJIR,ELDAS,88,7,2,9
WAJIR,ELDAS,89,9,4,13
WAJIR,ELDAS,85-89,34,16,50
WAJIR,ELDAS,90,17,9,26
WAJIR,ELDAS,91,4,5,9
WAJIR,ELDAS,92,2,1,3
WAJIR,ELDAS,93,-,-,-
WAJIR,ELDAS,94,1,-,1
WAJIR,ELDAS,90-94,24,15,39
WAJIR,ELDAS,95,3,-,3
WAJIR,ELDAS,96,1,1,2
WAJIR,ELDAS,97,-,1,1
WAJIR,ELDAS,98,-,1,1
WAJIR,ELDAS,99,1,1,2
WAJIR,ELDAS,95-99,5,4,9
WAJIR,ELDAS,100+,-,2,2
WAJIR,ELDAS,Not Stated,-,-,-
WAJIR,HABASWEIN,Total,94613,79505,174118
WAJIR,HABASWEIN,0,1448,1242,2690
WAJIR,HABASWEIN,1,2261,1858,4119
WAJIR,HABASWEIN,2,4265,3594,7859
WAJIR,HABASWEIN,3,3242,2702,5944
WAJIR,HABASWEIN,4,4104,3445,7549
WAJIR,HABASWEIN,0 - 4,15320,12841,28161
WAJIR,HABASWEIN,5,3224,2626,5850
WAJIR,HABASWEIN,6,4207,3357,7564
WAJIR,HABASWEIN,7,2608,2068,4676
WAJIR,HABASWEIN,8,4298,3362,7660
WAJIR,HABASWEIN,9,2352,1975,4327
WAJIR,HABASWEIN,05-Sep,16689,13388,30077
WAJIR,HABASWEIN,10,4646,3741,8387
WAJIR,HABASWEIN,11,2033,1768,3801
WAJIR,HABASWEIN,12,3604,2463,6067
WAJIR,HABASWEIN,13,2357,1777,4134
WAJIR,HABASWEIN,14,2950,2076,5026
WAJIR,HABASWEIN,Oct-14,15590,11825,27415
WAJIR,HABASWEIN,15,3131,2200,5331
WAJIR,HABASWEIN,16,2671,1829,4500
WAJIR,HABASWEIN,17,2336,1739,4075
WAJIR,HABASWEIN,18,2481,2040,4521
WAJIR,HABASWEIN,19,1181,1262,2443
WAJIR,HABASWEIN,15-19,11800,9070,20870
WAJIR,HABASWEIN,20,2809,2875,5684
WAJIR,HABASWEIN,21,1005,1129,2134
WAJIR,HABASWEIN,22,1363,1525,2888
WAJIR,HABASWEIN,23,1047,1178,2225
WAJIR,HABASWEIN,24,951,1126,2077
WAJIR,HABASWEIN,20-24,7175,7833,15008
WAJIR,HABASWEIN,25,2001,2291,4292
WAJIR,HABASWEIN,26,1035,1183,2218
WAJIR,HABASWEIN,27,959,1066,2025
WAJIR,HABASWEIN,28,1377,1592,2969
WAJIR,HABASWEIN,29,886,968,1854
WAJIR,HABASWEIN,25-29,6258,7100,13358
WAJIR,HABASWEIN,30,2929,2888,5817
WAJIR,HABASWEIN,31,712,741,1453
WAJIR,HABASWEIN,32,1005,876,1881
WAJIR,HABASWEIN,33,539,523,1062
WAJIR,HABASWEIN,34,571,497,1068
WAJIR,HABASWEIN,30-34,5756,5525,11281
WAJIR,HABASWEIN,35,1457,1429,2886
WAJIR,HABASWEIN,36,630,667,1297
WAJIR,HABASWEIN,37,537,582,1119
WAJIR,HABASWEIN,38,734,771,1505
WAJIR,HABASWEIN,39,555,537,1092
WAJIR,HABASWEIN,35-39,3913,3986,7899
WAJIR,HABASWEIN,40,2160,1580,3740
WAJIR,HABASWEIN,41,545,541,1086
WAJIR,HABASWEIN,42,648,461,1109
WAJIR,HABASWEIN,43,418,303,721
WAJIR,HABASWEIN,44,211,177,388
WAJIR,HABASWEIN,40-44,3982,3062,7044
WAJIR,HABASWEIN,45,919,674,1593
WAJIR,HABASWEIN,46,278,201,479
WAJIR,HABASWEIN,47,312,154,466
WAJIR,HABASWEIN,48,406,229,635
WAJIR,HABASWEIN,49,267,166,433
WAJIR,HABASWEIN,45-49,2182,1424,3606
WAJIR,HABASWEIN,50,1102,678,1780
WAJIR,HABASWEIN,51,212,100,312
WAJIR,HABASWEIN,52,362,210,572
WAJIR,HABASWEIN,53,195,93,288
WAJIR,HABASWEIN,54,216,109,325
WAJIR,HABASWEIN,50-54,2087,1190,3277
WAJIR,HABASWEIN,55,292,146,438
WAJIR,HABASWEIN,56,216,144,360
WAJIR,HABASWEIN,57,153,142,295
WAJIR,HABASWEIN,58,223,128,351
WAJIR,HABASWEIN,59,232,98,330
WAJIR,HABASWEIN,55-59,1116,658,1774
WAJIR,HABASWEIN,60,631,332,963
WAJIR,HABASWEIN,61,187,98,285
WAJIR,HABASWEIN,62,140,78,218
WAJIR,HABASWEIN,63,116,57,173
WAJIR,HABASWEIN,64,112,56,168
WAJIR,HABASWEIN,60-64,1186,621,1807
WAJIR,HABASWEIN,65,198,111,309
WAJIR,HABASWEIN,66,65,55,120
WAJIR,HABASWEIN,67,73,43,116
WAJIR,HABASWEIN,68,88,30,118
WAJIR,HABASWEIN,69,102,46,148
WAJIR,HABASWEIN,65-69,526,285,811
WAJIR,HABASWEIN,70,266,202,468
WAJIR,HABASWEIN,71,84,60,144
WAJIR,HABASWEIN,72,58,32,90
WAJIR,HABASWEIN,73,39,18,57
WAJIR,HABASWEIN,74,49,22,71
WAJIR,HABASWEIN,70-74,496,334,830
WAJIR,HABASWEIN,75,82,38,120
WAJIR,HABASWEIN,76,46,19,65
WAJIR,HABASWEIN,77,36,13,49
WAJIR,HABASWEIN,78,40,20,60
WAJIR,HABASWEIN,79,39,16,55
WAJIR,HABASWEIN,75-79,243,106,349
WAJIR,HABASWEIN,80,110,113,223
WAJIR,HABASWEIN,81,24,34,58
WAJIR,HABASWEIN,82,18,11,29
WAJIR,HABASWEIN,83,13,5,18
WAJIR,HABASWEIN,84,8,10,18
WAJIR,HABASWEIN,80-84,173,173,346
WAJIR,HABASWEIN,85,18,13,31
WAJIR,HABASWEIN,86,14,6,20
WAJIR,HABASWEIN,87,3,5,8
WAJIR,HABASWEIN,88,9,-,9
WAJIR,HABASWEIN,89,7,9,16
WAJIR,HABASWEIN,85-89,51,33,84
WAJIR,HABASWEIN,90,28,29,57
WAJIR,HABASWEIN,91,7,6,13
WAJIR,HABASWEIN,92,8,2,10
WAJIR,HABASWEIN,93,3,1,4
WAJIR,HABASWEIN,94,4,2,6
WAJIR,HABASWEIN,90-94,50,40,90
WAJIR,HABASWEIN,95,6,2,8
WAJIR,HABASWEIN,96,6,2,8
WAJIR,HABASWEIN,97,2,1,3
WAJIR,HABASWEIN,98,1,-,1
WAJIR,HABASWEIN,99,-,3,3
WAJIR,HABASWEIN,95-99,15,8,23
WAJIR,HABASWEIN,100+,5,3,8
WAJIR,HABASWEIN,Not Stated,-,-,-
WAJIR,TARBAJ,Total,26856,29776,56632
WAJIR,TARBAJ,0,553,768,1321
WAJIR,TARBAJ,1,661,896,1557
WAJIR,TARBAJ,2,1235,1622,2857
WAJIR,TARBAJ,3,874,1147,2021
WAJIR,TARBAJ,4,1240,1612,2852
WAJIR,TARBAJ,0 - 4,4563,6045,10608
WAJIR,TARBAJ,5,843,1068,1911
WAJIR,TARBAJ,6,1290,1612,2902
WAJIR,TARBAJ,7,729,891,1620
WAJIR,TARBAJ,8,1290,1576,2866
WAJIR,TARBAJ,9,665,791,1456
WAJIR,TARBAJ,05-Sep,4817,5938,10755
WAJIR,TARBAJ,10,1389,1624,3013
WAJIR,TARBAJ,11,557,693,1250
WAJIR,TARBAJ,12,1119,1135,2254
WAJIR,TARBAJ,13,644,670,1314
WAJIR,TARBAJ,14,892,886,1778
WAJIR,TARBAJ,Oct-14,4601,5008,9609
WAJIR,TARBAJ,15,896,797,1693
WAJIR,TARBAJ,16,809,802,1611
WAJIR,TARBAJ,17,651,646,1297
WAJIR,TARBAJ,18,762,721,1483
WAJIR,TARBAJ,19,330,387,717
WAJIR,TARBAJ,15-19,3448,3353,6801
WAJIR,TARBAJ,20,793,871,1664
WAJIR,TARBAJ,21,359,384,743
WAJIR,TARBAJ,22,386,469,855
WAJIR,TARBAJ,23,332,347,679
WAJIR,TARBAJ,24,234,293,527
WAJIR,TARBAJ,20-24,2104,2364,4468
WAJIR,TARBAJ,25,581,611,1192
WAJIR,TARBAJ,26,278,329,607
WAJIR,TARBAJ,27,272,388,660
WAJIR,TARBAJ,28,301,377,678
WAJIR,TARBAJ,29,212,296,508
WAJIR,TARBAJ,25-29,1644,2001,3645
WAJIR,TARBAJ,30,661,674,1335
WAJIR,TARBAJ,31,241,351,592
WAJIR,TARBAJ,32,258,330,588
WAJIR,TARBAJ,33,213,223,436
WAJIR,TARBAJ,34,159,177,336
WAJIR,TARBAJ,30-34,1532,1755,3287
WAJIR,TARBAJ,35,420,418,838
WAJIR,TARBAJ,36,149,142,291
WAJIR,TARBAJ,37,151,170,321
WAJIR,TARBAJ,38,168,205,373
WAJIR,TARBAJ,39,118,117,235
WAJIR,TARBAJ,35-39,1006,1052,2058
WAJIR,TARBAJ,40,518,403,921
WAJIR,TARBAJ,41,174,174,348
WAJIR,TARBAJ,42,173,164,337
WAJIR,TARBAJ,43,89,80,169
WAJIR,TARBAJ,44,57,44,101
WAJIR,TARBAJ,40-44,1011,865,1876
WAJIR,TARBAJ,45,248,170,418
WAJIR,TARBAJ,46,63,54,117
WAJIR,TARBAJ,47,46,42,88
WAJIR,TARBAJ,48,80,83,163
WAJIR,TARBAJ,49,85,59,144
WAJIR,TARBAJ,45-49,522,408,930
WAJIR,TARBAJ,50,302,176,478
WAJIR,TARBAJ,51,56,50,106
WAJIR,TARBAJ,52,96,59,155
WAJIR,TARBAJ,53,36,27,63
WAJIR,TARBAJ,54,52,31,83
WAJIR,TARBAJ,50-54,542,343,885
WAJIR,TARBAJ,55,65,39,104
WAJIR,TARBAJ,56,47,27,74
WAJIR,TARBAJ,57,41,39,80
WAJIR,TARBAJ,58,51,33,84
WAJIR,TARBAJ,59,46,38,84
WAJIR,TARBAJ,55-59,250,176,426
WAJIR,TARBAJ,60,164,80,244
WAJIR,TARBAJ,61,75,44,119
WAJIR,TARBAJ,62,42,23,65
WAJIR,TARBAJ,63,40,21,61
WAJIR,TARBAJ,64,35,24,59
WAJIR,TARBAJ,60-64,356,192,548
WAJIR,TARBAJ,65,58,30,88
WAJIR,TARBAJ,66,20,18,38
WAJIR,TARBAJ,67,22,8,30
WAJIR,TARBAJ,68,18,11,29
WAJIR,TARBAJ,69,39,23,62
WAJIR,TARBAJ,65-69,157,90,247
WAJIR,TARBAJ,70,72,59,131
WAJIR,TARBAJ,71,30,26,56
WAJIR,TARBAJ,72,17,5,22
WAJIR,TARBAJ,73,18,4,22
WAJIR,TARBAJ,74,13,3,16
WAJIR,TARBAJ,70-74,150,97,247
WAJIR,TARBAJ,75,22,11,33
WAJIR,TARBAJ,76,16,4,20
WAJIR,TARBAJ,77,4,3,7
WAJIR,TARBAJ,78,8,4,12
WAJIR,TARBAJ,79,14,8,22
WAJIR,TARBAJ,75-79,64,30,94
WAJIR,TARBAJ,80,35,24,59
WAJIR,TARBAJ,81,7,5,12
WAJIR,TARBAJ,82,5,1,6
WAJIR,TARBAJ,83,4,2,6
WAJIR,TARBAJ,84,3,5,8
WAJIR,TARBAJ,80-84,54,37,91
WAJIR,TARBAJ,85,8,4,12
WAJIR,TARBAJ,86,1,2,3
WAJIR,TARBAJ,87,2,-,2
WAJIR,TARBAJ,88,8,1,9
WAJIR,TARBAJ,89,4,2,6
WAJIR,TARBAJ,85-89,23,9,32
WAJIR,TARBAJ,90,5,5,10
WAJIR,TARBAJ,91,2,3,5
WAJIR,TARBAJ,92,-,1,1
WAJIR,TARBAJ,93,2,-,2
WAJIR,TARBAJ,94,1,1,2
WAJIR,TARBAJ,90-94,10,10,20
WAJIR,TARBAJ,95,-,-,-
WAJIR,TARBAJ,96,-,1,1
WAJIR,TARBAJ,97,-,-,-
WAJIR,TARBAJ,98,-,-,-
WAJIR,TARBAJ,99,-,-,-
WAJIR,TARBAJ,95-99,-,1,1
WAJIR,TARBAJ,100+,2,2,4
WAJIR,TARBAJ,Not Stated,-,-,-
WAJIR,WAJIR EAST,Total,59359,51292,110651
WAJIR,WAJIR EAST,0,759,811,1570
WAJIR,WAJIR EAST,1,1328,1229,2557
WAJIR,WAJIR EAST,2,2044,1925,3969
WAJIR,WAJIR EAST,3,1580,1565,3145
WAJIR,WAJIR EAST,4,2149,2056,4205
WAJIR,WAJIR EAST,0 - 4,7860,7586,15446
WAJIR,WAJIR EAST,5,1716,1693,3409
WAJIR,WAJIR EAST,6,2172,2095,4267
WAJIR,WAJIR EAST,7,1582,1426,3008
WAJIR,WAJIR EAST,8,2462,2216,4678
WAJIR,WAJIR EAST,9,1379,1379,2758
WAJIR,WAJIR EAST,05-Sep,9311,8809,18120
WAJIR,WAJIR EAST,10,3032,2489,5521
WAJIR,WAJIR EAST,11,1201,1264,2465
WAJIR,WAJIR EAST,12,2511,1825,4336
WAJIR,WAJIR EAST,13,1586,1292,2878
WAJIR,WAJIR EAST,14,2053,1477,3530
WAJIR,WAJIR EAST,Oct-14,10383,8347,18730
WAJIR,WAJIR EAST,15,2268,1624,3892
WAJIR,WAJIR EAST,16,1866,1415,3281
WAJIR,WAJIR EAST,17,1864,1279,3143
WAJIR,WAJIR EAST,18,1680,1274,2954
WAJIR,WAJIR EAST,19,903,792,1695
WAJIR,WAJIR EAST,15-19,8581,6384,14965
WAJIR,WAJIR EAST,20,1873,1501,3374
WAJIR,WAJIR EAST,21,809,664,1473
WAJIR,WAJIR EAST,22,983,932,1915
WAJIR,WAJIR EAST,23,811,707,1518
WAJIR,WAJIR EAST,24,731,623,1354
WAJIR,WAJIR EAST,20-24,5207,4427,9634
WAJIR,WAJIR EAST,25,1428,1331,2759
WAJIR,WAJIR EAST,26,719,637,1356
WAJIR,WAJIR EAST,27,758,698,1456
WAJIR,WAJIR EAST,28,809,792,1601
WAJIR,WAJIR EAST,29,578,536,1114
WAJIR,WAJIR EAST,25-29,4292,3994,8286
WAJIR,WAJIR EAST,30,1590,1499,3089
WAJIR,WAJIR EAST,31,563,523,1086
WAJIR,WAJIR EAST,32,649,527,1176
WAJIR,WAJIR EAST,33,421,390,811
WAJIR,WAJIR EAST,34,350,376,726
WAJIR,WAJIR EAST,30-34,3573,3315,6888
WAJIR,WAJIR EAST,35,943,907,1850
WAJIR,WAJIR EAST,36,387,391,778
WAJIR,WAJIR EAST,37,346,303,649
WAJIR,WAJIR EAST,38,377,403,780
WAJIR,WAJIR EAST,39,256,264,520
WAJIR,WAJIR EAST,35-39,2309,2268,4577
WAJIR,WAJIR EAST,40,1170,832,2002
WAJIR,WAJIR EAST,41,389,383,772
WAJIR,WAJIR EAST,42,426,339,765
WAJIR,WAJIR EAST,43,219,143,362
WAJIR,WAJIR EAST,44,149,135,284
WAJIR,WAJIR EAST,40-44,2353,1832,4185
WAJIR,WAJIR EAST,45,642,496,1138
WAJIR,WAJIR EAST,46,185,157,342
WAJIR,WAJIR EAST,47,188,142,330
WAJIR,WAJIR EAST,48,214,147,361
WAJIR,WAJIR EAST,49,165,131,296
WAJIR,WAJIR EAST,45-49,1394,1073,2467
WAJIR,WAJIR EAST,50,674,458,1132
WAJIR,WAJIR EAST,51,131,109,240
WAJIR,WAJIR EAST,52,206,142,348
WAJIR,WAJIR EAST,53,85,71,156
WAJIR,WAJIR EAST,54,150,124,274
WAJIR,WAJIR EAST,50-54,1246,904,2150
WAJIR,WAJIR EAST,55,201,136,337
WAJIR,WAJIR EAST,56,166,134,300
WAJIR,WAJIR EAST,57,134,143,277
WAJIR,WAJIR EAST,58,166,133,299
WAJIR,WAJIR EAST,59,163,130,293
WAJIR,WAJIR EAST,55-59,830,676,1506
WAJIR,WAJIR EAST,60,441,289,730
WAJIR,WAJIR EAST,61,114,142,256
WAJIR,WAJIR EAST,62,92,73,165
WAJIR,WAJIR EAST,63,105,54,159
WAJIR,WAJIR EAST,64,77,46,123
WAJIR,WAJIR EAST,60-64,829,604,1433
WAJIR,WAJIR EAST,65,145,97,242
WAJIR,WAJIR EAST,66,52,75,127
WAJIR,WAJIR EAST,67,66,38,104
WAJIR,WAJIR EAST,68,61,34,95
WAJIR,WAJIR EAST,69,79,43,122
WAJIR,WAJIR EAST,65-69,403,287,690
WAJIR,WAJIR EAST,70,203,177,380
WAJIR,WAJIR EAST,71,54,100,154
WAJIR,WAJIR EAST,72,54,27,81
WAJIR,WAJIR EAST,73,26,20,46
WAJIR,WAJIR EAST,74,35,33,68
WAJIR,WAJIR EAST,70-74,372,357,729
WAJIR,WAJIR EAST,75,54,65,119
WAJIR,WAJIR EAST,76,22,27,49
WAJIR,WAJIR EAST,77,27,15,42
WAJIR,WAJIR EAST,78,31,19,50
WAJIR,WAJIR EAST,79,26,21,47
WAJIR,WAJIR EAST,75-79,160,147,307
WAJIR,WAJIR EAST,80,73,83,156
WAJIR,WAJIR EAST,81,22,54,76
WAJIR,WAJIR EAST,82,16,13,29
WAJIR,WAJIR EAST,83,18,11,29
WAJIR,WAJIR EAST,84,11,10,21
WAJIR,WAJIR EAST,80-84,140,171,311
WAJIR,WAJIR EAST,85,18,16,34
WAJIR,WAJIR EAST,86,17,15,32
WAJIR,WAJIR EAST,87,15,7,22
WAJIR,WAJIR EAST,88,2,9,11
WAJIR,WAJIR EAST,89,19,9,28
WAJIR,WAJIR EAST,85-89,71,56,127
WAJIR,WAJIR EAST,90,14,21,35
WAJIR,WAJIR EAST,91,2,13,15
WAJIR,WAJIR EAST,92,2,1,3
WAJIR,WAJIR EAST,93,7,2,9
WAJIR,WAJIR EAST,94,2,-,2
WAJIR,WAJIR EAST,90-94,27,37,64
WAJIR,WAJIR EAST,95,4,2,6
WAJIR,WAJIR EAST,96,2,3,5
WAJIR,WAJIR EAST,97,-,-,-
WAJIR,WAJIR EAST,98,3,-,3
WAJIR,WAJIR EAST,99,-,5,5
WAJIR,WAJIR EAST,95-99,9,10,19
WAJIR,WAJIR EAST,100+,8,8,16
WAJIR,WAJIR EAST,Not Stated,1,-,1
WAJIR,WAJIR NORTH,Total,31990,30209,62199
WAJIR,WAJIR NORTH,0,544,626,1170
WAJIR,WAJIR NORTH,1,768,912,1680
WAJIR,WAJIR NORTH,2,1544,1676,3220
WAJIR,WAJIR NORTH,3,1057,1132,2189
WAJIR,WAJIR NORTH,4,1545,1650,3195
WAJIR,WAJIR NORTH,0 - 4,5458,5996,11454
WAJIR,WAJIR NORTH,5,971,1113,2084
WAJIR,WAJIR NORTH,6,1511,1681,3192
WAJIR,WAJIR NORTH,7,789,885,1674
WAJIR,WAJIR NORTH,8,1555,1546,3101
WAJIR,WAJIR NORTH,9,736,751,1487
WAJIR,WAJIR NORTH,05-Sep,5562,5976,11538
WAJIR,WAJIR NORTH,10,1602,1589,3191
WAJIR,WAJIR NORTH,11,583,810,1393
WAJIR,WAJIR NORTH,12,1299,896,2195
WAJIR,WAJIR NORTH,13,835,561,1396
WAJIR,WAJIR NORTH,14,1022,709,1731
WAJIR,WAJIR NORTH,Oct-14,5341,4565,9906
WAJIR,WAJIR NORTH,15,1095,745,1840
WAJIR,WAJIR NORTH,16,902,629,1531
WAJIR,WAJIR NORTH,17,898,665,1563
WAJIR,WAJIR NORTH,18,860,735,1595
WAJIR,WAJIR NORTH,19,352,332,684
WAJIR,WAJIR NORTH,15-19,4107,3106,7213
WAJIR,WAJIR NORTH,20,946,995,1941
WAJIR,WAJIR NORTH,21,340,339,679
WAJIR,WAJIR NORTH,22,455,533,988
WAJIR,WAJIR NORTH,23,318,350,668
WAJIR,WAJIR NORTH,24,402,397,799
WAJIR,WAJIR NORTH,20-24,2461,2614,5075
WAJIR,WAJIR NORTH,25,816,777,1593
WAJIR,WAJIR NORTH,26,345,361,706
WAJIR,WAJIR NORTH,27,364,410,774
WAJIR,WAJIR NORTH,28,415,522,937
WAJIR,WAJIR NORTH,29,227,316,543
WAJIR,WAJIR NORTH,25-29,2167,2386,4553
WAJIR,WAJIR NORTH,30,972,870,1842
WAJIR,WAJIR NORTH,31,215,239,454
WAJIR,WAJIR NORTH,32,276,279,555
WAJIR,WAJIR NORTH,33,165,230,395
WAJIR,WAJIR NORTH,34,199,186,385
WAJIR,WAJIR NORTH,30-34,1827,1804,3631
WAJIR,WAJIR NORTH,35,481,444,925
WAJIR,WAJIR NORTH,36,212,169,381
WAJIR,WAJIR NORTH,37,170,158,328
WAJIR,WAJIR NORTH,38,238,224,462
WAJIR,WAJIR NORTH,39,134,149,283
WAJIR,WAJIR NORTH,35-39,1235,1144,2379
WAJIR,WAJIR NORTH,40,693,520,1213
WAJIR,WAJIR NORTH,41,190,117,307
WAJIR,WAJIR NORTH,42,203,166,369
WAJIR,WAJIR NORTH,43,137,100,237
WAJIR,WAJIR NORTH,44,78,62,140
WAJIR,WAJIR NORTH,40-44,1301,965,2266
WAJIR,WAJIR NORTH,45,314,228,542
WAJIR,WAJIR NORTH,46,96,42,138
WAJIR,WAJIR NORTH,47,101,67,168
WAJIR,WAJIR NORTH,48,88,65,153
WAJIR,WAJIR NORTH,49,79,66,145
WAJIR,WAJIR NORTH,45-49,678,468,1146
WAJIR,WAJIR NORTH,50,350,218,568
WAJIR,WAJIR NORTH,51,57,40,97
WAJIR,WAJIR NORTH,52,90,64,154
WAJIR,WAJIR NORTH,53,51,23,74
WAJIR,WAJIR NORTH,54,81,63,144
WAJIR,WAJIR NORTH,50-54,629,408,1037
WAJIR,WAJIR NORTH,55,118,73,191
WAJIR,WAJIR NORTH,56,53,29,82
WAJIR,WAJIR NORTH,57,42,42,84
WAJIR,WAJIR NORTH,58,46,39,85
WAJIR,WAJIR NORTH,59,66,56,122
WAJIR,WAJIR NORTH,55-59,325,239,564
WAJIR,WAJIR NORTH,60,222,93,315
WAJIR,WAJIR NORTH,61,40,42,82
WAJIR,WAJIR NORTH,62,39,12,51
WAJIR,WAJIR NORTH,63,34,24,58
WAJIR,WAJIR NORTH,64,27,13,40
WAJIR,WAJIR NORTH,60-64,362,184,546
WAJIR,WAJIR NORTH,65,66,31,97
WAJIR,WAJIR NORTH,66,16,19,35
WAJIR,WAJIR NORTH,67,23,13,36
WAJIR,WAJIR NORTH,68,30,13,43
WAJIR,WAJIR NORTH,69,34,28,62
WAJIR,WAJIR NORTH,65-69,169,104,273
WAJIR,WAJIR NORTH,70,110,59,169
WAJIR,WAJIR NORTH,71,37,39,76
WAJIR,WAJIR NORTH,72,17,11,28
WAJIR,WAJIR NORTH,73,10,6,16
WAJIR,WAJIR NORTH,74,13,10,23
WAJIR,WAJIR NORTH,70-74,187,125,312
WAJIR,WAJIR NORTH,75,25,11,36
WAJIR,WAJIR NORTH,76,6,11,17
WAJIR,WAJIR NORTH,77,15,5,20
WAJIR,WAJIR NORTH,78,17,4,21
WAJIR,WAJIR NORTH,79,19,10,29
WAJIR,WAJIR NORTH,75-79,82,41,123
WAJIR,WAJIR NORTH,80,33,25,58
WAJIR,WAJIR NORTH,81,16,22,38
WAJIR,WAJIR NORTH,82,4,7,11
WAJIR,WAJIR NORTH,83,5,5,10
WAJIR,WAJIR NORTH,84,6,3,9
WAJIR,WAJIR NORTH,80-84,64,62,126
WAJIR,WAJIR NORTH,85,4,3,7
WAJIR,WAJIR NORTH,86,-,4,4
WAJIR,WAJIR NORTH,87,5,2,7
WAJIR,WAJIR NORTH,88,2,1,3
WAJIR,WAJIR NORTH,89,6,2,8
WAJIR,WAJIR NORTH,85-89,17,12,29
WAJIR,WAJIR NORTH,90,7,5,12
WAJIR,WAJIR NORTH,91,2,2,4
WAJIR,WAJIR NORTH,92,1,2,3
WAJIR,WAJIR NORTH,93,1,-,1
WAJIR,WAJIR NORTH,94,1,-,1
WAJIR,WAJIR NORTH,90-94,12,9,21
WAJIR,WAJIR NORTH,95,2,1,3
WAJIR,WAJIR NORTH,96,1,-,1
WAJIR,WAJIR NORTH,97,-,-,-
WAJIR,WAJIR NORTH,98,3,-,3
WAJIR,WAJIR NORTH,99,-,-,-
WAJIR,WAJIR NORTH,95-99,6,1,7
WAJIR,WAJIR NORTH,100+,-,-,-
WAJIR,WAJIR NORTH,Not Stated,-,-,-
WAJIR,WAJIR SOUTH,Total,64947,51864,116811
WAJIR,WAJIR SOUTH,0,591,550,1141
WAJIR,WAJIR SOUTH,1,1423,1218,2641
WAJIR,WAJIR SOUTH,2,2504,2318,4822
WAJIR,WAJIR SOUTH,3,1873,1633,3506
WAJIR,WAJIR SOUTH,4,2591,2248,4839
WAJIR,WAJIR SOUTH,0 - 4,8982,7967,16949
WAJIR,WAJIR SOUTH,5,1930,1704,3634
WAJIR,WAJIR SOUTH,6,2615,2166,4781
WAJIR,WAJIR SOUTH,7,1594,1360,2954
WAJIR,WAJIR SOUTH,8,2728,2181,4909
WAJIR,WAJIR SOUTH,9,1594,1337,2931
WAJIR,WAJIR SOUTH,05-Sep,10461,8748,19209
WAJIR,WAJIR SOUTH,10,3178,2302,5480
WAJIR,WAJIR SOUTH,11,1433,1169,2602
WAJIR,WAJIR SOUTH,12,2640,1623,4263
WAJIR,WAJIR SOUTH,13,1762,1110,2872
WAJIR,WAJIR SOUTH,14,2153,1278,3431
WAJIR,WAJIR SOUTH,Oct-14,11166,7482,18648
WAJIR,WAJIR SOUTH,15,2365,1464,3829
WAJIR,WAJIR SOUTH,16,1903,1210,3113
WAJIR,WAJIR SOUTH,17,1985,1277,3262
WAJIR,WAJIR SOUTH,18,1867,1389,3256
WAJIR,WAJIR SOUTH,19,915,842,1757
WAJIR,WAJIR SOUTH,15-19,9035,6182,15217
WAJIR,WAJIR SOUTH,20,2114,1741,3855
WAJIR,WAJIR SOUTH,21,756,780,1536
WAJIR,WAJIR SOUTH,22,1008,965,1973
WAJIR,WAJIR SOUTH,23,761,796,1557
WAJIR,WAJIR SOUTH,24,793,687,1480
WAJIR,WAJIR SOUTH,20-24,5432,4969,10401
WAJIR,WAJIR SOUTH,25,1528,1653,3181
WAJIR,WAJIR SOUTH,26,771,776,1547
WAJIR,WAJIR SOUTH,27,536,607,1143
WAJIR,WAJIR SOUTH,28,1036,1182,2218
WAJIR,WAJIR SOUTH,29,584,692,1276
WAJIR,WAJIR SOUTH,25-29,4455,4910,9365
WAJIR,WAJIR SOUTH,30,1929,1818,3747
WAJIR,WAJIR SOUTH,31,444,498,942
WAJIR,WAJIR SOUTH,32,721,782,1503
WAJIR,WAJIR SOUTH,33,437,412,849
WAJIR,WAJIR SOUTH,34,385,396,781
WAJIR,WAJIR SOUTH,30-34,3916,3906,7822
WAJIR,WAJIR SOUTH,35,1048,987,2035
WAJIR,WAJIR SOUTH,36,439,487,926
WAJIR,WAJIR SOUTH,37,303,331,634
WAJIR,WAJIR SOUTH,38,614,604,1218
WAJIR,WAJIR SOUTH,39,323,357,680
WAJIR,WAJIR SOUTH,35-39,2727,2766,5493
WAJIR,WAJIR SOUTH,40,1554,1001,2555
WAJIR,WAJIR SOUTH,41,302,287,589
WAJIR,WAJIR SOUTH,42,481,339,820
WAJIR,WAJIR SOUTH,43,334,187,521
WAJIR,WAJIR SOUTH,44,159,117,276
WAJIR,WAJIR SOUTH,40-44,2830,1931,4761
WAJIR,WAJIR SOUTH,45,729,484,1213
WAJIR,WAJIR SOUTH,46,248,133,381
WAJIR,WAJIR SOUTH,47,187,125,312
WAJIR,WAJIR SOUTH,48,348,251,599
WAJIR,WAJIR SOUTH,49,193,130,323
WAJIR,WAJIR SOUTH,45-49,1705,1123,2828
WAJIR,WAJIR SOUTH,50,1039,414,1453
WAJIR,WAJIR SOUTH,51,179,84,263
WAJIR,WAJIR SOUTH,52,268,121,389
WAJIR,WAJIR SOUTH,53,136,46,182
WAJIR,WAJIR SOUTH,54,147,59,206
WAJIR,WAJIR SOUTH,50-54,1769,724,2493
WAJIR,WAJIR SOUTH,55,208,108,316
WAJIR,WAJIR SOUTH,56,159,88,247
WAJIR,WAJIR SOUTH,57,92,63,155
WAJIR,WAJIR SOUTH,58,129,75,204
WAJIR,WAJIR SOUTH,59,109,42,151
WAJIR,WAJIR SOUTH,55-59,697,376,1073
WAJIR,WAJIR SOUTH,60,473,200,673
WAJIR,WAJIR SOUTH,61,89,45,134
WAJIR,WAJIR SOUTH,62,106,26,132
WAJIR,WAJIR SOUTH,63,93,28,121
WAJIR,WAJIR SOUTH,64,55,20,75
WAJIR,WAJIR SOUTH,60-64,816,319,1135
WAJIR,WAJIR SOUTH,65,115,69,184
WAJIR,WAJIR SOUTH,66,50,30,80
WAJIR,WAJIR SOUTH,67,46,15,61
WAJIR,WAJIR SOUTH,68,73,33,106
WAJIR,WAJIR SOUTH,69,60,16,76
WAJIR,WAJIR SOUTH,65-69,344,163,507
WAJIR,WAJIR SOUTH,70,196,83,279
WAJIR,WAJIR SOUTH,71,27,31,58
WAJIR,WAJIR SOUTH,72,53,15,68
WAJIR,WAJIR SOUTH,73,22,9,31
WAJIR,WAJIR SOUTH,74,16,8,24
WAJIR,WAJIR SOUTH,70-74,314,146,460
WAJIR,WAJIR SOUTH,75,41,12,53
WAJIR,WAJIR SOUTH,76,15,10,25
WAJIR,WAJIR SOUTH,77,17,6,23
WAJIR,WAJIR SOUTH,78,30,11,41
WAJIR,WAJIR SOUTH,79,17,7,24
WAJIR,WAJIR SOUTH,75-79,120,46,166
WAJIR,WAJIR SOUTH,80,63,33,96
WAJIR,WAJIR SOUTH,81,16,18,34
WAJIR,WAJIR SOUTH,82,8,5,13
WAJIR,WAJIR SOUTH,83,6,7,13
WAJIR,WAJIR SOUTH,84,9,3,12
WAJIR,WAJIR SOUTH,80-84,102,66,168
WAJIR,WAJIR SOUTH,85,13,3,16
WAJIR,WAJIR SOUTH,86,4,1,5
WAJIR,WAJIR SOUTH,87,8,3,11
WAJIR,WAJIR SOUTH,88,3,4,7
WAJIR,WAJIR SOUTH,89,11,4,15
WAJIR,WAJIR SOUTH,85-89,39,15,54
WAJIR,WAJIR SOUTH,90,17,11,28
WAJIR,WAJIR SOUTH,91,3,2,5
WAJIR,WAJIR SOUTH,92,4,2,6
WAJIR,WAJIR SOUTH,93,3,4,7
WAJIR,WAJIR SOUTH,94,-,-,-
WAJIR,WAJIR SOUTH,90-94,27,19,46
WAJIR,WAJIR SOUTH,95,6,3,9
WAJIR,WAJIR SOUTH,96,-,-,-
WAJIR,WAJIR SOUTH,97,-,-,-
WAJIR,WAJIR SOUTH,98,1,1,2
WAJIR,WAJIR SOUTH,99,1,1,2
WAJIR,WAJIR SOUTH,95-99,8,5,13
WAJIR,WAJIR SOUTH,100+,2,1,3
WAJIR,WAJIR SOUTH,Not Stated,-,-,-
WAJIR,WAJIR WEST,Total,65785,56037,121822
WAJIR,WAJIR WEST,0,818,796,1614
WAJIR,WAJIR WEST,1,1587,1518,3105
WAJIR,WAJIR WEST,2,2591,2558,5149
WAJIR,WAJIR WEST,3,1841,1785,3626
WAJIR,WAJIR WEST,4,2771,2637,5408
WAJIR,WAJIR WEST,0 - 4,9608,9294,18902
WAJIR,WAJIR WEST,5,1897,1961,3858
WAJIR,WAJIR WEST,6,2971,2828,5799
WAJIR,WAJIR WEST,7,1767,1733,3500
WAJIR,WAJIR WEST,8,3109,2970,6079
WAJIR,WAJIR WEST,9,1675,1721,3396
WAJIR,WAJIR WEST,05-Sep,11419,11213,22632
WAJIR,WAJIR WEST,10,3706,3352,7058
WAJIR,WAJIR WEST,11,1486,1593,3079
WAJIR,WAJIR WEST,12,3189,2294,5483
WAJIR,WAJIR WEST,13,2001,1414,3415
WAJIR,WAJIR WEST,14,2626,1754,4380
WAJIR,WAJIR WEST,Oct-14,13008,10407,23415
WAJIR,WAJIR WEST,15,2806,1734,4540
WAJIR,WAJIR WEST,16,2389,1584,3973
WAJIR,WAJIR WEST,17,2162,1332,3494
WAJIR,WAJIR WEST,18,2046,1360,3406
WAJIR,WAJIR WEST,19,895,691,1586
WAJIR,WAJIR WEST,15-19,10298,6701,16999
WAJIR,WAJIR WEST,20,1984,1594,3578
WAJIR,WAJIR WEST,21,804,593,1397
WAJIR,WAJIR WEST,22,1003,739,1742
WAJIR,WAJIR WEST,23,688,590,1278
WAJIR,WAJIR WEST,24,733,591,1324
WAJIR,WAJIR WEST,20-24,5212,4107,9319
WAJIR,WAJIR WEST,25,1144,1111,2255
WAJIR,WAJIR WEST,26,631,608,1239
WAJIR,WAJIR WEST,27,545,606,1151
WAJIR,WAJIR WEST,28,777,785,1562
WAJIR,WAJIR WEST,29,462,527,989
WAJIR,WAJIR WEST,25-29,3559,3637,7196
WAJIR,WAJIR WEST,30,1312,1244,2556
WAJIR,WAJIR WEST,31,548,737,1285
WAJIR,WAJIR WEST,32,476,473,949
WAJIR,WAJIR WEST,33,377,395,772
WAJIR,WAJIR WEST,34,353,317,670
WAJIR,WAJIR WEST,30-34,3066,3166,6232
WAJIR,WAJIR WEST,35,781,793,1574
WAJIR,WAJIR WEST,36,439,457,896
WAJIR,WAJIR WEST,37,311,329,640
WAJIR,WAJIR WEST,38,402,403,805
WAJIR,WAJIR WEST,39,256,271,527
WAJIR,WAJIR WEST,35-39,2189,2253,4442
WAJIR,WAJIR WEST,40,1006,759,1765
WAJIR,WAJIR WEST,41,458,468,926
WAJIR,WAJIR WEST,42,418,357,775
WAJIR,WAJIR WEST,43,187,184,371
WAJIR,WAJIR WEST,44,145,119,264
WAJIR,WAJIR WEST,40-44,2214,1887,4101
WAJIR,WAJIR WEST,45,543,335,878
WAJIR,WAJIR WEST,46,161,137,298
WAJIR,WAJIR WEST,47,166,97,263
WAJIR,WAJIR WEST,48,185,156,341
WAJIR,WAJIR WEST,49,158,103,261
WAJIR,WAJIR WEST,45-49,1213,828,2041
WAJIR,WAJIR WEST,50,617,367,984
WAJIR,WAJIR WEST,51,156,111,267
WAJIR,WAJIR WEST,52,213,119,332
WAJIR,WAJIR WEST,53,101,64,165
WAJIR,WAJIR WEST,54,139,89,228
WAJIR,WAJIR WEST,50-54,1226,750,1976
WAJIR,WAJIR WEST,55,189,93,282
WAJIR,WAJIR WEST,56,138,105,243
WAJIR,WAJIR WEST,57,109,77,186
WAJIR,WAJIR WEST,58,144,110,254
WAJIR,WAJIR WEST,59,213,116,329
WAJIR,WAJIR WEST,55-59,793,501,1294
WAJIR,WAJIR WEST,60,397,237,634
WAJIR,WAJIR WEST,61,139,73,212
WAJIR,WAJIR WEST,62,94,48,142
WAJIR,WAJIR WEST,63,88,58,146
WAJIR,WAJIR WEST,64,63,54,117
WAJIR,WAJIR WEST,60-64,781,470,1251
WAJIR,WAJIR WEST,65,118,82,200
WAJIR,WAJIR WEST,66,64,50,114
WAJIR,WAJIR WEST,67,74,41,115
WAJIR,WAJIR WEST,68,67,54,121
WAJIR,WAJIR WEST,69,80,37,117
WAJIR,WAJIR WEST,65-69,403,264,667
WAJIR,WAJIR WEST,70,187,177,364
WAJIR,WAJIR WEST,71,59,55,114
WAJIR,WAJIR WEST,72,47,23,70
WAJIR,WAJIR WEST,73,33,10,43
WAJIR,WAJIR WEST,74,39,16,55
WAJIR,WAJIR WEST,70-74,365,281,646
WAJIR,WAJIR WEST,75,70,35,105
WAJIR,WAJIR WEST,76,34,16,50
WAJIR,WAJIR WEST,77,26,12,38
WAJIR,WAJIR WEST,78,29,12,41
WAJIR,WAJIR WEST,79,26,14,40
WAJIR,WAJIR WEST,75-79,185,89,274
WAJIR,WAJIR WEST,80,82,76,158
WAJIR,WAJIR WEST,81,25,28,53
WAJIR,WAJIR WEST,82,20,5,25
WAJIR,WAJIR WEST,83,14,6,20
WAJIR,WAJIR WEST,84,12,8,20
WAJIR,WAJIR WEST,80-84,153,123,276
WAJIR,WAJIR WEST,85,10,11,21
WAJIR,WAJIR WEST,86,8,4,12
WAJIR,WAJIR WEST,87,12,5,17
WAJIR,WAJIR WEST,88,10,4,14
WAJIR,WAJIR WEST,89,6,10,16
WAJIR,WAJIR WEST,85-89,46,34,80
WAJIR,WAJIR WEST,90,12,13,25
WAJIR,WAJIR WEST,91,9,3,12
WAJIR,WAJIR WEST,92,6,-,6
WAJIR,WAJIR WEST,93,5,1,6
WAJIR,WAJIR WEST,94,1,4,5
WAJIR,WAJIR WEST,90-94,33,21,54
WAJIR,WAJIR WEST,95,1,3,4
WAJIR,WAJIR WEST,96,1,2,3
WAJIR,WAJIR WEST,97,4,-,4
WAJIR,WAJIR WEST,98,3,-,3
WAJIR,WAJIR WEST,99,2,3,5
WAJIR,WAJIR WEST,95-99,11,8,19
WAJIR,WAJIR WEST,100+,3,2,5
WAJIR,WAJIR WEST,Not Stated,-,1,1
WEST POKOT,ALL,Total,307013,314213,621226
WEST POKOT,ALL,0,9944,10068,20012
WEST POKOT,ALL,1,10844,10679,21523
WEST POKOT,ALL,2,12012,11859,23871
WEST POKOT,ALL,3,11956,12116,24072
WEST POKOT,ALL,4,12403,12109,24512
WEST POKOT,ALL,0 - 4,57159,56831,113990
WEST POKOT,ALL,5,11595,11247,22842
WEST POKOT,ALL,6,12055,12450,24505
WEST POKOT,ALL,7,10228,10188,20416
WEST POKOT,ALL,8,11236,11538,22774
WEST POKOT,ALL,9,8989,8797,17786
WEST POKOT,ALL,05-Sep,54103,54220,108323
WEST POKOT,ALL,10,12534,12691,25225
WEST POKOT,ALL,11,7362,7991,15353
WEST POKOT,ALL,12,10841,10177,21018
WEST POKOT,ALL,13,8525,8358,16883
WEST POKOT,ALL,14,8586,8109,16695
WEST POKOT,ALL,Oct-14,47848,47326,95174
WEST POKOT,ALL,15,9210,8460,17670
WEST POKOT,ALL,16,7305,7025,14330
WEST POKOT,ALL,17,6465,5905,12370
WEST POKOT,ALL,18,6075,6032,12107
WEST POKOT,ALL,19,5636,5668,11304
WEST POKOT,ALL,15-19,34691,33090,67781
WEST POKOT,ALL,20,6932,8079,15011
WEST POKOT,ALL,21,4697,5151,9848
WEST POKOT,ALL,22,4280,5008,9288
WEST POKOT,ALL,23,4988,5490,10478
WEST POKOT,ALL,24,4214,4734,8948
WEST POKOT,ALL,20-24,25111,28462,53573
WEST POKOT,ALL,25,5955,6540,12495
WEST POKOT,ALL,26,3835,4089,7924
WEST POKOT,ALL,27,3924,3993,7917
WEST POKOT,ALL,28,3122,3597,6719
WEST POKOT,ALL,29,3317,3737,7054
WEST POKOT,ALL,25-29,20153,21956,42109
WEST POKOT,ALL,30,5449,6038,11487
WEST POKOT,ALL,31,3052,3355,6407
WEST POKOT,ALL,32,3391,3450,6841
WEST POKOT,ALL,33,2852,3059,5911
WEST POKOT,ALL,34,2390,2493,4883
WEST POKOT,ALL,30-34,17134,18395,35529
WEST POKOT,ALL,35,4570,4685,9255
WEST POKOT,ALL,36,1835,1777,3612
WEST POKOT,ALL,37,1750,1651,3401
WEST POKOT,ALL,38,1262,1346,2608
WEST POKOT,ALL,39,1688,1574,3262
WEST POKOT,ALL,35-39,11105,11033,22138
WEST POKOT,ALL,40,2950,2874,5824
WEST POKOT,ALL,41,1998,1917,3915
WEST POKOT,ALL,42,2192,2143,4335
WEST POKOT,ALL,43,1521,1632,3153
WEST POKOT,ALL,44,1058,1163,2221
WEST POKOT,ALL,40-44,9719,9729,19448
WEST POKOT,ALL,45,2931,2860,5791
WEST POKOT,ALL,46,1805,1730,3535
WEST POKOT,ALL,47,1477,1400,2877
WEST POKOT,ALL,48,1026,890,1916
WEST POKOT,ALL,49,1391,1490,2881
WEST POKOT,ALL,45-49,8630,8370,17000
WEST POKOT,ALL,50,2384,2384,4768
WEST POKOT,ALL,51,1027,1020,2047
WEST POKOT,ALL,52,841,887,1728
WEST POKOT,ALL,53,619,621,1240
WEST POKOT,ALL,54,924,959,1883
WEST POKOT,ALL,50-54,5795,5871,11666
WEST POKOT,ALL,55,1154,1123,2277
WEST POKOT,ALL,56,907,805,1712
WEST POKOT,ALL,57,680,674,1354
WEST POKOT,ALL,58,590,637,1227
WEST POKOT,ALL,59,787,1031,1818
WEST POKOT,ALL,55-59,4118,4270,8388
WEST POKOT,ALL,60,1462,1819,3281
WEST POKOT,ALL,61,650,772,1422
WEST POKOT,ALL,62,519,581,1100
WEST POKOT,ALL,63,595,775,1370
WEST POKOT,ALL,64,516,553,1069
WEST POKOT,ALL,60-64,3742,4500,8242
WEST POKOT,ALL,65,907,1270,2177
WEST POKOT,ALL,66,400,459,859
WEST POKOT,ALL,67,612,591,1203
WEST POKOT,ALL,68,345,382,727
WEST POKOT,ALL,69,716,1070,1786
WEST POKOT,ALL,65-69,2980,3772,6752
WEST POKOT,ALL,70,1078,1294,2372
WEST POKOT,ALL,71,422,588,1010
WEST POKOT,ALL,72,383,383,766
WEST POKOT,ALL,73,262,328,590
WEST POKOT,ALL,74,311,459,770
WEST POKOT,ALL,70-74,2456,3052,5508
WEST POKOT,ALL,75,369,443,812
WEST POKOT,ALL,76,186,186,372
WEST POKOT,ALL,77,186,209,395
WEST POKOT,ALL,78,111,137,248
WEST POKOT,ALL,79,265,435,700
WEST POKOT,ALL,75-79,1117,1410,2527
WEST POKOT,ALL,80,304,470,774
WEST POKOT,ALL,81,98,131,229
WEST POKOT,ALL,82,67,84,151
WEST POKOT,ALL,83,71,118,189
WEST POKOT,ALL,84,76,138,214
WEST POKOT,ALL,80-84,616,941,1557
WEST POKOT,ALL,85,83,132,215
WEST POKOT,ALL,86,35,43,78
WEST POKOT,ALL,87,42,60,102
WEST POKOT,ALL,88,27,51,78
WEST POKOT,ALL,89,91,195,286
WEST POKOT,ALL,85-89,278,481,759
WEST POKOT,ALL,90,62,127,189
WEST POKOT,ALL,91,26,47,73
WEST POKOT,ALL,92,14,17,31
WEST POKOT,ALL,93,15,37,52
WEST POKOT,ALL,94,24,27,51
WEST POKOT,ALL,90-94,141,255,396
WEST POKOT,ALL,95,33,48,81
WEST POKOT,ALL,96,12,17,29
WEST POKOT,ALL,97,7,17,24
WEST POKOT,ALL,98,9,11,20
WEST POKOT,ALL,99,16,47,63
WEST POKOT,ALL,95-99,77,140,217
WEST POKOT,ALL,100+,38,108,146
WEST POKOT,ALL,Not Stated,2,1,3
WEST POKOT,KIPKOMO,Total,50923,51703,102626
WEST POKOT,KIPKOMO,0,1715,1756,3471
WEST POKOT,KIPKOMO,1,1831,1684,3515
WEST POKOT,KIPKOMO,2,1903,1864,3767
WEST POKOT,KIPKOMO,3,1973,1983,3956
WEST POKOT,KIPKOMO,4,1979,1912,3891
WEST POKOT,KIPKOMO,0 - 4,9401,9199,18600
WEST POKOT,KIPKOMO,5,1928,1813,3741
WEST POKOT,KIPKOMO,6,1946,1967,3913
WEST POKOT,KIPKOMO,7,1694,1687,3381
WEST POKOT,KIPKOMO,8,1702,1703,3405
WEST POKOT,KIPKOMO,9,1612,1471,3083
WEST POKOT,KIPKOMO,05-Sep,8882,8641,17523
WEST POKOT,KIPKOMO,10,1828,1857,3685
WEST POKOT,KIPKOMO,11,1427,1492,2919
WEST POKOT,KIPKOMO,12,1747,1613,3360
WEST POKOT,KIPKOMO,13,1486,1543,3029
WEST POKOT,KIPKOMO,14,1496,1439,2935
WEST POKOT,KIPKOMO,Oct-14,7984,7944,15928
WEST POKOT,KIPKOMO,15,1459,1509,2968
WEST POKOT,KIPKOMO,16,1241,1250,2491
WEST POKOT,KIPKOMO,17,1212,1127,2339
WEST POKOT,KIPKOMO,18,963,981,1944
WEST POKOT,KIPKOMO,19,1082,1013,2095
WEST POKOT,KIPKOMO,15-19,5957,5880,11837
WEST POKOT,KIPKOMO,20,1059,1260,2319
WEST POKOT,KIPKOMO,21,930,955,1885
WEST POKOT,KIPKOMO,22,706,810,1516
WEST POKOT,KIPKOMO,23,911,928,1839
WEST POKOT,KIPKOMO,24,736,801,1537
WEST POKOT,KIPKOMO,20-24,4342,4754,9096
WEST POKOT,KIPKOMO,25,934,937,1871
WEST POKOT,KIPKOMO,26,629,681,1310
WEST POKOT,KIPKOMO,27,651,615,1266
WEST POKOT,KIPKOMO,28,483,514,997
WEST POKOT,KIPKOMO,29,561,614,1175
WEST POKOT,KIPKOMO,25-29,3258,3361,6619
WEST POKOT,KIPKOMO,30,711,795,1506
WEST POKOT,KIPKOMO,31,474,496,970
WEST POKOT,KIPKOMO,32,473,459,932
WEST POKOT,KIPKOMO,33,444,474,918
WEST POKOT,KIPKOMO,34,398,410,808
WEST POKOT,KIPKOMO,30-34,2500,2634,5134
WEST POKOT,KIPKOMO,35,741,772,1513
WEST POKOT,KIPKOMO,36,338,311,649
WEST POKOT,KIPKOMO,37,339,324,663
WEST POKOT,KIPKOMO,38,177,190,367
WEST POKOT,KIPKOMO,39,266,276,542
WEST POKOT,KIPKOMO,35-39,1861,1873,3734
WEST POKOT,KIPKOMO,40,405,393,798
WEST POKOT,KIPKOMO,41,347,345,692
WEST POKOT,KIPKOMO,42,473,459,932
WEST POKOT,KIPKOMO,43,264,271,535
WEST POKOT,KIPKOMO,44,193,193,386
WEST POKOT,KIPKOMO,40-44,1682,1661,3343
WEST POKOT,KIPKOMO,45,500,497,997
WEST POKOT,KIPKOMO,46,341,292,633
WEST POKOT,KIPKOMO,47,299,293,592
WEST POKOT,KIPKOMO,48,134,156,290
WEST POKOT,KIPKOMO,49,230,294,524
WEST POKOT,KIPKOMO,45-49,1504,1532,3036
WEST POKOT,KIPKOMO,50,316,291,607
WEST POKOT,KIPKOMO,51,199,183,382
WEST POKOT,KIPKOMO,52,149,152,301
WEST POKOT,KIPKOMO,53,130,131,261
WEST POKOT,KIPKOMO,54,186,196,382
WEST POKOT,KIPKOMO,50-54,980,953,1933
WEST POKOT,KIPKOMO,55,191,180,371
WEST POKOT,KIPKOMO,56,171,125,296
WEST POKOT,KIPKOMO,57,108,88,196
WEST POKOT,KIPKOMO,58,104,117,221
WEST POKOT,KIPKOMO,59,150,174,324
WEST POKOT,KIPKOMO,55-59,724,684,1408
WEST POKOT,KIPKOMO,60,208,245,453
WEST POKOT,KIPKOMO,61,115,121,236
WEST POKOT,KIPKOMO,62,71,114,185
WEST POKOT,KIPKOMO,63,113,135,248
WEST POKOT,KIPKOMO,64,93,97,190
WEST POKOT,KIPKOMO,60-64,600,712,1312
WEST POKOT,KIPKOMO,65,128,215,343
WEST POKOT,KIPKOMO,66,59,73,132
WEST POKOT,KIPKOMO,67,113,92,205
WEST POKOT,KIPKOMO,68,56,75,131
WEST POKOT,KIPKOMO,69,125,209,334
WEST POKOT,KIPKOMO,65-69,481,664,1145
WEST POKOT,KIPKOMO,70,153,189,342
WEST POKOT,KIPKOMO,71,67,101,168
WEST POKOT,KIPKOMO,72,59,76,135
WEST POKOT,KIPKOMO,73,41,69,110
WEST POKOT,KIPKOMO,74,47,103,150
WEST POKOT,KIPKOMO,70-74,367,538,905
WEST POKOT,KIPKOMO,75,52,81,133
WEST POKOT,KIPKOMO,76,30,30,60
WEST POKOT,KIPKOMO,77,40,51,91
WEST POKOT,KIPKOMO,78,18,30,48
WEST POKOT,KIPKOMO,79,47,99,146
WEST POKOT,KIPKOMO,75-79,187,291,478
WEST POKOT,KIPKOMO,80,49,88,137
WEST POKOT,KIPKOMO,81,20,23,43
WEST POKOT,KIPKOMO,82,11,20,31
WEST POKOT,KIPKOMO,83,13,23,36
WEST POKOT,KIPKOMO,84,21,19,40
WEST POKOT,KIPKOMO,80-84,114,173,287
WEST POKOT,KIPKOMO,85,17,22,39
WEST POKOT,KIPKOMO,86,6,9,15
WEST POKOT,KIPKOMO,87,8,17,25
WEST POKOT,KIPKOMO,88,9,7,16
WEST POKOT,KIPKOMO,89,13,45,58
WEST POKOT,KIPKOMO,85-89,53,100,153
WEST POKOT,KIPKOMO,90,12,27,39
WEST POKOT,KIPKOMO,91,2,10,12
WEST POKOT,KIPKOMO,92,1,2,3
WEST POKOT,KIPKOMO,93,4,8,12
WEST POKOT,KIPKOMO,94,5,9,14
WEST POKOT,KIPKOMO,90-94,24,56,80
WEST POKOT,KIPKOMO,95,7,9,16
WEST POKOT,KIPKOMO,96,4,2,6
WEST POKOT,KIPKOMO,97,2,2,4
WEST POKOT,KIPKOMO,98,1,3,4
WEST POKOT,KIPKOMO,99,5,13,18
WEST POKOT,KIPKOMO,95-99,19,29,48
WEST POKOT,KIPKOMO,100+,3,24,27
WEST POKOT,KIPKOMO,Not Stated,-,-,-
WEST POKOT,POKOT CENTRAL,Total,59682,59331,119013
WEST POKOT,POKOT CENTRAL,0,1990,2033,4023
WEST POKOT,POKOT CENTRAL,1,1988,1985,3973
WEST POKOT,POKOT CENTRAL,2,2366,2317,4683
WEST POKOT,POKOT CENTRAL,3,2384,2315,4699
WEST POKOT,POKOT CENTRAL,4,2446,2376,4822
WEST POKOT,POKOT CENTRAL,0 - 4,11174,11026,22200
WEST POKOT,POKOT CENTRAL,5,2283,2239,4522
WEST POKOT,POKOT CENTRAL,6,2433,2434,4867
WEST POKOT,POKOT CENTRAL,7,2060,2005,4065
WEST POKOT,POKOT CENTRAL,8,2329,2201,4530
WEST POKOT,POKOT CENTRAL,9,1732,1614,3346
WEST POKOT,POKOT CENTRAL,05-Sep,10837,10493,21330
WEST POKOT,POKOT CENTRAL,10,2553,2461,5014
WEST POKOT,POKOT CENTRAL,11,1356,1438,2794
WEST POKOT,POKOT CENTRAL,12,2179,1947,4126
WEST POKOT,POKOT CENTRAL,13,1629,1460,3089
WEST POKOT,POKOT CENTRAL,14,1693,1589,3282
WEST POKOT,POKOT CENTRAL,Oct-14,9410,8895,18305
WEST POKOT,POKOT CENTRAL,15,1674,1523,3197
WEST POKOT,POKOT CENTRAL,16,1401,1360,2761
WEST POKOT,POKOT CENTRAL,17,1116,1018,2134
WEST POKOT,POKOT CENTRAL,18,1222,1217,2439
WEST POKOT,POKOT CENTRAL,19,1017,1013,2030
WEST POKOT,POKOT CENTRAL,15-19,6430,6131,12561
WEST POKOT,POKOT CENTRAL,20,1328,1582,2910
WEST POKOT,POKOT CENTRAL,21,790,864,1654
WEST POKOT,POKOT CENTRAL,22,744,854,1598
WEST POKOT,POKOT CENTRAL,23,882,960,1842
WEST POKOT,POKOT CENTRAL,24,738,776,1514
WEST POKOT,POKOT CENTRAL,20-24,4482,5036,9518
WEST POKOT,POKOT CENTRAL,25,1144,1202,2346
WEST POKOT,POKOT CENTRAL,26,625,695,1320
WEST POKOT,POKOT CENTRAL,27,724,703,1427
WEST POKOT,POKOT CENTRAL,28,619,769,1388
WEST POKOT,POKOT CENTRAL,29,602,698,1300
WEST POKOT,POKOT CENTRAL,25-29,3714,4067,7781
WEST POKOT,POKOT CENTRAL,30,1132,1226,2358
WEST POKOT,POKOT CENTRAL,31,513,566,1079
WEST POKOT,POKOT CENTRAL,32,630,548,1178
WEST POKOT,POKOT CENTRAL,33,592,579,1171
WEST POKOT,POKOT CENTRAL,34,474,471,945
WEST POKOT,POKOT CENTRAL,30-34,3341,3390,6731
WEST POKOT,POKOT CENTRAL,35,808,795,1603
WEST POKOT,POKOT CENTRAL,36,337,325,662
WEST POKOT,POKOT CENTRAL,37,305,261,566
WEST POKOT,POKOT CENTRAL,38,297,310,607
WEST POKOT,POKOT CENTRAL,39,295,273,568
WEST POKOT,POKOT CENTRAL,35-39,2042,1964,4006
WEST POKOT,POKOT CENTRAL,40,624,630,1254
WEST POKOT,POKOT CENTRAL,41,461,358,819
WEST POKOT,POKOT CENTRAL,42,365,359,724
WEST POKOT,POKOT CENTRAL,43,271,262,533
WEST POKOT,POKOT CENTRAL,44,183,175,358
WEST POKOT,POKOT CENTRAL,40-44,1904,1784,3688
WEST POKOT,POKOT CENTRAL,45,602,563,1165
WEST POKOT,POKOT CENTRAL,46,332,290,622
WEST POKOT,POKOT CENTRAL,47,260,241,501
WEST POKOT,POKOT CENTRAL,48,231,189,420
WEST POKOT,POKOT CENTRAL,49,275,262,537
WEST POKOT,POKOT CENTRAL,45-49,1700,1545,3245
WEST POKOT,POKOT CENTRAL,50,537,522,1059
WEST POKOT,POKOT CENTRAL,51,176,148,324
WEST POKOT,POKOT CENTRAL,52,207,133,340
WEST POKOT,POKOT CENTRAL,53,137,104,241
WEST POKOT,POKOT CENTRAL,54,170,173,343
WEST POKOT,POKOT CENTRAL,50-54,1227,1080,2307
WEST POKOT,POKOT CENTRAL,55,245,227,472
WEST POKOT,POKOT CENTRAL,56,198,161,359
WEST POKOT,POKOT CENTRAL,57,104,83,187
WEST POKOT,POKOT CENTRAL,58,125,126,251
WEST POKOT,POKOT CENTRAL,59,125,176,301
WEST POKOT,POKOT CENTRAL,55-59,797,773,1570
WEST POKOT,POKOT CENTRAL,60,265,408,673
WEST POKOT,POKOT CENTRAL,61,133,147,280
WEST POKOT,POKOT CENTRAL,62,125,92,217
WEST POKOT,POKOT CENTRAL,63,144,181,325
WEST POKOT,POKOT CENTRAL,64,121,120,241
WEST POKOT,POKOT CENTRAL,60-64,788,948,1736
WEST POKOT,POKOT CENTRAL,65,207,281,488
WEST POKOT,POKOT CENTRAL,66,81,76,157
WEST POKOT,POKOT CENTRAL,67,133,127,260
WEST POKOT,POKOT CENTRAL,68,78,84,162
WEST POKOT,POKOT CENTRAL,69,182,259,441
WEST POKOT,POKOT CENTRAL,65-69,681,827,1508
WEST POKOT,POKOT CENTRAL,70,265,327,592
WEST POKOT,POKOT CENTRAL,71,86,115,201
WEST POKOT,POKOT CENTRAL,72,108,88,196
WEST POKOT,POKOT CENTRAL,73,85,79,164
WEST POKOT,POKOT CENTRAL,74,78,81,159
WEST POKOT,POKOT CENTRAL,70-74,622,690,1312
WEST POKOT,POKOT CENTRAL,75,94,129,223
WEST POKOT,POKOT CENTRAL,76,43,42,85
WEST POKOT,POKOT CENTRAL,77,42,44,86
WEST POKOT,POKOT CENTRAL,78,28,30,58
WEST POKOT,POKOT CENTRAL,79,68,94,162
WEST POKOT,POKOT CENTRAL,75-79,275,339,614
WEST POKOT,POKOT CENTRAL,80,78,100,178
WEST POKOT,POKOT CENTRAL,81,20,25,45
WEST POKOT,POKOT CENTRAL,82,12,10,22
WEST POKOT,POKOT CENTRAL,83,19,28,47
WEST POKOT,POKOT CENTRAL,84,9,24,33
WEST POKOT,POKOT CENTRAL,80-84,138,187,325
WEST POKOT,POKOT CENTRAL,85,13,28,41
WEST POKOT,POKOT CENTRAL,86,7,5,12
WEST POKOT,POKOT CENTRAL,87,11,9,20
WEST POKOT,POKOT CENTRAL,88,6,11,17
WEST POKOT,POKOT CENTRAL,89,21,29,50
WEST POKOT,POKOT CENTRAL,85-89,58,82,140
WEST POKOT,POKOT CENTRAL,90,16,29,45
WEST POKOT,POKOT CENTRAL,91,2,5,7
WEST POKOT,POKOT CENTRAL,92,4,2,6
WEST POKOT,POKOT CENTRAL,93,4,5,9
WEST POKOT,POKOT CENTRAL,94,5,3,8
WEST POKOT,POKOT CENTRAL,90-94,31,44,75
WEST POKOT,POKOT CENTRAL,95,11,5,16
WEST POKOT,POKOT CENTRAL,96,5,5,10
WEST POKOT,POKOT CENTRAL,97,2,5,7
WEST POKOT,POKOT CENTRAL,98,1,1,2
WEST POKOT,POKOT CENTRAL,99,3,4,7
WEST POKOT,POKOT CENTRAL,95-99,22,20,42
WEST POKOT,POKOT CENTRAL,100+,9,10,19
WEST POKOT,POKOT CENTRAL,Not Stated,-,-,-
WEST POKOT,POKOT NORTH,Total,64780,69702,134482
WEST POKOT,POKOT NORTH,0,2155,2258,4413
WEST POKOT,POKOT NORTH,1,2517,2583,5100
WEST POKOT,POKOT NORTH,2,2915,2931,5846
WEST POKOT,POKOT NORTH,3,2835,3003,5838
WEST POKOT,POKOT NORTH,4,2988,3013,6001
WEST POKOT,POKOT NORTH,0 - 4,13410,13788,27198
WEST POKOT,POKOT NORTH,5,2671,2725,5396
WEST POKOT,POKOT NORTH,6,2978,3243,6221
WEST POKOT,POKOT NORTH,7,2224,2309,4533
WEST POKOT,POKOT NORTH,8,2969,3156,6125
WEST POKOT,POKOT NORTH,9,1666,1752,3418
WEST POKOT,POKOT NORTH,05-Sep,12508,13185,25693
WEST POKOT,POKOT NORTH,10,3322,3582,6904
WEST POKOT,POKOT NORTH,11,1259,1407,2666
WEST POKOT,POKOT NORTH,12,2463,2340,4803
WEST POKOT,POKOT NORTH,13,1620,1575,3195
WEST POKOT,POKOT NORTH,14,1654,1493,3147
WEST POKOT,POKOT NORTH,Oct-14,10318,10397,20715
WEST POKOT,POKOT NORTH,15,2125,1815,3940
WEST POKOT,POKOT NORTH,16,1417,1141,2558
WEST POKOT,POKOT NORTH,17,1146,929,2075
WEST POKOT,POKOT NORTH,18,1269,1330,2599
WEST POKOT,POKOT NORTH,19,820,891,1711
WEST POKOT,POKOT NORTH,15-19,6777,6106,12883
WEST POKOT,POKOT NORTH,20,1647,1991,3638
WEST POKOT,POKOT NORTH,21,749,922,1671
WEST POKOT,POKOT NORTH,22,790,1062,1852
WEST POKOT,POKOT NORTH,23,886,1089,1975
WEST POKOT,POKOT NORTH,24,734,982,1716
WEST POKOT,POKOT NORTH,20-24,4806,6046,10852
WEST POKOT,POKOT NORTH,25,1299,1659,2958
WEST POKOT,POKOT NORTH,26,728,856,1584
WEST POKOT,POKOT NORTH,27,674,803,1477
WEST POKOT,POKOT NORTH,28,625,757,1382
WEST POKOT,POKOT NORTH,29,615,812,1427
WEST POKOT,POKOT NORTH,25-29,3941,4887,8828
WEST POKOT,POKOT NORTH,30,1322,1669,2991
WEST POKOT,POKOT NORTH,31,619,794,1413
WEST POKOT,POKOT NORTH,32,646,803,1449
WEST POKOT,POKOT NORTH,33,577,688,1265
WEST POKOT,POKOT NORTH,34,389,419,808
WEST POKOT,POKOT NORTH,30-34,3553,4373,7926
WEST POKOT,POKOT NORTH,35,1126,1287,2413
WEST POKOT,POKOT NORTH,36,295,332,627
WEST POKOT,POKOT NORTH,37,250,286,536
WEST POKOT,POKOT NORTH,38,215,258,473
WEST POKOT,POKOT NORTH,39,308,315,623
WEST POKOT,POKOT NORTH,35-39,2194,2478,4672
WEST POKOT,POKOT NORTH,40,754,744,1498
WEST POKOT,POKOT NORTH,41,279,309,588
WEST POKOT,POKOT NORTH,42,372,376,748
WEST POKOT,POKOT NORTH,43,221,271,492
WEST POKOT,POKOT NORTH,44,170,194,364
WEST POKOT,POKOT NORTH,40-44,1796,1894,3690
WEST POKOT,POKOT NORTH,45,532,605,1137
WEST POKOT,POKOT NORTH,46,288,326,614
WEST POKOT,POKOT NORTH,47,199,166,365
WEST POKOT,POKOT NORTH,48,154,146,300
WEST POKOT,POKOT NORTH,49,269,289,558
WEST POKOT,POKOT NORTH,45-49,1442,1532,2974
WEST POKOT,POKOT NORTH,50,640,661,1301
WEST POKOT,POKOT NORTH,51,150,192,342
WEST POKOT,POKOT NORTH,52,128,176,304
WEST POKOT,POKOT NORTH,53,87,104,191
WEST POKOT,POKOT NORTH,54,159,159,318
WEST POKOT,POKOT NORTH,50-54,1164,1292,2456
WEST POKOT,POKOT NORTH,55,239,224,463
WEST POKOT,POKOT NORTH,56,147,141,288
WEST POKOT,POKOT NORTH,57,104,112,216
WEST POKOT,POKOT NORTH,58,85,104,189
WEST POKOT,POKOT NORTH,59,146,214,360
WEST POKOT,POKOT NORTH,55-59,721,795,1516
WEST POKOT,POKOT NORTH,60,360,436,796
WEST POKOT,POKOT NORTH,61,77,104,181
WEST POKOT,POKOT NORTH,62,78,115,193
WEST POKOT,POKOT NORTH,63,96,121,217
WEST POKOT,POKOT NORTH,64,71,85,156
WEST POKOT,POKOT NORTH,60-64,682,861,1543
WEST POKOT,POKOT NORTH,65,216,302,518
WEST POKOT,POKOT NORTH,66,99,107,206
WEST POKOT,POKOT NORTH,67,89,111,200
WEST POKOT,POKOT NORTH,68,65,78,143
WEST POKOT,POKOT NORTH,69,119,232,351
WEST POKOT,POKOT NORTH,65-69,588,830,1418
WEST POKOT,POKOT NORTH,70,262,307,569
WEST POKOT,POKOT NORTH,71,63,105,168
WEST POKOT,POKOT NORTH,72,44,79,123
WEST POKOT,POKOT NORTH,73,45,47,92
WEST POKOT,POKOT NORTH,74,58,92,150
WEST POKOT,POKOT NORTH,70-74,472,630,1102
WEST POKOT,POKOT NORTH,75,78,89,167
WEST POKOT,POKOT NORTH,76,28,36,64
WEST POKOT,POKOT NORTH,77,21,29,50
WEST POKOT,POKOT NORTH,78,24,30,54
WEST POKOT,POKOT NORTH,79,56,80,136
WEST POKOT,POKOT NORTH,75-79,207,264,471
WEST POKOT,POKOT NORTH,80,73,118,191
WEST POKOT,POKOT NORTH,81,11,25,36
WEST POKOT,POKOT NORTH,82,15,21,36
WEST POKOT,POKOT NORTH,83,5,9,14
WEST POKOT,POKOT NORTH,84,3,25,28
WEST POKOT,POKOT NORTH,80-84,107,198,305
WEST POKOT,POKOT NORTH,85,17,28,45
WEST POKOT,POKOT NORTH,86,5,9,14
WEST POKOT,POKOT NORTH,87,7,6,13
WEST POKOT,POKOT NORTH,88,3,8,11
WEST POKOT,POKOT NORTH,89,14,34,48
WEST POKOT,POKOT NORTH,85-89,46,85,131
WEST POKOT,POKOT NORTH,90,13,15,28
WEST POKOT,POKOT NORTH,91,8,12,20
WEST POKOT,POKOT NORTH,92,2,2,4
WEST POKOT,POKOT NORTH,93,3,4,7
WEST POKOT,POKOT NORTH,94,4,2,6
WEST POKOT,POKOT NORTH,90-94,30,35,65
WEST POKOT,POKOT NORTH,95,5,4,9
WEST POKOT,POKOT NORTH,96,1,3,4
WEST POKOT,POKOT NORTH,97,1,1,2
WEST POKOT,POKOT NORTH,98,1,2,3
WEST POKOT,POKOT NORTH,99,3,3,6
WEST POKOT,POKOT NORTH,95-99,11,13,24
WEST POKOT,POKOT NORTH,100+,6,13,19
WEST POKOT,POKOT NORTH,Not Stated,1,-,1
WEST POKOT,POKOT SOUTH,Total,39808,40851,80659
WEST POKOT,POKOT SOUTH,0,1198,1223,2421
WEST POKOT,POKOT SOUTH,1,1372,1376,2748
WEST POKOT,POKOT SOUTH,2,1511,1453,2964
WEST POKOT,POKOT SOUTH,3,1543,1507,3050
WEST POKOT,POKOT SOUTH,4,1623,1490,3113
WEST POKOT,POKOT SOUTH,0 - 4,7247,7049,14296
WEST POKOT,POKOT SOUTH,5,1545,1454,2999
WEST POKOT,POKOT SOUTH,6,1487,1521,3008
WEST POKOT,POKOT SOUTH,7,1365,1306,2671
WEST POKOT,POKOT SOUTH,8,1300,1358,2658
WEST POKOT,POKOT SOUTH,9,1306,1298,2604
WEST POKOT,POKOT SOUTH,05-Sep,7003,6937,13940
WEST POKOT,POKOT SOUTH,10,1506,1486,2992
WEST POKOT,POKOT SOUTH,11,1109,1303,2412
WEST POKOT,POKOT SOUTH,12,1453,1312,2765
WEST POKOT,POKOT SOUTH,13,1212,1275,2487
WEST POKOT,POKOT SOUTH,14,1242,1193,2435
WEST POKOT,POKOT SOUTH,Oct-14,6522,6569,13091
WEST POKOT,POKOT SOUTH,15,1282,1192,2474
WEST POKOT,POKOT SOUTH,16,1115,1082,2197
WEST POKOT,POKOT SOUTH,17,950,893,1843
WEST POKOT,POKOT SOUTH,18,779,728,1507
WEST POKOT,POKOT SOUTH,19,881,900,1781
WEST POKOT,POKOT SOUTH,15-19,5007,4795,9802
WEST POKOT,POKOT SOUTH,20,881,956,1837
WEST POKOT,POKOT SOUTH,21,690,789,1479
WEST POKOT,POKOT SOUTH,22,559,663,1222
WEST POKOT,POKOT SOUTH,23,692,727,1419
WEST POKOT,POKOT SOUTH,24,574,607,1181
WEST POKOT,POKOT SOUTH,20-24,3396,3742,7138
WEST POKOT,POKOT SOUTH,25,770,825,1595
WEST POKOT,POKOT SOUTH,26,504,524,1028
WEST POKOT,POKOT SOUTH,27,467,524,991
WEST POKOT,POKOT SOUTH,28,359,411,770
WEST POKOT,POKOT SOUTH,29,402,454,856
WEST POKOT,POKOT SOUTH,25-29,2502,2738,5240
WEST POKOT,POKOT SOUTH,30,520,611,1131
WEST POKOT,POKOT SOUTH,31,358,406,764
WEST POKOT,POKOT SOUTH,32,438,368,806
WEST POKOT,POKOT SOUTH,33,362,368,730
WEST POKOT,POKOT SOUTH,34,321,399,720
WEST POKOT,POKOT SOUTH,30-34,1999,2152,4151
WEST POKOT,POKOT SOUTH,35,491,536,1027
WEST POKOT,POKOT SOUTH,36,231,225,456
WEST POKOT,POKOT SOUTH,37,249,228,477
WEST POKOT,POKOT SOUTH,38,127,156,283
WEST POKOT,POKOT SOUTH,39,233,191,424
WEST POKOT,POKOT SOUTH,35-39,1331,1336,2667
WEST POKOT,POKOT SOUTH,40,308,277,585
WEST POKOT,POKOT SOUTH,41,282,277,559
WEST POKOT,POKOT SOUTH,42,284,285,569
WEST POKOT,POKOT SOUTH,43,189,252,441
WEST POKOT,POKOT SOUTH,44,141,188,329
WEST POKOT,POKOT SOUTH,40-44,1204,1279,2483
WEST POKOT,POKOT SOUTH,45,329,319,648
WEST POKOT,POKOT SOUTH,46,241,284,525
WEST POKOT,POKOT SOUTH,47,183,238,421
WEST POKOT,POKOT SOUTH,48,152,121,273
WEST POKOT,POKOT SOUTH,49,208,222,430
WEST POKOT,POKOT SOUTH,45-49,1113,1184,2297
WEST POKOT,POKOT SOUTH,50,198,239,437
WEST POKOT,POKOT SOUTH,51,138,127,265
WEST POKOT,POKOT SOUTH,52,88,122,210
WEST POKOT,POKOT SOUTH,53,74,89,163
WEST POKOT,POKOT SOUTH,54,110,143,253
WEST POKOT,POKOT SOUTH,50-54,608,720,1328
WEST POKOT,POKOT SOUTH,55,131,149,280
WEST POKOT,POKOT SOUTH,56,112,112,224
WEST POKOT,POKOT SOUTH,57,122,109,231
WEST POKOT,POKOT SOUTH,58,62,84,146
WEST POKOT,POKOT SOUTH,59,83,135,218
WEST POKOT,POKOT SOUTH,55-59,510,589,1099
WEST POKOT,POKOT SOUTH,60,171,215,386
WEST POKOT,POKOT SOUTH,61,98,154,252
WEST POKOT,POKOT SOUTH,62,66,82,148
WEST POKOT,POKOT SOUTH,63,59,110,169
WEST POKOT,POKOT SOUTH,64,69,83,152
WEST POKOT,POKOT SOUTH,60-64,463,644,1107
WEST POKOT,POKOT SOUTH,65,92,130,222
WEST POKOT,POKOT SOUTH,66,41,63,104
WEST POKOT,POKOT SOUTH,67,79,74,153
WEST POKOT,POKOT SOUTH,68,45,43,88
WEST POKOT,POKOT SOUTH,69,88,127,215
WEST POKOT,POKOT SOUTH,65-69,345,437,782
WEST POKOT,POKOT SOUTH,70,111,141,252
WEST POKOT,POKOT SOUTH,71,59,68,127
WEST POKOT,POKOT SOUTH,72,53,42,95
WEST POKOT,POKOT SOUTH,73,26,38,64
WEST POKOT,POKOT SOUTH,74,38,44,82
WEST POKOT,POKOT SOUTH,70-74,287,333,620
WEST POKOT,POKOT SOUTH,75,45,37,82
WEST POKOT,POKOT SOUTH,76,23,16,39
WEST POKOT,POKOT SOUTH,77,26,20,46
WEST POKOT,POKOT SOUTH,78,8,12,20
WEST POKOT,POKOT SOUTH,79,33,39,72
WEST POKOT,POKOT SOUTH,75-79,135,124,259
WEST POKOT,POKOT SOUTH,80,28,37,65
WEST POKOT,POKOT SOUTH,81,16,10,26
WEST POKOT,POKOT SOUTH,82,5,10,15
WEST POKOT,POKOT SOUTH,83,13,13,26
WEST POKOT,POKOT SOUTH,84,8,12,20
WEST POKOT,POKOT SOUTH,80-84,70,82,152
WEST POKOT,POKOT SOUTH,85,12,10,22
WEST POKOT,POKOT SOUTH,86,2,4,6
WEST POKOT,POKOT SOUTH,87,5,9,14
WEST POKOT,POKOT SOUTH,88,1,5,6
WEST POKOT,POKOT SOUTH,89,13,27,40
WEST POKOT,POKOT SOUTH,85-89,33,55,88
WEST POKOT,POKOT SOUTH,90,7,12,19
WEST POKOT,POKOT SOUTH,91,7,7,14
WEST POKOT,POKOT SOUTH,92,1,5,6
WEST POKOT,POKOT SOUTH,93,-,7,7
WEST POKOT,POKOT SOUTH,94,6,7,13
WEST POKOT,POKOT SOUTH,90-94,21,38,59
WEST POKOT,POKOT SOUTH,95,2,9,11
WEST POKOT,POKOT SOUTH,96,1,4,5
WEST POKOT,POKOT SOUTH,97,2,3,5
WEST POKOT,POKOT SOUTH,98,-,-,-
WEST POKOT,POKOT SOUTH,99,2,10,12
WEST POKOT,POKOT SOUTH,95-99,7,26,33
WEST POKOT,POKOT SOUTH,100+,5,22,27
WEST POKOT,POKOT SOUTH,Not Stated,-,-,-
WEST POKOT,WEST POKOT,Total,91820,92626,184446
WEST POKOT,WEST POKOT,0,2886,2798,5684
WEST POKOT,WEST POKOT,1,3136,3051,6187
WEST POKOT,WEST POKOT,2,3317,3294,6611
WEST POKOT,WEST POKOT,3,3221,3308,6529
WEST POKOT,WEST POKOT,4,3367,3318,6685
WEST POKOT,WEST POKOT,0 - 4,15927,15769,31696
WEST POKOT,WEST POKOT,5,3168,3016,6184
WEST POKOT,WEST POKOT,6,3211,3285,6496
WEST POKOT,WEST POKOT,7,2885,2881,5766
WEST POKOT,WEST POKOT,8,2936,3120,6056
WEST POKOT,WEST POKOT,9,2673,2662,5335
WEST POKOT,WEST POKOT,05-Sep,14873,14964,29837
WEST POKOT,WEST POKOT,10,3325,3305,6630
WEST POKOT,WEST POKOT,11,2211,2351,4562
WEST POKOT,WEST POKOT,12,2999,2965,5964
WEST POKOT,WEST POKOT,13,2578,2505,5083
WEST POKOT,WEST POKOT,14,2501,2395,4896
WEST POKOT,WEST POKOT,Oct-14,13614,13521,27135
WEST POKOT,WEST POKOT,15,2670,2421,5091
WEST POKOT,WEST POKOT,16,2131,2192,4323
WEST POKOT,WEST POKOT,17,2041,1938,3979
WEST POKOT,WEST POKOT,18,1842,1776,3618
WEST POKOT,WEST POKOT,19,1836,1851,3687
WEST POKOT,WEST POKOT,15-19,10520,10178,20698
WEST POKOT,WEST POKOT,20,2017,2290,4307
WEST POKOT,WEST POKOT,21,1538,1621,3159
WEST POKOT,WEST POKOT,22,1481,1619,3100
WEST POKOT,WEST POKOT,23,1617,1786,3403
WEST POKOT,WEST POKOT,24,1432,1568,3000
WEST POKOT,WEST POKOT,20-24,8085,8884,16969
WEST POKOT,WEST POKOT,25,1808,1917,3725
WEST POKOT,WEST POKOT,26,1349,1333,2682
WEST POKOT,WEST POKOT,27,1408,1348,2756
WEST POKOT,WEST POKOT,28,1036,1146,2182
WEST POKOT,WEST POKOT,29,1137,1159,2296
WEST POKOT,WEST POKOT,25-29,6738,6903,13641
WEST POKOT,WEST POKOT,30,1764,1737,3501
WEST POKOT,WEST POKOT,31,1088,1093,2181
WEST POKOT,WEST POKOT,32,1204,1272,2476
WEST POKOT,WEST POKOT,33,877,950,1827
WEST POKOT,WEST POKOT,34,808,794,1602
WEST POKOT,WEST POKOT,30-34,5741,5846,11587
WEST POKOT,WEST POKOT,35,1404,1295,2699
WEST POKOT,WEST POKOT,36,634,584,1218
WEST POKOT,WEST POKOT,37,607,552,1159
WEST POKOT,WEST POKOT,38,446,432,878
WEST POKOT,WEST POKOT,39,586,519,1105
WEST POKOT,WEST POKOT,35-39,3677,3382,7059
WEST POKOT,WEST POKOT,40,859,830,1689
WEST POKOT,WEST POKOT,41,629,628,1257
WEST POKOT,WEST POKOT,42,698,664,1362
WEST POKOT,WEST POKOT,43,576,576,1152
WEST POKOT,WEST POKOT,44,371,413,784
WEST POKOT,WEST POKOT,40-44,3133,3111,6244
WEST POKOT,WEST POKOT,45,968,876,1844
WEST POKOT,WEST POKOT,46,603,538,1141
WEST POKOT,WEST POKOT,47,536,462,998
WEST POKOT,WEST POKOT,48,355,278,633
WEST POKOT,WEST POKOT,49,409,423,832
WEST POKOT,WEST POKOT,45-49,2871,2577,5448
WEST POKOT,WEST POKOT,50,693,671,1364
WEST POKOT,WEST POKOT,51,364,370,734
WEST POKOT,WEST POKOT,52,269,304,573
WEST POKOT,WEST POKOT,53,191,193,384
WEST POKOT,WEST POKOT,54,299,288,587
WEST POKOT,WEST POKOT,50-54,1816,1826,3642
WEST POKOT,WEST POKOT,55,348,343,691
WEST POKOT,WEST POKOT,56,279,266,545
WEST POKOT,WEST POKOT,57,242,282,524
WEST POKOT,WEST POKOT,58,214,206,420
WEST POKOT,WEST POKOT,59,283,332,615
WEST POKOT,WEST POKOT,55-59,1366,1429,2795
WEST POKOT,WEST POKOT,60,458,515,973
WEST POKOT,WEST POKOT,61,227,246,473
WEST POKOT,WEST POKOT,62,179,178,357
WEST POKOT,WEST POKOT,63,183,228,411
WEST POKOT,WEST POKOT,64,162,168,330
WEST POKOT,WEST POKOT,60-64,1209,1335,2544
WEST POKOT,WEST POKOT,65,264,342,606
WEST POKOT,WEST POKOT,66,120,140,260
WEST POKOT,WEST POKOT,67,198,187,385
WEST POKOT,WEST POKOT,68,101,102,203
WEST POKOT,WEST POKOT,69,202,243,445
WEST POKOT,WEST POKOT,65-69,885,1014,1899
WEST POKOT,WEST POKOT,70,287,330,617
WEST POKOT,WEST POKOT,71,147,199,346
WEST POKOT,WEST POKOT,72,119,98,217
WEST POKOT,WEST POKOT,73,65,95,160
WEST POKOT,WEST POKOT,74,90,139,229
WEST POKOT,WEST POKOT,70-74,708,861,1569
WEST POKOT,WEST POKOT,75,100,107,207
WEST POKOT,WEST POKOT,76,62,62,124
WEST POKOT,WEST POKOT,77,57,65,122
WEST POKOT,WEST POKOT,78,33,35,68
WEST POKOT,WEST POKOT,79,61,123,184
WEST POKOT,WEST POKOT,75-79,313,392,705
WEST POKOT,WEST POKOT,80,76,127,203
WEST POKOT,WEST POKOT,81,31,48,79
WEST POKOT,WEST POKOT,82,24,23,47
WEST POKOT,WEST POKOT,83,21,45,66
WEST POKOT,WEST POKOT,84,35,58,93
WEST POKOT,WEST POKOT,80-84,187,301,488
WEST POKOT,WEST POKOT,85,24,44,68
WEST POKOT,WEST POKOT,86,15,16,31
WEST POKOT,WEST POKOT,87,11,19,30
WEST POKOT,WEST POKOT,88,8,20,28
WEST POKOT,WEST POKOT,89,30,60,90
WEST POKOT,WEST POKOT,85-89,88,159,247
WEST POKOT,WEST POKOT,90,14,44,58
WEST POKOT,WEST POKOT,91,7,13,20
WEST POKOT,WEST POKOT,92,6,6,12
WEST POKOT,WEST POKOT,93,4,13,17
WEST POKOT,WEST POKOT,94,4,6,10
WEST POKOT,WEST POKOT,90-94,35,82,117
WEST POKOT,WEST POKOT,95,8,21,29
WEST POKOT,WEST POKOT,96,1,3,4
WEST POKOT,WEST POKOT,97,-,6,6
WEST POKOT,WEST POKOT,98,6,5,11
WEST POKOT,WEST POKOT,99,3,17,20
WEST POKOT,WEST POKOT,95-99,18,52,70
WEST POKOT,WEST POKOT,100+,15,39,54
WEST POKOT,WEST POKOT,Not Stated,1,1,2